"","Zip_Code","Housing_Units","Total_Vacant","Seasonal","Vacant_perm","vacancy_pct"
"1","Z01001",7452,349,71,278," 3.7"
"2","Z01002",10483,942,183,759," 7.2"
"3","Z01005",2164,352,20,332,"15.3"
"4","Z01007",5932,216,188,28," 0.5"
"5","Z01008",596,91,38,53," 8.9"
"6","Z01009",230,46,0,46,"20.0"
"7","Z01010",1641,157,75,82," 5.0"
"8","Z01011",688,136,52,84,"12.2"
"9","Z01012",331,86,50,36,"10.9"
"10","Z01013",10065,869,10,859," 8.5"
"11","Z01020",13298,727,14,713," 5.4"
"12","Z01022",1435,209,0,209,"14.6"
"13","Z01026",501,44,24,20," 4.0"
"14","Z01027",8355,395,103,292," 3.5"
"15","Z01028",6291,252,10,242," 3.8"
"16","Z01029",1113,799,787,12," 1.1"
"17","Z01030",4462,77,0,77," 1.7"
"18","Z01031",696,121,14,107,"15.4"
"19","Z01032",369,91,77,14," 3.8"
"20","Z01033",2457,113,47,66," 2.7"
"21","Z01034",1170,365,289,76," 6.5"
"22","Z01035",2483,195,26,169," 6.8"
"23","Z01036",1972,55,55,0," 0.0"
"24","Z01038",1310,54,54,0," 0.0"
"25","Z01039",638,70,0,70,"11.0"
"26","Z01040",16776,1452,76,1376," 8.2"
"27","Z01050",1208,249,167,82," 6.8"
"28","Z01053",592,21,10,11," 1.9"
"29","Z01054",856,32,5,27," 3.2"
"30","Z01056",8539,446,34,412," 4.8"
"31","Z01057",3739,205,59,146," 3.9"
"32","Z01060",6927,460,82,378," 5.5"
"33","Z01062",4654,208,17,191," 4.1"
"34","Z01068",691,23,9,14," 2.0"
"35","Z01069",3842,342,101,241," 6.3"
"36","Z01070",310,67,58,9," 2.9"
"37","Z01071",584,68,17,51," 8.7"
"38","Z01072",754,119,58,61," 8.1"
"39","Z01073",2532,48,0,48," 1.9"
"40","Z01074",103,20,20,0," 0.0"
"41","Z01075",7258,325,90,235," 3.2"
"42","Z01077",3898,332,102,230," 5.9"
"43","Z01079",297,35,0,35,"11.8"
"44","Z01080",1044,127,0,127,"12.2"
"45","Z01081",836,147,75,72," 8.6"
"46","Z01082",4675,407,125,282," 6.0"
"47","Z01083",1315,135,13,122," 9.3"
"48","Z01085",16358,1168,99,1069," 6.5"
"49","Z01088",303,13,6,7," 2.3"
"50","Z01089",12174,679,0,679," 5.6"
"51","Z01093",143,10,0,10," 7.0"
"52","Z01095",5591,176,84,92," 1.6"
"53","Z01096",1076,83,58,25," 2.3"
"54","Z01098",629,115,96,19," 3.0"
"55","Z01103",1708,296,22,274,"16.0"
"56","Z01104",9437,653,13,640," 6.8"
"57","Z01105",5733,889,13,876,"15.3"
"58","Z01106",6051,286,112,174," 2.9"
"59","Z01107",4284,361,8,353," 8.2"
"60","Z01108",10846,1130,57,1073," 9.9"
"61","Z01109",10790,1411,0,1411,"13.1"
"62","Z01118",5928,385,34,351," 5.9"
"63","Z01119",4938,208,44,164," 3.3"
"64","Z01128",1016,19,0,19," 1.9"
"65","Z01129",3117,194,8,186," 6.0"
"66","Z01151",3701,398,8,390,"10.5"
"67","Z01201",21831,1937,394,1543," 7.1"
"68","Z01220",4354,516,54,462,"10.6"
"69","Z01223",2064,1046,927,119," 5.8"
"70","Z01224",86,9,9,0," 0.0"
"71","Z01225",1555,181,81,100," 6.4"
"72","Z01226",3186,343,13,330,"10.4"
"73","Z01230",4388,1107,848,259," 5.9"
"74","Z01236",660,136,90,46," 7.0"
"75","Z01237",1518,542,385,157,"10.3"
"76","Z01238",3248,756,599,157," 4.8"
"77","Z01240",2916,610,502,108," 3.7"
"78","Z01243",210,33,27,6," 2.9"
"79","Z01245",859,442,436,6," 0.7"
"80","Z01247",8135,1066,124,942,"11.6"
"81","Z01253",525,223,202,21," 4.0"
"82","Z01254",587,147,111,36," 6.1"
"83","Z01255",698,345,313,32," 4.6"
"84","Z01256",359,22,9,13," 3.6"
"85","Z01257",1229,279,224,55," 4.5"
"86","Z01258",348,169,155,14," 4.0"
"87","Z01260",154,10,0,10," 6.5"
"88","Z01262",991,417,391,26," 2.6"
"89","Z01266",1125,464,334,130,"11.6"
"90","Z01267",3085,704,286,418,"13.5"
"91","Z01270",446,130,93,37," 8.3"
"92","Z01301",8399,549,37,512," 6.1"
"93","Z01330",808,186,155,31," 3.8"
"94","Z01331",6302,961,288,673,"10.7"
"95","Z01337",1195,73,23,50," 4.2"
"96","Z01339",798,203,107,96,"12.0"
"97","Z01341",795,107,72,35," 4.4"
"98","Z01342",503,19,0,19," 3.8"
"99","Z01346",414,204,176,28," 6.8"
"100","Z01349",501,55,19,36," 7.2"
"101","Z01351",993,54,7,47," 4.7"
"102","Z01354",622,53,24,29," 4.7"
"103","Z01360",1388,154,90,64," 4.6"
"104","Z01364",3704,402,116,286," 7.7"
"105","Z01366",563,67,30,37," 6.6"
"106","Z01367",318,71,43,28," 8.8"
"107","Z01370",1964,196,94,102," 5.2"
"108","Z01373",2129,215,43,172," 8.1"
"109","Z01375",1574,46,0,46," 2.9"
"110","Z01376",2469,217,15,202," 8.2"
"111","Z01379",396,20,11,9," 2.3"
"112","Z01420",17031,2189,111,2078,"12.2"
"113","Z01430",2748,532,414,118," 4.3"
"114","Z01431",1130,82,43,39," 3.5"
"115","Z01432",3537,229,0,229," 6.5"
"116","Z01440",9183,1027,151,876," 9.5"
"117","Z01450",4243,251,85,166," 3.9"
"118","Z01451",1683,31,0,31," 1.8"
"119","Z01452",1751,159,82,77," 4.4"
"120","Z01453",17847,1063,74,989," 5.5"
"121","Z01460",3691,245,23,222," 6.0"
"122","Z01462",4567,280,126,154," 3.4"
"123","Z01463",4451,204,9,195," 4.4"
"124","Z01464",2462,131,0,131," 5.3"
"125","Z01468",1876,264,116,148," 7.9"
"126","Z01469",2648,101,12,89," 3.4"
"127","Z01473",3051,272,200,72," 2.4"
"128","Z01474",856,127,32,95,"11.1"
"129","Z01475",4511,563,189,374," 8.3"
"130","Z01501",6616,349,27,322," 4.9"
"131","Z01503",1163,85,15,70," 6.0"
"132","Z01504",3628,295,36,259," 7.1"
"133","Z01505",1751,133,11,122," 7.0"
"134","Z01506",1514,124,21,103," 6.8"
"135","Z01507",4913,169,9,160," 3.3"
"136","Z01510",6211,567,8,559," 9.0"
"137","Z01515",895,68,23,45," 5.0"
"138","Z01516",3290,190,72,118," 3.6"
"139","Z01518",1364,151,57,94," 6.9"
"140","Z01520",5513,335,0,335," 6.1"
"141","Z01521",1443,445,357,88," 6.1"
"142","Z01523",2389,128,86,42," 1.8"
"143","Z01524",2802,179,43,136," 4.9"
"144","Z01527",5487,325,36,289," 5.3"
"145","Z01529",1127,66,3,63," 5.6"
"146","Z01531",423,31,0,31," 7.3"
"147","Z01532",5253,145,0,145," 2.8"
"148","Z01534",2323,186,0,186," 8.0"
"149","Z01535",2204,384,47,337,"15.3"
"150","Z01536",2966,223,0,223," 7.5"
"151","Z01537",932,104,0,104,"11.2"
"152","Z01540",4444,224,16,208," 4.7"
"153","Z01541",1307,55,0,55," 4.2"
"154","Z01542",798,25,0,25," 3.1"
"155","Z01543",3194,296,134,162," 5.1"
"156","Z01545",13758,919,0,919," 6.7"
"157","Z01550",7466,704,14,690," 9.2"
"158","Z01560",1901,196,0,196,"10.3"
"159","Z01561",96,38,0,38,"39.6"
"160","Z01562",5281,625,91,534,"10.1"
"161","Z01564",2821,73,30,43," 1.5"
"162","Z01566",2624,228,50,178," 6.8"
"163","Z01568",2912,279,0,279," 9.6"
"164","Z01569",5006,182,0,182," 3.6"
"165","Z01570",7653,984,310,674," 8.8"
"166","Z01571",4384,347,0,347," 7.9"
"167","Z01581",7337,345,44,301," 4.1"
"168","Z01583",2240,97,18,79," 3.5"
"169","Z01585",2072,192,62,130," 6.3"
"170","Z01588",4003,251,0,251," 6.3"
"171","Z01590",3372,279,100,179," 5.3"
"172","Z01602",9655,476,18,458," 4.7"
"173","Z01603",7900,697,0,697," 8.8"
"174","Z01604",15438,1308,148,1160," 7.5"
"175","Z01605",11651,1179,21,1158," 9.9"
"176","Z01606",8439,751,49,702," 8.3"
"177","Z01607",4154,413,0,413," 9.9"
"178","Z01608",1725,287,19,268,"15.5"
"179","Z01609",8170,1121,183,938,"11.5"
"180","Z01610",8759,916,0,916,"10.5"
"181","Z01611",1011,84,0,84," 8.3"
"182","Z01612",1579,71,25,46," 2.9"
"183","Z01701",12680,336,9,327," 2.6"
"184","Z01702",15326,581,12,569," 3.7"
"185","Z01719",2126,25,0,25," 1.2"
"186","Z01720",8865,362,110,252," 2.8"
"187","Z01721",6744,148,0,148," 2.2"
"188","Z01730",5330,201,14,187," 3.5"
"189","Z01740",1676,57,0,57," 3.4"
"190","Z01741",1827,65,0,65," 3.6"
"191","Z01742",7478,558,127,431," 5.8"
"192","Z01746",5084,47,0,47," 0.9"
"193","Z01747",2328,91,0,91," 3.9"
"194","Z01748",5698,276,59,217," 3.8"
"195","Z01749",7947,309,19,290," 3.6"
"196","Z01752",16560,1002,62,940," 5.7"
"197","Z01754",4544,260,17,243," 5.3"
"198","Z01756",2058,65,33,32," 1.6"
"199","Z01757",11565,649,0,649," 5.6"
"200","Z01760",14295,421,73,348," 2.4"
"201","Z01770",1554,93,0,93," 6.0"
"202","Z01772",3377,202,10,192," 5.7"
"203","Z01773",2229,208,71,137," 6.1"
"204","Z01775",2591,53,0,53," 2.0"
"205","Z01776",6221,158,22,136," 2.2"
"206","Z01778",5435,222,91,131," 2.4"
"207","Z01801",15925,909,74,835," 5.2"
"208","Z01803",9858,499,84,415," 4.2"
"209","Z01810",12797,623,34,589," 4.6"
"210","Z01821",11377,294,32,262," 2.3"
"211","Z01824",10138,317,65,252," 2.5"
"212","Z01826",11301,293,0,293," 2.6"
"213","Z01827",1208,32,0,32," 2.6"
"214","Z01830",10847,645,91,554," 5.1"
"215","Z01832",9193,732,67,665," 7.2"
"216","Z01833",3231,116,0,116," 3.6"
"217","Z01834",2496,111,0,111," 4.4"
"218","Z01835",5506,388,39,349," 6.3"
"219","Z01840",2379,121,16,105," 4.4"
"220","Z01841",16198,945,9,936," 5.8"
"221","Z01843",9488,505,0,505," 5.3"
"222","Z01844",18230,779,48,731," 4.0"
"223","Z01845",11366,536,87,449," 4.0"
"224","Z01850",5923,478,0,478," 8.1"
"225","Z01851",10741,689,0,689," 6.4"
"226","Z01852",14572,1008,101,907," 6.2"
"227","Z01854",10230,784,97,687," 6.7"
"228","Z01860",2582,54,0,54," 2.1"
"229","Z01862",3575,208,0,208," 5.8"
"230","Z01863",4039,108,9,99," 2.5"
"231","Z01864",5691,330,32,298," 5.2"
"232","Z01867",9342,444,67,377," 4.0"
"233","Z01876",11357,383,19,364," 3.2"
"234","Z01879",4327,75,18,57," 1.3"
"235","Z01880",10305,454,9,445," 4.3"
"236","Z01886",8339,461,256,205," 2.5"
"237","Z01887",7823,171,30,141," 1.8"
"238","Z01890",7918,332,87,245," 3.1"
"239","Z01901",829,68,0,68," 8.2"
"240","Z01902",18239,1376,33,1343," 7.4"
"241","Z01904",6617,231,0,231," 3.5"
"242","Z01905",8860,470,0,470," 5.3"
"243","Z01906",10757,649,84,565," 5.3"
"244","Z01907",5645,133,71,62," 1.1"
"245","Z01908",1756,117,11,106," 6.0"
"246","Z01913",7577,522,75,447," 5.9"
"247","Z01915",16989,876,110,766," 4.5"
"248","Z01921",2732,19,19,0," 0.0"
"249","Z01923",10988,594,86,508," 4.6"
"250","Z01929",1627,202,96,106," 6.5"
"251","Z01930",14147,1844,918,926," 6.5"
"252","Z01938",5916,381,155,226," 3.8"
"253","Z01940",5105,334,53,281," 5.5"
"254","Z01944",2300,237,192,45," 2.0"
"255","Z01945",8773,636,242,394," 4.5"
"256","Z01949",2744,111,0,111," 4.0"
"257","Z01950",8090,535,288,247," 3.1"
"258","Z01951",2006,292,198,94," 4.7"
"259","Z01952",4533,1087,826,261," 5.8"
"260","Z01960",22449,1038,139,899," 4.0"
"261","Z01966",4203,921,773,148," 3.5"
"262","Z01969",2246,27,12,15," 0.7"
"263","Z01970",19278,1277,141,1136," 5.9"
"264","Z01982",2984,256,151,105," 3.5"
"265","Z01983",2320,38,10,28," 1.2"
"266","Z01984",1457,85,0,85," 5.8"
"267","Z01985",1607,89,22,67," 4.2"
"268","Z02019",6467,271,0,271," 4.2"
"269","Z02021",9182,433,94,339," 3.7"
"270","Z02025",3332,365,365,0," 0.0"
"271","Z02026",9844,265,67,198," 2.0"
"272","Z02030",2020,85,0,85," 4.2"
"273","Z02035",6632,221,76,145," 2.2"
"274","Z02038",11429,314,61,253," 2.2"
"275","Z02043",9030,595,19,576," 6.4"
"276","Z02045",5856,964,630,334," 5.7"
"277","Z02047",174,90,48,42,"24.1"
"278","Z02048",8489,374,33,341," 4.0"
"279","Z02050",10926,1367,943,424," 3.9"
"280","Z02052",4328,238,31,207," 4.8"
"281","Z02053",4704,142,9,133," 2.8"
"282","Z02054",3085,16,0,16," 0.5"
"283","Z02056",3295,118,0,118," 3.6"
"284","Z02061",3741,103,9,94," 2.5"
"285","Z02062",12069,399,10,389," 3.2"
"286","Z02066",7246,736,463,273," 3.8"
"287","Z02067",6539,327,54,273," 4.2"
"288","Z02072",11301,746,8,738," 6.5"
"289","Z02081",7375,277,0,277," 3.8"
"290","Z02090",5691,102,20,82," 1.4"
"291","Z02093",4083,190,85,105," 2.6"
"292","Z02108",2398,284,61,223," 9.3"
"293","Z02109",2343,342,182,160," 6.8"
"294","Z02110",1632,339,97,242,"14.8"
"295","Z02111",3378,270,192,78," 2.3"
"296","Z02113",4595,276,67,209," 4.5"
"297","Z02114",7759,759,157,602," 7.8"
"298","Z02115",10289,754,118,636," 6.2"
"299","Z02116",12909,1449,560,889," 6.9"
"300","Z02118",13386,886,260,626," 4.7"
"301","Z02126",10549,889,0,889," 8.4"
"302","Z02127",17223,891,107,784," 4.6"
"303","Z02128",16936,1116,51,1065," 6.3"
"304","Z02129",9113,656,152,504," 5.5"
"305","Z02130",16812,742,46,696," 4.1"
"306","Z02131",12734,642,11,631," 5.0"
"307","Z02132",11774,504,92,412," 3.5"
"308","Z02134",8854,1028,48,980,"11.1"
"309","Z02135",19880,1851,163,1688," 8.5"
"310","Z02136",11692,644,0,644," 5.5"
"311","Z02138",15264,1610,482,1128," 7.4"
"312","Z02139",15537,1479,266,1213," 7.8"
"313","Z02140",8941,380,107,273," 3.1"
"314","Z02141",6960,663,255,408," 5.9"
"315","Z02142",1789,482,254,228,"12.7"
"316","Z02143",11582,242,9,233," 2.0"
"317","Z02144",11087,327,27,300," 2.7"
"318","Z02145",10609,572,13,559," 5.3"
"319","Z02148",24232,1272,63,1209," 5.0"
"320","Z02149",16571,1095,0,1095," 6.6"
"321","Z02150",12926,650,15,635," 4.9"
"322","Z02151",21784,1284,26,1258," 5.8"
"323","Z02152",8155,553,32,521," 6.4"
"324","Z02155",23192,1078,102,976," 4.2"
"325","Z02163",721,196,33,163,"22.6"
"326","Z02169",25897,1533,111,1422," 5.5"
"327","Z02170",7947,322,0,322," 4.1"
"328","Z02171",7993,506,50,456," 5.7"
"329","Z02176",11822,473,16,457," 3.9"
"330","Z02180",9406,351,26,325," 3.5"
"331","Z02184",14204,498,80,418," 2.9"
"332","Z02186",9302,253,0,253," 2.7"
"333","Z02188",6685,474,81,393," 5.9"
"334","Z02189",6141,53,0,53," 0.9"
"335","Z02190",7018,139,0,139," 2.0"
"336","Z02191",3780,250,37,213," 5.6"
"337","Z02199",945,148,93,55," 5.8"
"338","Z02210",1576,360,130,230,"14.6"
"339","Z02215",8370,898,241,657," 7.8"
"340","Z02301",23843,2559,133,2426,"10.2"
"341","Z02302",12072,592,13,579," 4.8"
"342","Z02322",1751,92,7,85," 4.9"
"343","Z02324",8360,557,55,502," 6.0"
"344","Z02330",4649,226,79,147," 3.2"
"345","Z02332",6055,649,358,291," 4.8"
"346","Z02333",5091,105,0,105," 2.1"
"347","Z02338",2975,123,81,42," 1.4"
"348","Z02339",5001,139,49,90," 1.8"
"349","Z02343",4465,132,0,132," 3.0"
"350","Z02346",9122,556,175,381," 4.2"
"351","Z02347",4209,429,289,140," 3.3"
"352","Z02351",6335,300,12,288," 4.5"
"353","Z02356",4353,75,0,75," 1.7"
"354","Z02359",6675,366,122,244," 3.7"
"355","Z02360",25852,3907,2548,1359," 5.3"
"356","Z02364",4795,210,157,53," 1.1"
"357","Z02367",1074,46,0,46," 4.3"
"358","Z02368",12798,753,56,697," 5.4"
"359","Z02370",6965,448,38,410," 5.9"
"360","Z02375",3646,201,0,201," 5.5"
"361","Z02379",2538,195,25,170," 6.7"
"362","Z02382",5658,155,0,155," 2.7"
"363","Z02420",5179,153,44,109," 2.1"
"364","Z02421",6870,365,0,365," 5.3"
"365","Z02445",9342,699,99,600," 6.4"
"366","Z02446",14592,1161,160,1001," 6.9"
"367","Z02451",8223,561,102,459," 5.6"
"368","Z02452",5251,171,0,171," 3.3"
"369","Z02453",12413,907,70,837," 6.7"
"370","Z02458",5324,404,38,366," 6.9"
"371","Z02459",6941,315,72,243," 3.5"
"372","Z02460",3838,83,0,83," 2.2"
"373","Z02461",2798,107,0,107," 3.8"
"374","Z02462",669,51,6,45," 6.7"
"375","Z02464",1269,64,0,64," 5.0"
"376","Z02465",4408,159,0,159," 3.6"
"377","Z02466",2984,108,0,108," 3.6"
"378","Z02467",7116,530,66,464," 6.5"
"379","Z02468",1994,35,0,35," 1.8"
"380","Z02472",15229,872,107,765," 5.0"
"381","Z02474",12071,621,84,537," 4.4"
"382","Z02476",7547,354,167,187," 2.5"
"383","Z02478",10109,605,8,597," 5.9"
"384","Z02481",5006,245,49,196," 3.9"
"385","Z02482",3977,177,46,131," 3.3"
"386","Z02492",7115,224,0,224," 3.1"
"387","Z02493",3959,178,47,131," 3.3"
"388","Z02494",3803,120,0,120," 3.2"
"389","Z02532",6882,1776,1485,291," 4.2"
"390","Z02534",573,212,212,0," 0.0"
"391","Z02535",2052,1567,1517,50," 2.4"
"392","Z02536",11941,3922,3353,569," 4.8"
"393","Z02537",3280,888,788,100," 3.0"
"394","Z02538",1809,624,559,65," 3.6"
"395","Z02539",5279,3843,3592,251," 4.8"
"396","Z02540",6817,2823,2571,252," 3.7"
"397","Z02542",473,236,29,207,"43.8"
"398","Z02543",830,462,421,41," 4.9"
"399","Z02554",10446,6602,6044,558," 5.3"
"400","Z02556",2308,1038,989,49," 2.1"
"401","Z02557",4541,2829,2544,285," 6.3"
"402","Z02558",1565,882,768,114," 7.3"
"403","Z02559",2892,989,942,47," 1.6"
"404","Z02561",251,22,22,0," 0.0"
"405","Z02562",1999,651,573,78," 3.9"
"406","Z02563",4433,650,551,99," 2.2"
"407","Z02564",1308,1238,1217,21," 1.6"
"408","Z02568",3061,1724,1579,145," 4.7"
"409","Z02571",5762,1255,1046,209," 3.6"
"410","Z02575",2295,1299,1218,81," 3.5"
"411","Z02576",2048,262,127,135," 6.6"
"412","Z02601",8601,2208,1457,751," 8.7"
"413","Z02630",1192,336,268,68," 5.7"
"414","Z02631",7679,3474,3289,185," 2.4"
"415","Z02632",6106,1480,1349,131," 2.1"
"416","Z02633",4263,2444,2234,210," 4.9"
"417","Z02635",2251,698,578,120," 5.3"
"418","Z02638",3358,1761,1675,86," 2.6"
"419","Z02639",4941,3641,3384,257," 5.2"
"420","Z02642",5892,3615,3537,78," 1.3"
"421","Z02644",1569,196,148,48," 3.1"
"422","Z02645",5994,2038,1854,184," 3.1"
"423","Z02646",2733,1715,1581,134," 4.9"
"424","Z02648",3208,522,455,67," 2.1"
"425","Z02649",9807,3900,3565,335," 3.4"
"426","Z02652",1676,1244,1187,57," 3.4"
"427","Z02653",5296,2370,2106,264," 5.0"
"428","Z02655",3085,1427,1299,128," 4.1"
"429","Z02657",4517,2735,2511,224," 5.0"
"430","Z02659",1356,963,895,68," 5.0"
"431","Z02660",4789,1725,1646,79," 1.6"
"432","Z02663",343,287,287,0," 0.0"
"433","Z02664",6818,2463,2133,330," 4.8"
"434","Z02666",1601,1213,1213,0," 0.0"
"435","Z02667",4133,2641,2537,104," 2.5"
"436","Z02668",1445,131,92,39," 2.7"
"437","Z02669",511,431,431,0," 0.0"
"438","Z02670",2365,1665,1572,93," 3.9"
"439","Z02671",1387,910,862,48," 3.5"
"440","Z02673",6616,2932,2535,397," 6.0"
"441","Z02675",4115,1029,861,168," 4.1"
"442","Z02703",18046,1259,83,1176," 6.5"
"443","Z02715",1116,60,0,60," 5.4"
"444","Z02717",1676,145,59,86," 5.1"
"445","Z02718",2508,214,18,196," 7.8"
"446","Z02719",7447,760,347,413," 5.5"
"447","Z02720",14825,1611,218,1393," 9.4"
"448","Z02721",12587,1443,242,1201," 9.5"
"449","Z02723",7333,819,90,729," 9.9"
"450","Z02724",8700,1087,165,922,"10.6"
"451","Z02725",1016,51,41,10," 1.0"
"452","Z02726",6342,432,148,284," 4.5"
"453","Z02738",2434,583,514,69," 2.8"
"454","Z02739",3179,880,699,181," 5.7"
"455","Z02740",20232,1958,77,1881," 9.3"
"456","Z02744",5299,638,46,592,"11.2"
"457","Z02745",10814,678,15,663," 6.1"
"458","Z02746",6845,876,23,853,"12.5"
"459","Z02747",6812,308,55,253," 3.7"
"460","Z02748",5462,636,408,228," 4.2"
"461","Z02760",10587,764,69,695," 6.6"
"462","Z02762",3766,408,42,366," 9.7"
"463","Z02763",726,26,0,26," 3.6"
"464","Z02764",1507,60,0,60," 4.0"
"465","Z02766",6493,342,0,342," 5.3"
"466","Z02767",5040,206,39,167," 3.3"
"467","Z02769",4269,257,10,247," 5.8"
"468","Z02770",1871,59,23,36," 1.9"
"469","Z02771",5650,149,0,149," 2.6"
"470","Z02777",6617,602,201,401," 6.1"
"471","Z02779",2201,17,0,17," 0.8"
"472","Z02780",21156,1475,32,1443," 6.8"
"473","Z02790",7345,1149,813,336," 4.6"
"474","Z02791",220,116,116,0," 0.0"
"475","Z02804",1091,137,62,75," 6.9"
"476","Z02806",6634,399,73,326," 4.9"
"477","Z02807",1820,1394,1359,35," 1.9"
"478","Z02808",871,46,0,46," 5.3"
"479","Z02809",9070,681,261,420," 4.6"
"480","Z02812",526,29,29,0," 0.0"
"481","Z02813",4940,1892,1657,235," 4.8"
"482","Z02814",3144,435,132,303," 9.6"
"483","Z02816",13986,902,114,788," 5.6"
"484","Z02817",2371,196,34,162," 6.8"
"485","Z02818",7936,478,76,402," 5.1"
"486","Z02822",2452,91,0,91," 3.7"
"487","Z02825",2071,114,8,106," 5.1"
"488","Z02827",788,58,0,58," 7.4"
"489","Z02828",3050,110,0,110," 3.6"
"490","Z02830",2695,148,0,148," 5.5"
"491","Z02831",1340,74,0,74," 5.5"
"492","Z02832",2241,213,73,140," 6.2"
"493","Z02833",304,26,0,26," 8.6"
"494","Z02835",2995,635,582,53," 1.8"
"495","Z02837",2336,696,639,57," 2.4"
"496","Z02838",1573,148,16,132," 8.4"
"497","Z02839",600,33,0,33," 5.5"
"498","Z02840",13370,2642,1814,828," 6.2"
"499","Z02842",7360,946,592,354," 4.8"
"500","Z02852",9670,710,229,481," 5.0"
"501","Z02857",3818,118,9,109," 2.9"
"502","Z02859",2708,248,103,145," 5.4"
"503","Z02860",20654,2681,101,2580,"12.5"
"504","Z02861",11047,989,46,943," 8.5"
"505","Z02863",7614,1201,0,1201,"15.8"
"506","Z02864",13969,607,47,560," 4.0"
"507","Z02865",6737,402,48,354," 5.3"
"508","Z02871",7876,960,598,362," 4.6"
"509","Z02874",2517,188,166,22," 0.9"
"510","Z02878",7375,705,318,387," 5.2"
"511","Z02879",10820,2572,2170,402," 3.7"
"512","Z02881",1194,23,0,23," 1.9"
"513","Z02882",9331,3015,2782,233," 2.5"
"514","Z02885",5097,431,92,339," 6.7"
"515","Z02886",13261,834,150,684," 5.2"
"516","Z02888",8883,328,0,328," 3.7"
"517","Z02889",12130,972,212,760," 6.3"
"518","Z02891",11906,2743,1970,773," 6.5"
"519","Z02892",1781,32,32,0," 0.0"
"520","Z02893",14211,1247,160,1087," 7.6"
"521","Z02895",19473,2149,127,2022,"10.4"
"522","Z02896",4961,480,12,468," 9.4"
"523","Z02898",628,47,0,47," 7.5"
"524","Z02903",5352,745,121,624,"11.7"
"525","Z02904",14274,1553,33,1520,"10.6"
"526","Z02905",9625,1015,11,1004,"10.4"
"527","Z02906",12311,1397,228,1169," 9.5"
"528","Z02907",10280,1581,20,1561,"15.2"
"529","Z02908",14635,2325,41,2284,"15.6"
"530","Z02909",17131,2240,23,2217,"12.9"
"531","Z02910",8711,910,0,910,"10.4"
"532","Z02911",7080,395,0,395," 5.6"
"533","Z02914",9448,680,97,583," 6.2"
"534","Z02915",7663,320,0,320," 4.2"
"535","Z02916",3842,185,0,185," 4.8"
"536","Z02917",4590,291,51,240," 5.2"
"537","Z02919",12936,1171,0,1171," 9.1"
"538","Z02920",14969,611,11,600," 4.0"
"539","Z02921",4412,195,0,195," 4.4"
"540","Z03031",4045,113,46,67," 1.7"
"541","Z03032",2021,89,0,89," 4.4"
"542","Z03033",1687,11,0,11," 0.7"
"543","Z03034",1571,52,0,52," 3.3"
"544","Z03036",1675,57,0,57," 3.4"
"545","Z03037",1714,152,109,43," 2.5"
"546","Z03038",13872,631,114,517," 3.7"
"547","Z03042",2859,278,80,198," 6.9"
"548","Z03043",762,187,119,68," 8.9"
"549","Z03045",5399,293,39,254," 4.7"
"550","Z03047",701,95,79,16," 2.3"
"551","Z03048",1531,176,72,104," 6.8"
"552","Z03049",3012,180,180,0," 0.0"
"553","Z03051",9194,330,110,220," 2.4"
"554","Z03052",2956,135,60,75," 2.5"
"555","Z03053",8635,267,30,237," 2.7"
"556","Z03054",9936,360,61,299," 3.0"
"557","Z03055",6374,283,41,242," 3.8"
"558","Z03057",969,68,37,31," 3.2"
"559","Z03060",12854,1031,25,1006," 7.8"
"560","Z03062",11032,396,43,353," 3.2"
"561","Z03063",6931,423,169,254," 3.7"
"562","Z03064",6008,356,28,328," 5.5"
"563","Z03070",1961,79,24,55," 2.8"
"564","Z03071",2001,206,103,103," 5.1"
"565","Z03076",4638,185,106,79," 1.7"
"566","Z03077",4177,207,69,138," 3.3"
"567","Z03079",11733,623,286,337," 2.9"
"568","Z03084",607,95,52,43," 7.1"
"569","Z03086",1679,171,58,113," 6.7"
"570","Z03087",5315,219,167,52," 1.0"
"571","Z03101",1894,199,0,199,"10.5"
"572","Z03102",14333,1133,0,1133," 7.9"
"573","Z03103",15250,1454,105,1349," 8.8"
"574","Z03104",14457,877,87,790," 5.5"
"575","Z03106",5239,72,0,72," 1.4"
"576","Z03109",4311,308,60,248," 5.8"
"577","Z03110",7630,247,52,195," 2.6"
"578","Z03215",1178,1072,1067,5," 0.4"
"579","Z03216",1060,180,137,43," 4.1"
"580","Z03217",1472,535,319,216,"14.7"
"581","Z03220",3559,706,495,211," 5.9"
"582","Z03221",1212,343,274,69," 5.7"
"583","Z03222",4266,2019,1856,163," 3.8"
"584","Z03223",2567,1125,841,284,"11.1"
"585","Z03224",1064,166,79,87," 8.2"
"586","Z03225",2003,666,607,59," 2.9"
"587","Z03226",793,358,332,26," 3.3"
"588","Z03227",703,211,169,42," 6.0"
"589","Z03229",2334,266,194,72," 3.1"
"590","Z03230",736,190,146,44," 6.0"
"591","Z03233",79,32,32,0," 0.0"
"592","Z03234",1910,100,33,67," 3.5"
"593","Z03235",4060,589,154,435,"10.7"
"594","Z03237",1336,478,416,62," 4.6"
"595","Z03240",829,294,243,51," 6.2"
"596","Z03241",825,458,446,12," 1.5"
"597","Z03242",1996,328,171,157," 7.9"
"598","Z03244",3975,805,535,270," 6.8"
"599","Z03245",1448,632,533,99," 6.8"
"600","Z03246",9870,3094,2688,406," 4.1"
"601","Z03249",5100,2045,1680,365," 7.2"
"602","Z03251",3035,2427,2351,76," 2.5"
"603","Z03253",4624,2013,1819,194," 4.2"
"604","Z03254",4993,3186,3014,172," 3.4"
"605","Z03255",1643,815,731,84," 5.1"
"606","Z03256",1198,327,281,46," 3.8"
"607","Z03257",2312,578,513,65," 2.8"
"608","Z03258",1065,85,21,64," 6.0"
"609","Z03259",274,121,104,17," 6.2"
"610","Z03260",409,85,59,26," 6.4"
"611","Z03261",2071,427,344,83," 4.0"
"612","Z03262",1237,800,684,116," 9.4"
"613","Z03263",1612,88,8,80," 5.0"
"614","Z03264",2672,427,252,175," 6.5"
"615","Z03266",1472,512,414,98," 6.7"
"616","Z03268",529,9,9,0," 0.0"
"617","Z03269",1643,459,438,21," 1.3"
"618","Z03273",255,109,76,33,"12.9"
"619","Z03275",4782,405,48,357," 7.5"
"620","Z03276",3584,317,194,123," 3.4"
"621","Z03278",1435,345,218,127," 8.9"
"622","Z03279",548,235,197,38," 6.9"
"623","Z03280",1131,655,601,54," 4.8"
"624","Z03281",3816,672,451,221," 5.8"
"625","Z03282",513,172,151,21," 4.1"
"626","Z03284",587,195,159,36," 6.1"
"627","Z03285",1824,912,823,89," 4.9"
"628","Z03287",697,86,70,16," 2.3"
"629","Z03290",1943,209,186,23," 1.2"
"630","Z03293",132,97,97,0," 0.0"
"631","Z03301",14032,1135,97,1038," 7.4"
"632","Z03303",6498,424,167,257," 4.0"
"633","Z03304",2887,104,0,104," 3.6"
"634","Z03307",2204,142,59,83," 3.8"
"635","Z03431",10921,656,154,502," 4.6"
"636","Z03440",1435,385,255,130," 9.1"
"637","Z03444",780,167,139,28," 3.6"
"638","Z03446",2712,299,75,224," 8.3"
"639","Z03447",1225,167,117,50," 4.1"
"640","Z03448",374,74,44,30," 8.0"
"641","Z03449",910,183,152,31," 3.4"
"642","Z03451",1941,164,0,164," 8.4"
"643","Z03452",2397,227,105,122," 5.1"
"644","Z03455",926,114,82,32," 3.5"
"645","Z03456",428,124,97,27," 6.3"
"646","Z03458",3527,325,46,279," 7.9"
"647","Z03461",2199,363,286,77," 3.5"
"648","Z03464",1031,548,529,19," 1.8"
"649","Z03465",959,12,0,12," 1.3"
"650","Z03467",722,86,24,62," 8.6"
"651","Z03470",2337,347,138,209," 8.9"
"652","Z03561",2971,380,101,279," 9.4"
"653","Z03570",4888,793,204,589,"12.0"
"654","Z03574",1526,477,280,197,"12.9"
"655","Z03576",2525,1037,865,172," 6.8"
"656","Z03579",1119,862,831,31," 2.8"
"657","Z03580",1080,481,379,102," 9.4"
"658","Z03581",1686,253,94,159," 9.4"
"659","Z03582",1421,363,256,107," 7.5"
"660","Z03583",589,156,114,42," 7.1"
"661","Z03584",1910,277,116,161," 8.4"
"662","Z03586",458,163,113,50,"10.9"
"663","Z03588",1114,396,352,44," 3.9"
"664","Z03590",715,316,275,41," 5.7"
"665","Z03592",2204,1636,1549,87," 3.9"
"666","Z03597",287,144,95,49,"17.1"
"667","Z03598",1957,475,349,126," 6.4"
"668","Z03601",285,88,83,5," 1.8"
"669","Z03602",1187,138,51,87," 7.3"
"670","Z03603",2426,240,101,139," 5.7"
"671","Z03605",603,201,176,25," 4.1"
"672","Z03608",1131,84,25,59," 5.2"
"673","Z03609",414,22,0,22," 5.3"
"674","Z03740",501,184,139,45," 9.0"
"675","Z03741",1994,411,333,78," 3.9"
"676","Z03743",6410,965,250,715,"11.2"
"677","Z03745",643,65,29,36," 5.6"
"678","Z03746",94,13,8,5," 5.3"
"679","Z03748",2567,543,501,42," 1.6"
"680","Z03750",383,18,7,11," 2.9"
"681","Z03751",473,179,152,27," 5.7"
"682","Z03753",1651,536,498,38," 2.3"
"683","Z03755",2886,279,82,197," 6.8"
"684","Z03765",298,70,0,70,"23.5"
"685","Z03766",4773,371,0,371," 7.8"
"686","Z03768",783,104,58,46," 5.9"
"687","Z03770",202,24,0,24,"11.9"
"688","Z03771",381,42,14,28," 7.3"
"689","Z03773",3737,601,344,257," 6.9"
"690","Z03774",750,178,115,63," 8.4"
"691","Z03777",682,125,57,68,"10.0"
"692","Z03779",491,156,127,29," 5.9"
"693","Z03781",766,65,30,35," 4.6"
"694","Z03784",2006,64,15,49," 2.4"
"695","Z03785",1373,334,243,91," 6.6"
"696","Z03801",11110,543,213,330," 3.0"
"697","Z03809",2041,517,441,76," 3.7"
"698","Z03810",2367,1767,1620,147," 6.2"
"699","Z03811",2757,127,34,93," 3.4"
"700","Z03813",2085,788,671,117," 5.6"
"701","Z03814",1861,847,729,118," 6.3"
"702","Z03818",2225,610,451,159," 7.1"
"703","Z03819",1596,48,0,48," 3.0"
"704","Z03820",13602,921,54,867," 6.4"
"705","Z03823",639,26,0,26," 4.1"
"706","Z03824",3544,428,30,398,"11.2"
"707","Z03825",3697,361,204,157," 4.2"
"708","Z03826",1098,51,0,51," 4.6"
"709","Z03827",1386,192,142,50," 3.6"
"710","Z03830",2039,1294,1198,96," 4.7"
"711","Z03832",274,110,97,13," 4.7"
"712","Z03833",8716,226,44,182," 2.1"
"713","Z03835",2893,269,82,187," 6.5"
"714","Z03836",1770,1204,1153,51," 2.9"
"715","Z03838",1761,1227,1105,122," 6.9"
"716","Z03839",1653,130,34,96," 5.8"
"717","Z03840",1492,45,0,45," 3.0"
"718","Z03841",2626,123,123,0," 0.0"
"719","Z03842",9571,2804,2236,568," 5.9"
"720","Z03844",957,27,11,16," 1.7"
"721","Z03845",1246,681,575,106," 8.5"
"722","Z03846",944,553,507,46," 4.9"
"723","Z03848",2746,244,182,62," 2.3"
"724","Z03849",1120,527,447,80," 7.1"
"725","Z03851",1841,372,186,186,"10.1"
"726","Z03852",217,10,10,0," 0.0"
"727","Z03853",977,689,689,0," 0.0"
"728","Z03855",1562,592,489,103," 6.6"
"729","Z03856",569,7,0,7," 1.2"
"730","Z03857",4040,186,0,186," 4.6"
"731","Z03858",1867,75,52,23," 1.2"
"732","Z03860",2922,1068,854,214," 7.3"
"733","Z03861",1834,58,0,58," 3.2"
"734","Z03862",1869,140,111,29," 1.6"
"735","Z03864",853,213,140,73," 8.6"
"736","Z03865",3034,196,0,196," 6.5"
"737","Z03867",9897,801,105,696," 7.0"
"738","Z03868",2281,120,0,120," 5.3"
"739","Z03869",1044,58,5,53," 5.1"
"740","Z03870",2960,562,431,131," 4.4"
"741","Z03872",2034,398,347,51," 2.5"
"742","Z03873",2300,129,59,70," 3.0"
"743","Z03874",4696,838,571,267," 5.7"
"744","Z03875",846,357,342,15," 1.8"
"745","Z03878",4989,376,107,269," 5.4"
"746","Z03884",1721,312,270,42," 2.4"
"747","Z03885",2818,42,0,42," 1.5"
"748","Z03886",1588,516,376,140," 8.8"
"749","Z03890",295,152,72,80,"27.1"
"750","Z03894",4582,1838,1376,462,"10.1"
"751","Z03901",3028,253,16,237," 7.8"
"752","Z03902",1280,186,131,55," 4.3"
"753","Z03903",2662,203,23,180," 6.8"
"754","Z03904",4167,536,261,275," 6.6"
"755","Z03905",1085,230,184,46," 4.2"
"756","Z03906",1905,106,62,44," 2.3"
"757","Z03907",1888,1211,1081,130," 6.9"
"758","Z03908",2852,150,105,45," 1.6"
"759","Z03909",6600,2268,1912,356," 5.4"
"760","Z03910",613,448,297,151,"24.6"
"761","Z04001",2181,1234,1155,79," 3.6"
"762","Z04002",3579,600,393,207," 5.8"
"763","Z04003",480,279,164,115,"24.0"
"764","Z04005",10451,1304,560,744," 7.1"
"765","Z04008",1324,31,31,0," 0.0"
"766","Z04009",4174,2144,1806,338," 8.1"
"767","Z04011",9441,1113,188,925," 9.8"
"768","Z04015",3047,1538,1358,180," 5.9"
"769","Z04017",557,318,289,29," 5.2"
"770","Z04020",684,113,28,85,"12.4"
"771","Z04021",2182,45,45,0," 0.0"
"772","Z04022",1161,738,661,77," 6.6"
"773","Z04024",307,82,56,26," 8.5"
"774","Z04027",2633,356,265,91," 3.5"
"775","Z04029",1499,750,647,103," 6.9"
"776","Z04030",1510,458,387,71," 4.7"
"777","Z04032",3580,381,231,150," 4.2"
"778","Z04037",2071,649,498,151," 7.3"
"779","Z04038",6370,481,162,319," 5.0"
"780","Z04039",3281,396,276,120," 3.7"
"781","Z04040",2293,932,793,139," 6.1"
"782","Z04041",862,246,217,29," 3.4"
"783","Z04042",1864,121,87,34," 1.8"
"784","Z04043",6121,1383,1215,168," 2.7"
"785","Z04046",4644,1447,1194,253," 5.4"
"786","Z04047",1132,454,350,104," 9.2"
"787","Z04048",1549,458,374,84," 5.4"
"788","Z04049",1655,304,232,72," 4.4"
"789","Z04050",424,294,276,18," 4.2"
"790","Z04051",1208,793,702,91," 7.5"
"791","Z04055",3289,1642,1304,338,"10.3"
"792","Z04056",163,48,38,10," 6.1"
"793","Z04061",1205,270,199,71," 5.9"
"794","Z04062",7814,1364,890,474," 6.1"
"795","Z04064",5960,1975,1723,252," 4.2"
"796","Z04066",450,196,178,18," 4.0"
"797","Z04071",3833,1746,1639,107," 2.8"
"798","Z04072",8554,707,436,271," 3.2"
"799","Z04073",7582,924,283,641," 8.5"
"800","Z04074",8286,883,578,305," 3.7"
"801","Z04076",2059,1011,979,32," 1.6"
"802","Z04079",2907,1324,1088,236," 8.1"
"803","Z04083",2013,210,0,210,"10.4"
"804","Z04084",4077,1088,875,213," 5.2"
"805","Z04085",710,35,0,35," 4.9"
"806","Z04086",4175,397,44,353," 8.5"
"807","Z04087",1027,258,148,110,"10.7"
"808","Z04088",1014,390,308,82," 8.1"
"809","Z04090",8766,4253,3726,527," 6.0"
"810","Z04092",8361,510,54,456," 5.5"
"811","Z04093",3452,262,44,218," 6.3"
"812","Z04095",1024,459,385,74," 7.2"
"813","Z04096",3696,234,148,86," 2.3"
"814","Z04097",1405,44,0,44," 3.1"
"815","Z04101",9739,983,324,659," 6.8"
"816","Z04102",8166,409,95,314," 3.8"
"817","Z04103",14144,997,26,971," 6.9"
"818","Z04105",4803,207,128,79," 1.6"
"819","Z04106",11273,618,212,406," 3.6"
"820","Z04107",4084,362,218,144," 3.5"
"821","Z04108",1008,596,581,15," 1.5"
"822","Z04210",10696,954,117,837," 7.8"
"823","Z04216",470,303,264,39," 8.3"
"824","Z04217",2706,1535,1387,148," 5.5"
"825","Z04219",1172,553,518,35," 3.0"
"826","Z04220",1465,286,217,69," 4.7"
"827","Z04221",512,131,96,35," 6.8"
"828","Z04222",1679,94,0,94," 5.6"
"829","Z04224",1452,396,190,206,"14.2"
"830","Z04231",340,217,206,11," 3.2"
"831","Z04236",1879,177,93,84," 4.5"
"832","Z04238",512,39,32,7," 1.4"
"833","Z04239",2186,396,183,213," 9.7"
"834","Z04240",17110,1326,53,1273," 7.4"
"835","Z04252",2010,204,18,186," 9.3"
"836","Z04253",1091,243,163,80," 7.3"
"837","Z04254",1519,207,26,181,"11.9"
"838","Z04255",774,505,478,27," 3.5"
"839","Z04256",1244,99,0,99," 8.0"
"840","Z04257",1479,453,98,355,"24.0"
"841","Z04258",959,29,4,25," 2.6"
"842","Z04259",1572,293,196,97," 6.2"
"843","Z04260",2337,263,168,95," 4.1"
"844","Z04261",1760,1581,1556,25," 1.4"
"845","Z04263",942,114,102,12," 1.3"
"846","Z04268",2530,757,507,250," 9.9"
"847","Z04270",3447,1126,900,226," 6.6"
"848","Z04274",2654,450,332,118," 4.4"
"849","Z04275",617,442,433,9," 1.5"
"850","Z04280",3000,231,141,90," 3.0"
"851","Z04281",2369,337,103,234," 9.9"
"852","Z04282",2551,317,61,256,"10.0"
"853","Z04284",781,288,250,38," 4.9"
"854","Z04285",704,519,481,38," 5.4"
"855","Z04287",1486,87,0,87," 5.9"
"856","Z04289",802,145,50,95,"11.8"
"857","Z04294",1990,455,335,120," 6.0"
"858","Z04330",12669,1484,339,1145," 9.0"
"859","Z04342",890,108,80,28," 3.1"
"860","Z04344",1573,150,19,131," 8.3"
"861","Z04345",5301,517,319,198," 3.7"
"862","Z04346",949,153,12,141,"14.9"
"863","Z04347",1271,60,0,60," 4.7"
"864","Z04349",793,340,269,71," 9.0"
"865","Z04350",1929,409,298,111," 5.8"
"866","Z04351",1263,181,145,36," 2.9"
"867","Z04352",1087,398,372,26," 2.4"
"868","Z04354",966,337,299,38," 3.9"
"869","Z04355",1328,232,189,43," 3.2"
"870","Z04357",1803,326,69,257,"14.3"
"871","Z04358",2309,578,514,64," 2.8"
"872","Z04360",402,159,146,13," 3.2"
"873","Z04363",1194,123,54,69," 5.8"
"874","Z04364",3054,647,419,228," 7.5"
"875","Z04401",20491,1755,257,1498," 7.3"
"876","Z04406",784,474,414,60," 7.7"
"877","Z04410",556,107,79,28," 5.0"
"878","Z04412",4359,439,117,322," 7.4"
"879","Z04414",1238,745,676,69," 5.6"
"880","Z04415",145,39,30,9," 6.2"
"881","Z04416",3056,595,279,316,"10.3"
"882","Z04418",955,303,203,100,"10.5"
"883","Z04419",1209,161,71,90," 7.4"
"884","Z04421",712,358,290,68," 9.6"
"885","Z04422",494,80,33,47," 9.5"
"886","Z04424",972,668,572,96," 9.9"
"887","Z04426",3197,1200,1004,196," 6.1"
"888","Z04427",1313,199,76,123," 9.4"
"889","Z04428",1579,266,169,97," 6.1"
"890","Z04429",2712,904,807,97," 3.6"
"891","Z04430",899,54,34,20," 2.2"
"892","Z04435",477,53,22,31," 6.5"
"893","Z04441",2721,1832,1706,126," 4.6"
"894","Z04443",1766,718,614,104," 5.9"
"895","Z04444",3609,240,150,90," 2.5"
"896","Z04448",803,227,185,42," 5.2"
"897","Z04449",755,148,94,54," 7.2"
"898","Z04450",632,100,20,80,"12.7"
"899","Z04455",547,192,162,30," 5.5"
"900","Z04456",1202,75,20,55," 4.6"
"901","Z04457",3176,808,604,204," 6.4"
"902","Z04459",594,198,172,26," 4.4"
"903","Z04460",696,158,87,71,"10.2"
"904","Z04461",1479,189,13,176,"11.9"
"905","Z04462",3699,1544,1268,276," 7.5"
"906","Z04463",1918,632,555,77," 4.0"
"907","Z04464",607,322,283,39," 6.4"
"908","Z04468",4626,653,188,465,"10.1"
"909","Z04472",1389,452,390,62," 4.5"
"910","Z04473",3212,304,53,251," 7.8"
"911","Z04474",1801,174,83,91," 5.1"
"912","Z04479",819,234,165,69," 8.4"
"913","Z04481",368,158,116,42,"11.4"
"914","Z04485",269,161,154,7," 2.6"
"915","Z04487",1059,679,654,25," 2.4"
"916","Z04488",655,184,133,51," 7.8"
"917","Z04493",1270,478,374,104," 8.2"
"918","Z04496",1724,64,0,64," 3.7"
"919","Z04530",5574,686,289,397," 7.1"
"920","Z04535",320,54,10,44,"13.8"
"921","Z04537",1192,311,213,98," 8.2"
"922","Z04538",1847,908,692,216,"11.7"
"923","Z04539",606,102,66,36," 5.9"
"924","Z04543",1426,502,330,172,"12.1"
"925","Z04544",995,641,507,134,"13.5"
"926","Z04547",881,428,376,52," 5.9"
"927","Z04548",1067,603,539,64," 6.0"
"928","Z04551",697,322,284,38," 5.5"
"929","Z04553",1034,230,156,74," 7.2"
"930","Z04554",1174,705,612,93," 7.9"
"931","Z04555",1122,424,352,72," 6.4"
"932","Z04556",726,242,142,100,"13.8"
"933","Z04562",1716,820,763,57," 3.3"
"934","Z04564",436,274,238,36," 8.3"
"935","Z04568",726,481,422,59," 8.1"
"936","Z04572",2631,596,246,350,"13.3"
"937","Z04573",319,97,73,24," 7.5"
"938","Z04574",797,201,134,67," 8.4"
"939","Z04575",186,155,131,24,"12.9"
"940","Z04578",2340,514,233,281,"12.0"
"941","Z04579",1255,62,52,10," 0.8"
"942","Z04605",8241,2326,1724,602," 7.3"
"943","Z04606",795,293,193,100,"12.6"
"944","Z04607",853,347,279,68," 8.0"
"945","Z04609",3445,1035,750,285," 8.3"
"946","Z04611",360,159,71,88,"24.4"
"947","Z04612",429,195,180,15," 3.5"
"948","Z04613",100,31,26,5," 5.0"
"949","Z04614",1707,587,432,155," 9.1"
"950","Z04616",833,479,435,44," 5.3"
"951","Z04617",780,441,421,20," 2.6"
"952","Z04619",1699,305,126,179,"10.5"
"953","Z04622",1367,722,623,99," 7.2"
"954","Z04623",726,262,182,80,"11.0"
"955","Z04624",262,196,164,32,"12.2"
"956","Z04625",180,148,138,10," 5.6"
"957","Z04626",310,119,70,49,"15.8"
"958","Z04627",1519,794,677,117," 7.7"
"959","Z04628",438,138,101,37," 8.4"
"960","Z04630",874,304,244,60," 6.9"
"961","Z04631",1108,383,195,188,"17.0"
"962","Z04643",718,270,165,105,"14.6"
"963","Z04648",301,81,23,58,"19.3"
"964","Z04649",987,404,233,171,"17.3"
"965","Z04650",260,198,190,8," 3.1"
"966","Z04652",1449,596,348,248,"17.1"
"967","Z04653",434,190,137,53,"12.2"
"968","Z04654",2013,651,441,210,"10.4"
"969","Z04655",629,199,148,51," 8.1"
"970","Z04660",1172,579,491,88," 7.5"
"971","Z04662",618,323,316,7," 1.1"
"972","Z04664",812,314,240,74," 9.1"
"973","Z04668",1010,304,197,107,"10.6"
"974","Z04674",455,197,145,52,"11.4"
"975","Z04675",421,240,231,9," 2.1"
"976","Z04676",687,215,135,80,"11.6"
"977","Z04677",293,172,151,21," 7.2"
"978","Z04679",1530,650,546,104," 6.8"
"979","Z04680",917,426,341,85," 9.3"
"980","Z04681",974,423,364,59," 6.1"
"981","Z04684",1134,432,378,54," 4.8"
"982","Z04685",450,283,252,31," 6.9"
"983","Z04691",359,206,142,64,"17.8"
"984","Z04693",515,292,244,48," 9.3"
"985","Z04694",1524,546,330,216,"14.2"
"986","Z04730",4735,572,272,300," 6.3"
"987","Z04733",207,85,71,14," 6.8"
"988","Z04734",434,80,8,72,"16.6"
"989","Z04735",349,100,33,67,"19.2"
"990","Z04736",4774,552,171,381," 8.0"
"991","Z04739",907,500,437,63," 6.9"
"992","Z04740",579,79,17,62,"10.7"
"993","Z04742",1673,169,31,138," 8.2"
"994","Z04743",2266,272,136,136," 6.0"
"995","Z04745",474,85,28,57,"12.0"
"996","Z04747",1029,432,356,76," 7.4"
"997","Z04750",1196,343,63,280,"23.4"
"998","Z04757",1464,294,195,99," 6.8"
"999","Z04758",679,44,18,26," 3.8"
"1000","Z04765",1100,531,496,35," 3.2"
"1001","Z04768",524,317,280,37," 7.1"
"1002","Z04769",4467,381,45,336," 7.5"
"1003","Z04772",571,224,171,53," 9.3"
"1004","Z04774",642,316,264,52," 8.1"
"1005","Z04776",511,120,84,36," 7.0"
"1006","Z04779",576,448,426,22," 3.8"
"1007","Z04780",502,205,150,55,"11.0"
"1008","Z04781",291,59,38,21," 7.2"
"1009","Z04786",891,98,33,65," 7.3"
"1010","Z04787",234,14,0,14," 6.0"
"1011","Z04841",4079,525,122,403," 9.9"
"1012","Z04843",3254,888,593,295," 9.1"
"1013","Z04847",800,190,177,13," 1.6"
"1014","Z04849",2653,922,792,130," 4.9"
"1015","Z04854",1006,287,222,65," 6.5"
"1016","Z04855",373,231,198,33," 8.8"
"1017","Z04856",1758,445,354,91," 5.2"
"1018","Z04858",886,326,281,45," 5.1"
"1019","Z04859",564,271,221,50," 8.9"
"1020","Z04860",1211,516,446,70," 5.8"
"1021","Z04861",1268,92,0,92," 7.3"
"1022","Z04862",1813,338,232,106," 5.8"
"1023","Z04863",1323,789,695,94," 7.1"
"1024","Z04864",2095,441,216,225,"10.7"
"1025","Z04901",12332,1137,173,964," 7.8"
"1026","Z04910",931,170,102,68," 7.3"
"1027","Z04911",1204,324,221,103," 8.6"
"1028","Z04912",557,156,104,52," 9.3"
"1029","Z04915",4352,649,335,314," 7.2"
"1030","Z04917",1667,561,531,30," 1.8"
"1031","Z04918",489,329,271,58,"11.9"
"1032","Z04920",1303,542,378,164,"12.6"
"1033","Z04922",721,201,158,43," 6.0"
"1034","Z04924",1123,203,118,85," 7.6"
"1035","Z04927",1525,171,23,148," 9.7"
"1036","Z04928",1116,253,160,93," 8.3"
"1037","Z04929",388,38,9,29," 7.5"
"1038","Z04930",2527,622,297,325,"12.9"
"1039","Z04936",826,749,705,44," 5.3"
"1040","Z04937",2909,212,0,212," 7.3"
"1041","Z04938",4508,843,459,384," 8.5"
"1042","Z04939",584,98,78,20," 3.4"
"1043","Z04941",796,183,68,115,"14.4"
"1044","Z04942",1225,662,497,165,"13.5"
"1045","Z04943",1150,456,315,141,"12.3"
"1046","Z04945",1345,893,722,171,"12.7"
"1047","Z04947",3026,2315,2218,97," 3.2"
"1048","Z04949",677,304,262,42," 6.2"
"1049","Z04950",2473,519,277,242," 9.8"
"1050","Z04951",480,45,24,21," 4.4"
"1051","Z04952",899,121,64,57," 6.3"
"1052","Z04953",1733,349,123,226,"13.0"
"1053","Z04955",689,171,90,81,"11.8"
"1054","Z04957",2046,236,137,99," 4.8"
"1055","Z04958",1532,679,593,86," 5.6"
"1056","Z04963",4038,981,716,265," 6.6"
"1057","Z04964",799,708,671,37," 4.6"
"1058","Z04965",1041,164,56,108,"10.4"
"1059","Z04966",1298,564,397,167,"12.9"
"1060","Z04967",1783,272,60,212,"11.9"
"1061","Z04969",624,87,69,18," 2.9"
"1062","Z04970",2844,2127,1936,191," 6.7"
"1063","Z04971",1242,420,303,117," 9.4"
"1064","Z04973",843,129,99,30," 3.6"
"1065","Z04974",1757,376,191,185,"10.5"
"1066","Z04976",5012,680,226,454," 9.1"
"1067","Z04978",525,204,163,41," 7.8"
"1068","Z04979",597,144,99,45," 7.5"
"1069","Z04982",647,473,446,27," 4.2"
"1070","Z04983",968,335,292,43," 4.4"
"1071","Z04984",373,81,68,13," 3.5"
"1072","Z04986",810,162,68,94,"11.6"
"1073","Z04988",1010,183,102,81," 8.0"
"1074","Z04989",1960,341,224,117," 6.0"
"1075","Z05001",5174,1080,586,494," 9.5"
"1076","Z05032",1369,318,207,111," 8.1"
"1077","Z05033",1372,178,106,72," 5.2"
"1078","Z05034",199,73,56,17," 8.5"
"1079","Z05035",465,182,129,53,"11.4"
"1080","Z05038",715,157,88,69," 9.7"
"1081","Z05039",673,219,133,86,"12.8"
"1082","Z05040",197,16,7,9," 4.6"
"1083","Z05042",270,81,46,35,"13.0"
"1084","Z05043",356,39,13,26," 7.3"
"1085","Z05045",1207,295,247,48," 4.0"
"1086","Z05046",760,319,279,40," 5.3"
"1087","Z05048",1242,126,57,69," 5.6"
"1088","Z05051",996,278,210,68," 6.8"
"1089","Z05053",211,35,35,0," 0.0"
"1090","Z05055",1617,287,219,68," 4.2"
"1091","Z05056",821,631,560,71," 8.6"
"1092","Z05058",123,17,0,17,"13.8"
"1093","Z05060",2206,279,146,133," 6.0"
"1094","Z05061",646,122,79,43," 6.7"
"1095","Z05062",465,166,143,23," 4.9"
"1096","Z05067",161,48,31,17,"10.6"
"1097","Z05068",1753,319,195,124," 7.1"
"1098","Z05069",287,49,31,18," 6.3"
"1099","Z05070",238,39,39,0," 0.0"
"1100","Z05072",275,43,43,0," 0.0"
"1101","Z05076",252,92,73,19," 7.5"
"1102","Z05077",718,206,131,75,"10.4"
"1103","Z05081",289,37,25,12," 4.2"
"1104","Z05084",111,5,5,0," 0.0"
"1105","Z05089",2513,312,100,212," 8.4"
"1106","Z05091",2269,679,447,232,"10.2"
"1107","Z05101",2280,343,60,283,"12.4"
"1108","Z05142",444,144,114,30," 6.8"
"1109","Z05143",2529,586,433,153," 6.0"
"1110","Z05148",1108,639,528,111,"10.0"
"1111","Z05149",3376,2368,2072,296," 8.8"
"1112","Z05150",544,22,22,0," 0.0"
"1113","Z05151",669,53,31,22," 3.3"
"1114","Z05153",595,243,222,21," 3.5"
"1115","Z05154",272,32,7,25," 9.2"
"1116","Z05155",1843,1481,1450,31," 1.7"
"1117","Z05156",3872,289,51,238," 6.1"
"1118","Z05158",551,113,79,34," 6.2"
"1119","Z05161",566,314,277,37," 6.5"
"1120","Z05201",6637,604,264,340," 5.1"
"1121","Z05250",2076,482,381,101," 4.9"
"1122","Z05251",1149,458,422,36," 3.1"
"1123","Z05253",366,51,42,9," 2.5"
"1124","Z05254",280,166,162,4," 1.4"
"1125","Z05255",2288,439,382,57," 2.5"
"1126","Z05257",1038,128,62,66," 6.4"
"1127","Z05262",1219,95,60,35," 2.9"
"1128","Z05301",8394,1032,589,443," 5.3"
"1129","Z05340",1804,1504,1490,14," 0.8"
"1130","Z05341",290,74,64,10," 3.4"
"1131","Z05342",447,169,160,9," 2.0"
"1132","Z05343",958,596,540,56," 5.8"
"1133","Z05345",1327,283,217,66," 5.0"
"1134","Z05346",2224,265,144,121," 5.4"
"1135","Z05350",513,138,112,26," 5.1"
"1136","Z05352",473,95,80,15," 3.2"
"1137","Z05355",753,454,431,23," 3.1"
"1138","Z05359",481,249,223,26," 5.4"
"1139","Z05360",439,334,324,10," 2.3"
"1140","Z05361",624,248,228,20," 3.2"
"1141","Z05362",75,30,30,0," 0.0"
"1142","Z05363",2630,1647,1493,154," 5.9"
"1143","Z05401",12634,392,96,296," 2.3"
"1144","Z05403",8537,371,51,320," 3.7"
"1145","Z05404",3324,278,73,205," 6.2"
"1146","Z05408",4191,157,0,157," 3.7"
"1147","Z05440",1369,656,520,136," 9.9"
"1148","Z05441",439,63,37,26," 5.9"
"1149","Z05442",194,54,40,14," 7.2"
"1150","Z05443",2888,205,70,135," 4.7"
"1151","Z05444",712,56,38,18," 2.5"
"1152","Z05445",1834,365,237,128," 7.0"
"1153","Z05446",7190,709,401,308," 4.3"
"1154","Z05448",444,68,25,43," 9.7"
"1155","Z05450",2267,311,165,146," 6.4"
"1156","Z05452",8609,194,9,185," 2.1"
"1157","Z05456",591,55,46,9," 1.5"
"1158","Z05457",999,396,365,31," 3.1"
"1159","Z05458",1207,292,198,94," 7.8"
"1160","Z05459",964,102,0,102,"10.6"
"1161","Z05461",1857,52,52,0," 0.0"
"1162","Z05462",849,91,25,66," 7.8"
"1163","Z05463",454,236,218,18," 4.0"
"1164","Z05464",1439,133,71,62," 4.3"
"1165","Z05465",2135,86,8,78," 3.7"
"1166","Z05468",5310,305,235,70," 1.3"
"1167","Z05471",603,246,206,40," 6.6"
"1168","Z05473",748,171,159,12," 1.6"
"1169","Z05474",1018,604,562,42," 4.1"
"1170","Z05476",1438,228,145,83," 5.8"
"1171","Z05477",1865,127,68,59," 3.2"
"1172","Z05478",6499,722,298,424," 6.5"
"1173","Z05482",3289,288,151,137," 4.2"
"1174","Z05486",1048,343,274,69," 6.6"
"1175","Z05487",667,134,116,18," 2.7"
"1176","Z05488",3799,772,701,71," 1.9"
"1177","Z05489",1291,62,24,38," 2.9"
"1178","Z05491",2899,422,263,159," 5.5"
"1179","Z05494",663,20,10,10," 1.5"
"1180","Z05495",4167,72,18,54," 1.3"
"1181","Z05602",5760,553,124,429," 7.4"
"1182","Z05641",7722,520,62,458," 5.9"
"1183","Z05647",688,244,176,68," 9.9"
"1184","Z05648",221,64,64,0," 0.0"
"1185","Z05649",254,15,11,4," 1.6"
"1186","Z05650",689,182,139,43," 6.2"
"1187","Z05651",759,71,42,29," 3.8"
"1188","Z05653",390,210,210,0," 0.0"
"1189","Z05654",330,23,0,23," 7.0"
"1190","Z05655",1307,64,8,56," 4.3"
"1191","Z05656",1284,118,20,98," 7.6"
"1192","Z05657",88,53,53,0," 0.0"
"1193","Z05658",621,62,20,42," 6.8"
"1194","Z05660",943,214,192,22," 2.3"
"1195","Z05661",2977,523,195,328,"11.0"
"1196","Z05667",1006,191,68,123,"12.2"
"1197","Z05669",400,119,93,26," 6.5"
"1198","Z05672",3553,1564,1405,159," 4.5"
"1199","Z05673",1890,783,724,59," 3.1"
"1200","Z05674",2518,1761,1668,93," 3.7"
"1201","Z05675",596,160,121,39," 6.5"
"1202","Z05676",2354,190,115,75," 3.2"
"1203","Z05677",1011,40,40,0," 0.0"
"1204","Z05679",1378,34,24,10," 0.7"
"1205","Z05680",1031,172,158,14," 1.4"
"1206","Z05681",410,244,225,19," 4.6"
"1207","Z05682",527,62,29,33," 6.3"
"1208","Z05701",10062,1106,333,773," 7.7"
"1209","Z05730",256,129,97,32,"12.5"
"1210","Z05732",582,213,213,0," 0.0"
"1211","Z05733",3074,587,505,82," 2.7"
"1212","Z05734",685,151,88,63," 9.2"
"1213","Z05735",1515,227,160,67," 4.4"
"1214","Z05738",557,133,110,23," 4.1"
"1215","Z05739",802,217,141,76," 9.5"
"1216","Z05743",2451,689,452,237," 9.7"
"1217","Z05744",243,28,11,17," 7.0"
"1218","Z05748",198,45,36,9," 4.5"
"1219","Z05751",2727,2307,2039,268," 9.8"
"1220","Z05753",4056,457,96,361," 8.9"
"1221","Z05757",479,123,115,8," 1.7"
"1222","Z05758",685,318,294,24," 3.5"
"1223","Z05759",866,65,10,55," 6.4"
"1224","Z05760",689,203,175,28," 4.1"
"1225","Z05761",559,181,134,47," 8.4"
"1226","Z05762",414,194,178,16," 3.9"
"1227","Z05763",1395,212,150,62," 4.4"
"1228","Z05764",1868,548,406,142," 7.6"
"1229","Z05765",813,89,20,69," 8.5"
"1230","Z05766",329,60,47,13," 4.0"
"1231","Z05767",834,354,289,65," 7.8"
"1232","Z05769",692,216,199,17," 2.5"
"1233","Z05770",512,90,50,40," 7.8"
"1234","Z05772",498,196,166,30," 6.0"
"1235","Z05773",1030,112,89,23," 2.2"
"1236","Z05774",859,369,319,50," 5.8"
"1237","Z05775",330,77,58,19," 5.8"
"1238","Z05776",463,190,157,33," 7.1"
"1239","Z05777",1553,160,37,123," 7.9"
"1240","Z05778",311,24,4,20," 6.4"
"1241","Z05819",4478,542,206,336," 7.5"
"1242","Z05820",331,52,41,11," 3.3"
"1243","Z05821",669,241,235,6," 0.9"
"1244","Z05822",1089,359,286,73," 6.7"
"1245","Z05824",770,311,277,34," 4.4"
"1246","Z05826",559,204,149,55," 9.8"
"1247","Z05827",261,129,104,25," 9.6"
"1248","Z05828",966,172,118,54," 5.6"
"1249","Z05829",1049,274,251,23," 2.2"
"1250","Z05832",700,418,357,61," 8.7"
"1251","Z05839",481,180,169,11," 2.3"
"1252","Z05841",704,504,465,39," 5.5"
"1253","Z05842",267,64,38,26," 9.7"
"1254","Z05843",1250,218,82,136,"10.9"
"1255","Z05845",568,87,75,12," 2.1"
"1256","Z05846",949,526,458,68," 7.2"
"1257","Z05847",485,179,148,31," 6.4"
"1258","Z05851",2931,285,168,117," 4.0"
"1259","Z05853",815,533,497,36," 4.4"
"1260","Z05855",3374,490,277,213," 6.3"
"1261","Z05857",873,207,149,58," 6.6"
"1262","Z05860",1565,551,444,107," 6.8"
"1263","Z05868",224,53,40,13," 5.8"
"1264","Z05871",1067,442,381,61," 5.7"
"1265","Z05872",545,178,120,58,"10.6"
"1266","Z05873",588,319,276,43," 7.3"
"1267","Z05874",297,97,67,30,"10.1"
"1268","Z05875",388,158,148,10," 2.6"
"1269","Z05905",833,459,453,6," 0.7"
"1270","Z05906",760,238,198,40," 5.3"
"1271","Z05907",358,282,282,0," 0.0"
"1272","Z06001",7574,372,34,338," 4.5"
"1273","Z06002",8823,339,52,287," 3.3"
"1274","Z06010",26953,2032,114,1918," 7.1"
"1275","Z06013",3535,161,8,153," 4.3"
"1276","Z06016",2630,71,0,71," 2.7"
"1277","Z06018",1227,196,58,138,"11.2"
"1278","Z06019",4273,279,69,210," 4.9"
"1279","Z06021",178,60,48,12," 6.7"
"1280","Z06024",369,30,23,7," 1.9"
"1281","Z06026",2134,53,53,0," 0.0"
"1282","Z06029",6638,286,12,274," 4.1"
"1283","Z06031",874,264,237,27," 3.1"
"1284","Z06032",7754,523,118,405," 5.2"
"1285","Z06033",11539,508,64,444," 3.8"
"1286","Z06035",3321,177,0,177," 5.3"
"1287","Z06037",7864,422,40,382," 4.9"
"1288","Z06039",1153,427,312,115,"10.0"
"1289","Z06040",15200,883,10,873," 5.7"
"1290","Z06042",10256,432,0,432," 4.2"
"1291","Z06043",2131,110,10,100," 4.7"
"1292","Z06051",13702,2002,0,2002,"14.6"
"1293","Z06052",3377,363,40,323," 9.6"
"1294","Z06053",14602,1447,64,1383," 9.5"
"1295","Z06057",2611,221,166,55," 2.1"
"1296","Z06058",977,276,218,58," 5.9"
"1297","Z06060",950,162,0,162,"17.1"
"1298","Z06062",8035,573,74,499," 6.2"
"1299","Z06063",1299,50,34,16," 1.2"
"1300","Z06065",311,5,5,0," 0.0"
"1301","Z06066",14139,947,74,873," 6.2"
"1302","Z06067",8408,497,0,497," 5.9"
"1303","Z06068",1135,468,362,106," 9.3"
"1304","Z06069",1729,574,395,179,"10.4"
"1305","Z06070",5692,285,21,264," 4.6"
"1306","Z06071",3607,219,36,183," 5.1"
"1307","Z06073",2183,93,53,40," 1.8"
"1308","Z06074",10143,541,0,541," 5.3"
"1309","Z06076",5768,673,272,401," 7.0"
"1310","Z06078",3777,170,0,170," 4.5"
"1311","Z06082",17446,1221,57,1164," 6.7"
"1312","Z06084",5455,201,15,186," 3.4"
"1313","Z06085",3021,132,0,132," 4.4"
"1314","Z06088",2061,198,0,198," 9.6"
"1315","Z06089",1266,39,0,39," 3.1"
"1316","Z06092",1686,119,0,119," 7.1"
"1317","Z06095",11700,925,63,862," 7.4"
"1318","Z06096",5295,321,0,321," 6.1"
"1319","Z06098",6553,1067,473,594," 9.1"
"1320","Z06103",1093,92,43,49," 4.5"
"1321","Z06105",11145,1458,30,1428,"12.8"
"1322","Z06106",15938,2063,0,2063,"12.9"
"1323","Z06107",7792,175,27,148," 1.9"
"1324","Z06108",10295,963,0,963," 9.4"
"1325","Z06109",11274,499,0,499," 4.4"
"1326","Z06110",5266,328,57,271," 5.1"
"1327","Z06111",12990,341,9,332," 2.6"
"1328","Z06112",9200,1885,75,1810,"19.7"
"1329","Z06114",10539,1134,0,1134,"10.8"
"1330","Z06117",5805,315,83,232," 4.0"
"1331","Z06118",11821,928,0,928," 7.9"
"1332","Z06119",7173,509,100,409," 5.7"
"1333","Z06120",5053,866,0,866,"17.1"
"1334","Z06226",7383,695,78,617," 8.4"
"1335","Z06231",1490,225,104,121," 8.1"
"1336","Z06232",1234,76,0,76," 6.2"
"1337","Z06234",3174,246,0,246," 7.8"
"1338","Z06235",898,99,29,70," 7.8"
"1339","Z06237",2159,96,29,67," 3.1"
"1340","Z06238",4965,385,203,182," 3.7"
"1341","Z06239",4776,436,76,360," 7.5"
"1342","Z06241",3291,476,167,309," 9.4"
"1343","Z06247",1116,50,8,42," 3.8"
"1344","Z06248",2132,27,0,27," 1.3"
"1345","Z06249",3097,436,146,290," 9.4"
"1346","Z06250",2010,130,0,130," 6.5"
"1347","Z06254",772,62,20,42," 5.4"
"1348","Z06255",2018,114,0,114," 5.6"
"1349","Z06256",1076,45,0,45," 4.2"
"1350","Z06259",1640,99,35,64," 3.9"
"1351","Z06260",4213,388,62,326," 7.7"
"1352","Z06264",39,10,0,10,"25.6"
"1353","Z06268",3985,432,26,406,"10.2"
"1354","Z06277",1796,258,165,93," 5.2"
"1355","Z06278",1969,232,149,83," 4.2"
"1356","Z06279",2526,109,0,109," 4.3"
"1357","Z06280",1324,38,0,38," 2.9"
"1358","Z06281",3219,574,175,399,"12.4"
"1359","Z06282",607,131,86,45," 7.4"
"1360","Z06320",12270,1484,107,1377,"11.2"
"1361","Z06330",1376,101,16,85," 6.2"
"1362","Z06331",2036,145,10,135," 6.6"
"1363","Z06332",218,37,0,37,"17.0"
"1364","Z06333",2464,109,22,87," 3.5"
"1365","Z06334",1071,75,22,53," 4.9"
"1366","Z06335",2808,189,0,189," 6.7"
"1367","Z06339",3278,260,57,203," 6.2"
"1368","Z06340",14444,1881,536,1345," 9.3"
"1369","Z06351",6576,509,85,424," 6.4"
"1370","Z06354",2590,244,0,244," 9.4"
"1371","Z06355",6268,732,193,539," 8.6"
"1372","Z06357",5762,889,693,196," 3.4"
"1373","Z06359",2286,267,150,117," 5.1"
"1374","Z06360",17113,2117,46,2071,"12.1"
"1375","Z06365",2042,107,0,107," 5.2"
"1376","Z06370",2860,127,21,106," 3.7"
"1377","Z06371",5892,1763,1375,388," 6.6"
"1378","Z06374",3285,351,0,351,"10.7"
"1379","Z06375",1605,100,28,72," 4.5"
"1380","Z06376",264,171,171,0," 0.0"
"1381","Z06377",972,35,0,35," 3.6"
"1382","Z06378",2983,686,450,236," 7.9"
"1383","Z06379",4102,486,119,367," 8.9"
"1384","Z06380",1181,113,0,113," 9.6"
"1385","Z06382",4654,594,33,561,"12.1"
"1386","Z06384",1151,91,26,65," 5.6"
"1387","Z06385",7166,789,77,712," 9.9"
"1388","Z06390",789,655,614,41," 5.2"
"1389","Z06401",7408,454,38,416," 5.6"
"1390","Z06403",2609,253,45,208," 8.0"
"1391","Z06405",13909,1572,489,1083," 7.8"
"1392","Z06410",10397,476,42,434," 4.2"
"1393","Z06412",2091,261,103,158," 7.6"
"1394","Z06413",6126,819,512,307," 5.0"
"1395","Z06415",6928,982,474,508," 7.3"
"1396","Z06416",5846,390,78,312," 5.3"
"1397","Z06417",2169,252,192,60," 2.8"
"1398","Z06418",5429,518,18,500," 9.2"
"1399","Z06419",2709,196,137,59," 2.2"
"1400","Z06420",1696,166,80,86," 5.1"
"1401","Z06422",2692,98,0,98," 3.6"
"1402","Z06423",2531,512,389,123," 4.9"
"1403","Z06424",5582,643,148,495," 8.9"
"1404","Z06426",1700,227,48,179,"10.5"
"1405","Z06437",9578,853,481,372," 3.9"
"1406","Z06438",1118,41,41,0," 0.0"
"1407","Z06441",2194,157,89,68," 3.1"
"1408","Z06442",1210,26,0,26," 2.1"
"1409","Z06443",7968,1189,1052,137," 1.7"
"1410","Z06450",17325,2409,37,2372,"13.7"
"1411","Z06451",11423,1632,31,1601,"14.0"
"1412","Z06455",1346,39,0,39," 2.9"
"1413","Z06457",21081,2011,250,1761," 8.4"
"1414","Z06460",17427,1716,506,1210," 6.9"
"1415","Z06461",5665,121,20,101," 1.8"
"1416","Z06468",7047,353,93,260," 3.7"
"1417","Z06469",1264,66,52,14," 1.1"
"1418","Z06470",5960,187,19,168," 2.8"
"1419","Z06471",3260,208,0,208," 6.4"
"1420","Z06472",2427,50,0,50," 2.1"
"1421","Z06473",9068,502,22,480," 5.3"
"1422","Z06475",5723,1459,1174,285," 5.0"
"1423","Z06477",5031,156,36,120," 2.4"
"1424","Z06478",4690,305,156,149," 3.2"
"1425","Z06479",4515,381,108,273," 6.0"
"1426","Z06480",4308,401,108,293," 6.8"
"1427","Z06481",476,32,0,32," 6.7"
"1428","Z06482",4207,266,93,173," 4.1"
"1429","Z06483",6649,530,134,396," 6.0"
"1430","Z06484",16471,1079,118,961," 5.8"
"1431","Z06488",8435,766,311,455," 5.4"
"1432","Z06489",13342,541,140,401," 3.0"
"1433","Z06492",19296,1588,84,1504," 7.8"
"1434","Z06498",3672,831,552,279," 7.6"
"1435","Z06510",1710,190,5,185,"10.8"
"1436","Z06511",24117,3256,83,3173,"13.2"
"1437","Z06512",13074,1286,195,1091," 8.3"
"1438","Z06513",16587,1827,104,1723,"10.4"
"1439","Z06514",11169,972,38,934," 8.4"
"1440","Z06515",7259,592,0,592," 8.2"
"1441","Z06516",22290,2153,282,1871," 8.4"
"1442","Z06517",6890,559,44,515," 7.5"
"1443","Z06518",7135,509,14,495," 6.9"
"1444","Z06519",6362,994,0,994,"15.6"
"1445","Z06524",2060,18,0,18," 0.9"
"1446","Z06525",3224,140,35,105," 3.3"
"1447","Z06604",12174,1923,39,1884,"15.5"
"1448","Z06605",9657,1364,115,1249,"12.9"
"1449","Z06606",18062,1514,33,1481," 8.2"
"1450","Z06607",3271,577,0,577,"17.6"
"1451","Z06608",5069,775,10,765,"15.1"
"1452","Z06610",9647,1360,109,1251,"13.0"
"1453","Z06611",12551,428,53,375," 3.0"
"1454","Z06612",2757,75,43,32," 1.2"
"1455","Z06614",14234,820,81,739," 5.2"
"1456","Z06615",8030,730,170,560," 7.0"
"1457","Z06702",1983,378,32,346,"17.4"
"1458","Z06704",11018,1891,27,1864,"16.9"
"1459","Z06705",11526,1348,107,1241,"10.8"
"1460","Z06706",5788,738,13,725,"12.5"
"1461","Z06708",12599,1651,125,1526,"12.1"
"1462","Z06710",4433,1137,0,1137,"25.6"
"1463","Z06712",3311,106,9,97," 2.9"
"1464","Z06716",6043,297,29,268," 4.4"
"1465","Z06750",774,152,113,39," 5.0"
"1466","Z06751",1485,208,174,34," 2.3"
"1467","Z06752",886,133,88,45," 5.1"
"1468","Z06754",897,243,158,85," 9.5"
"1469","Z06755",314,15,15,0," 0.0"
"1470","Z06757",1095,269,209,60," 5.5"
"1471","Z06759",2900,517,336,181," 6.2"
"1472","Z06762",2866,148,23,125," 4.4"
"1473","Z06763",1147,362,296,66," 5.8"
"1474","Z06770",12978,835,88,747," 5.8"
"1475","Z06776",11193,1083,375,708," 6.3"
"1476","Z06777",988,353,331,22," 2.2"
"1477","Z06779",3499,300,0,300," 8.6"
"1478","Z06782",1007,140,30,110,"10.9"
"1479","Z06783",1209,287,150,137,"11.3"
"1480","Z06784",1815,365,280,85," 4.7"
"1481","Z06785",406,135,118,17," 4.2"
"1482","Z06786",4120,297,53,244," 5.9"
"1483","Z06787",3104,122,10,112," 3.6"
"1484","Z06790",17249,2172,445,1727,"10.0"
"1485","Z06791",2265,234,148,86," 3.8"
"1486","Z06794",696,126,117,9," 1.3"
"1487","Z06795",5323,389,82,307," 5.8"
"1488","Z06798",4462,361,49,312," 7.0"
"1489","Z06801",7545,329,16,313," 4.1"
"1490","Z06804",6532,597,196,401," 6.1"
"1491","Z06807",2706,185,49,136," 5.0"
"1492","Z06810",19673,1885,237,1648," 8.4"
"1493","Z06811",12013,937,395,542," 4.5"
"1494","Z06812",5863,1012,631,381," 6.5"
"1495","Z06820",6940,385,90,295," 4.3"
"1496","Z06824",11985,781,210,571," 4.8"
"1497","Z06825",7626,251,82,169," 2.2"
"1498","Z06830",10377,971,225,746," 7.2"
"1499","Z06831",5873,750,220,530," 9.0"
"1500","Z06840",7310,453,103,350," 4.8"
"1501","Z06850",7685,277,22,255," 3.3"
"1502","Z06851",11387,384,101,283," 2.5"
"1503","Z06853",1602,155,10,145," 9.1"
"1504","Z06854",11632,571,33,538," 4.6"
"1505","Z06855",3398,276,24,252," 7.4"
"1506","Z06870",2546,120,8,112," 4.4"
"1507","Z06877",9499,587,114,473," 5.0"
"1508","Z06878",2811,157,14,143," 5.1"
"1509","Z06880",10739,871,289,582," 5.4"
"1510","Z06883",3801,422,165,257," 6.8"
"1511","Z06890",1708,94,26,68," 4.0"
"1512","Z06896",3924,406,108,298," 7.6"
"1513","Z06897",6358,397,87,310," 4.9"
"1514","Z06901",4687,807,123,684,"14.6"
"1515","Z06902",26474,2372,481,1891," 7.1"
"1516","Z06903",5188,170,48,122," 2.4"
"1517","Z06905",7632,474,22,452," 5.9"
"1518","Z06906",3520,168,12,156," 4.4"
"1519","Z06907",3593,176,0,176," 4.9"
"1520","Z07001",5179,205,0,205," 4.0"
"1521","Z07002",27398,1924,340,1584," 5.8"
"1522","Z07003",18493,1014,9,1005," 5.4"
"1523","Z07004",2749,241,55,186," 6.8"
"1524","Z07005",5928,293,0,293," 4.9"
"1525","Z07006",9717,507,131,376," 3.9"
"1526","Z07008",8304,514,36,478," 5.8"
"1527","Z07009",4396,92,0,92," 2.1"
"1528","Z07010",11163,690,0,690," 6.2"
"1529","Z07011",13704,1103,0,1103," 8.0"
"1530","Z07012",5125,471,0,471," 9.2"
"1531","Z07013",10915,984,0,984," 9.0"
"1532","Z07014",1962,194,0,194," 9.9"
"1533","Z07016",8742,393,30,363," 4.2"
"1534","Z07017",17027,2710,0,2710,"15.9"
"1535","Z07018",13503,2233,16,2217,"16.4"
"1536","Z07020",6234,563,74,489," 7.8"
"1537","Z07021",801,53,22,31," 3.9"
"1538","Z07022",5818,414,0,414," 7.1"
"1539","Z07023",2609,101,0,101," 3.9"
"1540","Z07024",18126,1593,171,1422," 7.8"
"1541","Z07026",11707,816,15,801," 6.8"
"1542","Z07027",1776,143,0,143," 8.1"
"1543","Z07028",2529,42,0,42," 1.7"
"1544","Z07029",6340,371,20,351," 5.5"
"1545","Z07030",26464,1885,36,1849," 7.0"
"1546","Z07031",6296,174,0,174," 2.8"
"1547","Z07032",14708,925,102,823," 5.6"
"1548","Z07033",2687,82,0,82," 3.1"
"1549","Z07034",3745,267,39,228," 6.1"
"1550","Z07035",4109,244,0,244," 5.9"
"1551","Z07036",16351,1402,46,1356," 8.3"
"1552","Z07039",10130,434,61,373," 3.7"
"1553","Z07040",8741,750,54,696," 8.0"
"1554","Z07041",2709,199,30,169," 6.2"
"1555","Z07042",10833,758,61,697," 6.4"
"1556","Z07043",4405,112,9,103," 2.3"
"1557","Z07044",5728,323,86,237," 4.1"
"1558","Z07045",3777,131,17,114," 3.0"
"1559","Z07046",1394,24,24,0," 0.0"
"1560","Z07047",23253,1577,94,1483," 6.4"
"1561","Z07050",13015,1890,27,1863,"14.3"
"1562","Z07052",17184,915,229,686," 4.0"
"1563","Z07054",11776,652,32,620," 5.3"
"1564","Z07055",21721,1919,25,1894," 8.7"
"1565","Z07057",5006,412,10,402," 8.0"
"1566","Z07058",2101,124,59,65," 3.1"
"1567","Z07059",5153,143,28,115," 2.2"
"1568","Z07060",15485,1167,35,1132," 7.3"
"1569","Z07062",4511,473,0,473,"10.5"
"1570","Z07063",4145,327,9,318," 7.7"
"1571","Z07064",1263,58,0,58," 4.6"
"1572","Z07065",12002,1144,48,1096," 9.1"
"1573","Z07066",5730,120,0,120," 2.1"
"1574","Z07067",6240,258,20,238," 3.8"
"1575","Z07068",2483,57,0,57," 2.3"
"1576","Z07069",2254,201,16,185," 8.2"
"1577","Z07070",7207,268,48,220," 3.1"
"1578","Z07071",8933,768,43,725," 8.1"
"1579","Z07072",2468,155,0,155," 6.3"
"1580","Z07073",3837,200,0,200," 5.2"
"1581","Z07074",1077,98,4,94," 8.7"
"1582","Z07075",3108,160,0,160," 5.1"
"1583","Z07076",8713,368,65,303," 3.5"
"1584","Z07077",1038,108,0,108,"10.4"
"1585","Z07079",5633,332,41,291," 5.2"
"1586","Z07080",8255,237,0,237," 2.9"
"1587","Z07081",7453,385,108,277," 3.7"
"1588","Z07082",1771,88,30,58," 3.3"
"1589","Z07083",20231,938,49,889," 4.4"
"1590","Z07087",25859,2784,245,2539," 9.8"
"1591","Z07088",1346,103,0,103," 7.7"
"1592","Z07090",10901,534,0,534," 4.9"
"1593","Z07092",2472,160,0,160," 6.5"
"1594","Z07093",25413,1866,265,1601," 6.3"
"1595","Z07094",7359,608,88,520," 7.1"
"1596","Z07095",7776,411,46,365," 4.7"
"1597","Z07102",5395,778,27,751,"13.9"
"1598","Z07103",12454,2354,29,2325,"18.7"
"1599","Z07104",20469,2398,42,2356,"11.5"
"1600","Z07105",17811,1387,40,1347," 7.6"
"1601","Z07106",13280,2541,39,2502,"18.8"
"1602","Z07107",14961,2569,17,2552,"17.1"
"1603","Z07108",9880,2488,0,2488,"25.2"
"1604","Z07109",13861,955,61,894," 6.4"
"1605","Z07111",23877,3815,0,3815,"16.0"
"1606","Z07114",4492,642,0,642,"14.3"
"1607","Z07201",9184,1290,45,1245,"13.6"
"1608","Z07202",14240,1153,17,1136," 8.0"
"1609","Z07203",8678,550,0,550," 6.3"
"1610","Z07204",5413,503,0,503," 9.3"
"1611","Z07205",7606,364,16,348," 4.6"
"1612","Z07208",11841,911,0,911," 7.7"
"1613","Z07302",22124,2944,42,2902,"13.1"
"1614","Z07304",17328,1811,81,1730,"10.0"
"1615","Z07305",25210,3097,65,3032,"12.0"
"1616","Z07306",22095,1822,0,1822," 8.2"
"1617","Z07307",17469,1540,76,1464," 8.4"
"1618","Z07310",6655,846,149,697,"10.5"
"1619","Z07311",317,126,0,126,"39.7"
"1620","Z07401",2426,215,48,167," 6.9"
"1621","Z07403",2914,63,16,47," 1.6"
"1622","Z07405",6556,268,22,246," 3.8"
"1623","Z07407",7145,233,0,233," 3.3"
"1624","Z07410",12080,314,31,283," 2.3"
"1625","Z07416",2594,354,100,254," 9.8"
"1626","Z07417",3888,154,0,154," 4.0"
"1627","Z07418",803,140,50,90,"11.2"
"1628","Z07419",4108,470,78,392," 9.5"
"1629","Z07420",1639,59,11,48," 2.9"
"1630","Z07421",3223,606,192,414,"12.8"
"1631","Z07422",2950,581,342,239," 8.1"
"1632","Z07423",1477,62,0,62," 4.2"
"1633","Z07424",10186,592,44,548," 5.4"
"1634","Z07430",9448,224,76,148," 1.6"
"1635","Z07432",2937,151,41,110," 3.7"
"1636","Z07435",1183,203,155,48," 4.1"
"1637","Z07436",4525,164,11,153," 3.4"
"1638","Z07438",4451,303,134,169," 3.8"
"1639","Z07439",921,44,0,44," 4.8"
"1640","Z07440",1694,86,0,86," 5.1"
"1641","Z07442",4437,317,124,193," 4.3"
"1642","Z07444",4803,160,0,160," 3.3"
"1643","Z07446",5568,132,58,74," 1.3"
"1644","Z07450",8570,264,22,242," 2.8"
"1645","Z07452",3982,120,24,96," 2.4"
"1646","Z07456",4158,356,124,232," 5.6"
"1647","Z07457",2081,122,0,122," 5.9"
"1648","Z07458",3930,212,37,175," 4.5"
"1649","Z07460",1429,147,124,23," 1.6"
"1650","Z07461",8287,1364,730,634," 7.7"
"1651","Z07462",3284,678,389,289," 8.8"
"1652","Z07463",3562,134,17,117," 3.3"
"1653","Z07465",2684,133,55,78," 2.9"
"1654","Z07470",18896,773,116,657," 3.5"
"1655","Z07480",6501,633,188,445," 6.8"
"1656","Z07481",5971,169,33,136," 2.3"
"1657","Z07501",11732,1718,0,1718,"14.6"
"1658","Z07502",4615,478,0,478,"10.4"
"1659","Z07503",5905,466,14,452," 7.7"
"1660","Z07504",3653,438,0,438,"12.0"
"1661","Z07505",1117,117,0,117,"10.5"
"1662","Z07506",7170,341,0,341," 4.8"
"1663","Z07508",7751,433,17,416," 5.4"
"1664","Z07512",3584,276,43,233," 6.5"
"1665","Z07513",3547,294,27,267," 7.5"
"1666","Z07514",7047,670,0,670," 9.5"
"1667","Z07522",7054,1194,0,1194,"16.9"
"1668","Z07524",4155,413,0,413," 9.9"
"1669","Z07601",19620,1451,7,1444," 7.4"
"1670","Z07603",2946,68,0,68," 2.3"
"1671","Z07604",4548,77,0,77," 1.7"
"1672","Z07605",3505,169,10,159," 4.5"
"1673","Z07606",914,5,0,5," 0.5"
"1674","Z07607",3740,210,0,210," 5.6"
"1675","Z07621",9385,413,26,387," 4.1"
"1676","Z07624",2772,85,0,85," 3.1"
"1677","Z07626",3133,169,15,154," 4.9"
"1678","Z07627",1794,112,27,85," 4.7"
"1679","Z07628",6548,240,0,240," 3.7"
"1680","Z07630",2563,162,43,119," 4.6"
"1681","Z07631",11721,1046,86,960," 8.2"
"1682","Z07632",1954,191,15,176," 9.0"
"1683","Z07641",1151,17,0,17," 1.5"
"1684","Z07642",3601,67,0,67," 1.9"
"1685","Z07643",4616,379,0,379," 8.2"
"1686","Z07644",9743,682,12,670," 6.9"
"1687","Z07645",2860,32,32,0," 0.0"
"1688","Z07646",6205,226,5,221," 3.6"
"1689","Z07647",1833,70,2,68," 3.7"
"1690","Z07648",2128,45,8,37," 1.7"
"1691","Z07649",2738,105,43,62," 2.3"
"1692","Z07650",7768,451,0,451," 5.8"
"1693","Z07652",8854,384,14,370," 4.2"
"1694","Z07656",3295,94,30,64," 1.9"
"1695","Z07657",4231,229,8,221," 5.2"
"1696","Z07660",4997,364,7,357," 7.1"
"1697","Z07661",4057,108,17,91," 2.2"
"1698","Z07662",1972,49,0,49," 2.5"
"1699","Z07663",5449,169,14,155," 2.8"
"1700","Z07666",14074,753,11,742," 5.3"
"1701","Z07670",4931,173,12,161," 3.3"
"1702","Z07675",10094,495,14,481," 4.8"
"1703","Z07676",3359,159,38,121," 3.6"
"1704","Z07677",2111,23,0,23," 1.1"
"1705","Z07701",10399,710,129,581," 5.6"
"1706","Z07702",1457,87,0,87," 6.0"
"1707","Z07704",2074,47,0,47," 2.3"
"1708","Z07711",845,280,209,71," 8.4"
"1709","Z07712",18001,1976,595,1381," 7.7"
"1710","Z07716",3814,247,55,192," 5.0"
"1711","Z07718",2408,26,0,26," 1.1"
"1712","Z07719",10418,1744,1089,655," 6.3"
"1713","Z07720",3172,1020,964,56," 1.8"
"1714","Z07721",1191,124,0,124,"10.4"
"1715","Z07722",3374,89,0,89," 2.6"
"1716","Z07723",1211,860,826,34," 2.8"
"1717","Z07724",9533,576,79,497," 5.2"
"1718","Z07726",15883,911,51,860," 5.4"
"1719","Z07727",2843,124,8,116," 4.1"
"1720","Z07728",20813,1052,104,948," 4.6"
"1721","Z07730",6163,229,0,229," 3.7"
"1722","Z07731",12893,354,62,292," 2.3"
"1723","Z07732",3493,960,360,600,"17.2"
"1724","Z07733",5942,325,45,280," 4.7"
"1725","Z07734",6343,978,0,978,"15.4"
"1726","Z07735",7604,478,0,478," 6.3"
"1727","Z07738",2081,31,0,31," 1.5"
"1728","Z07739",2209,129,67,62," 2.8"
"1729","Z07740",14996,2896,1406,1490," 9.9"
"1730","Z07746",6326,116,0,116," 1.8"
"1731","Z07747",12255,689,114,575," 4.7"
"1732","Z07748",9871,329,21,308," 3.1"
"1733","Z07750",2019,588,447,141," 7.0"
"1734","Z07751",6357,361,0,361," 5.7"
"1735","Z07753",16691,1198,132,1066," 6.4"
"1736","Z07755",2360,254,189,65," 2.8"
"1737","Z07756",3049,1315,896,419,"13.7"
"1738","Z07757",2248,111,0,111," 4.9"
"1739","Z07758",1810,239,26,213,"11.8"
"1740","Z07760",4008,688,345,343," 8.6"
"1741","Z07762",5270,1469,1044,425," 8.1"
"1742","Z07764",2535,63,29,34," 1.3"
"1743","Z07801",8574,540,17,523," 6.1"
"1744","Z07803",1233,51,0,51," 4.1"
"1745","Z07821",3712,393,235,158," 4.3"
"1746","Z07823",3662,361,97,264," 7.2"
"1747","Z07825",3673,305,129,176," 4.8"
"1748","Z07826",2838,478,238,240," 8.5"
"1749","Z07827",1974,282,94,188," 9.5"
"1750","Z07828",6101,387,30,357," 5.9"
"1751","Z07830",2749,342,94,248," 9.0"
"1752","Z07832",1605,141,10,131," 8.2"
"1753","Z07834",7317,379,36,343," 4.7"
"1754","Z07836",4822,301,0,301," 6.2"
"1755","Z07838",1461,64,16,48," 3.3"
"1756","Z07840",12604,799,166,633," 5.0"
"1757","Z07843",5172,617,179,438," 8.5"
"1758","Z07848",1726,187,12,175,"10.1"
"1759","Z07849",3873,467,242,225," 5.8"
"1760","Z07850",2393,134,25,109," 4.6"
"1761","Z07851",47,20,0,20,"42.6"
"1762","Z07852",1524,105,19,86," 5.6"
"1763","Z07853",4507,173,28,145," 3.2"
"1764","Z07856",2350,397,125,272,"11.6"
"1765","Z07857",1518,21,0,21," 1.4"
"1766","Z07860",11402,1377,597,780," 6.8"
"1767","Z07863",1683,93,0,93," 5.5"
"1768","Z07865",779,7,0,7," 0.9"
"1769","Z07866",8591,491,16,475," 5.5"
"1770","Z07869",9261,241,0,241," 2.6"
"1771","Z07871",7738,749,280,469," 6.1"
"1772","Z07874",3433,345,0,345,"10.0"
"1773","Z07876",3483,98,3,95," 2.7"
"1774","Z07878",414,90,0,90,"21.7"
"1775","Z07882",5822,478,76,402," 6.9"
"1776","Z07885",3962,76,0,76," 1.9"
"1777","Z07901",8725,448,94,354," 4.1"
"1778","Z07920",10091,372,43,329," 3.3"
"1779","Z07921",4265,305,19,286," 6.7"
"1780","Z07922",4354,238,0,238," 5.5"
"1781","Z07924",3087,301,69,232," 7.5"
"1782","Z07927",1506,91,0,91," 6.0"
"1783","Z07928",7067,443,18,425," 6.0"
"1784","Z07930",3088,289,19,270," 8.7"
"1785","Z07931",1241,129,69,60," 4.8"
"1786","Z07932",4167,184,45,139," 3.3"
"1787","Z07934",597,40,0,40," 6.7"
"1788","Z07936",4052,143,6,137," 3.4"
"1789","Z07940",5799,292,37,255," 4.4"
"1790","Z07945",3133,78,20,58," 1.9"
"1791","Z07950",7495,380,43,337," 4.5"
"1792","Z07960",18417,1416,480,936," 5.1"
"1793","Z07974",4253,208,18,190," 4.5"
"1794","Z07976",260,29,29,0," 0.0"
"1795","Z07980",849,39,15,24," 2.8"
"1796","Z07981",3657,136,0,136," 3.7"
"1797","Z08001",462,59,0,59,"12.8"
"1798","Z08002",9133,634,7,627," 6.9"
"1799","Z08003",11116,412,21,391," 3.5"
"1800","Z08004",4389,408,32,376," 8.6"
"1801","Z08005",10223,1377,686,691," 6.8"
"1802","Z08006",1145,892,860,32," 2.8"
"1803","Z08007",2244,150,0,150," 6.7"
"1804","Z08008",17046,13707,13194,513," 3.0"
"1805","Z08009",4913,334,41,293," 6.0"
"1806","Z08010",5057,516,0,516,"10.2"
"1807","Z08012",15681,820,0,820," 5.2"
"1808","Z08015",7956,653,0,653," 8.2"
"1809","Z08016",12846,1075,54,1021," 7.9"
"1810","Z08019",405,41,0,41,"10.1"
"1811","Z08020",939,51,0,51," 5.4"
"1812","Z08021",19964,2031,79,1952," 9.8"
"1813","Z08022",3687,175,55,120," 3.3"
"1814","Z08026",802,23,0,23," 2.9"
"1815","Z08027",2192,144,8,136," 6.2"
"1816","Z08028",7290,749,17,732,"10.0"
"1817","Z08029",1945,90,0,90," 4.6"
"1818","Z08030",5311,561,14,547,"10.3"
"1819","Z08031",4805,361,0,361," 7.5"
"1820","Z08033",6607,242,20,222," 3.4"
"1821","Z08034",7326,448,103,345," 4.7"
"1822","Z08035",3109,184,0,184," 5.9"
"1823","Z08036",2267,93,0,93," 4.1"
"1824","Z08037",9434,806,100,706," 7.5"
"1825","Z08041",367,4,0,4," 1.1"
"1826","Z08043",11643,657,36,621," 5.3"
"1827","Z08046",11170,811,29,782," 7.0"
"1828","Z08048",4719,262,14,248," 5.3"
"1829","Z08049",2323,156,0,156," 6.7"
"1830","Z08050",12863,3432,2434,998," 7.8"
"1831","Z08051",4782,151,0,151," 3.2"
"1832","Z08052",9074,812,17,795," 8.8"
"1833","Z08053",18407,1197,76,1121," 6.1"
"1834","Z08054",18364,1148,138,1010," 5.5"
"1835","Z08055",10317,384,65,319," 3.1"
"1836","Z08056",1527,11,11,0," 0.0"
"1837","Z08057",7817,534,51,483," 6.2"
"1838","Z08059",2358,279,53,226," 9.6"
"1839","Z08060",9546,701,44,657," 6.9"
"1840","Z08062",5250,95,18,77," 1.5"
"1841","Z08063",1136,64,0,64," 5.6"
"1842","Z08065",3561,375,20,355,"10.0"
"1843","Z08066",3944,527,0,527,"13.4"
"1844","Z08067",660,58,0,58," 8.8"
"1845","Z08068",2885,108,0,108," 3.7"
"1846","Z08069",5376,762,38,724,"13.5"
"1847","Z08070",5854,620,58,562," 9.6"
"1848","Z08071",3932,299,9,290," 7.4"
"1849","Z08075",11354,974,27,947," 8.3"
"1850","Z08077",7206,338,24,314," 4.4"
"1851","Z08078",3351,265,0,265," 7.9"
"1852","Z08079",4933,907,47,860,"17.4"
"1853","Z08080",12882,327,24,303," 2.4"
"1854","Z08081",18215,1802,168,1634," 9.0"
"1855","Z08083",3853,239,0,239," 6.2"
"1856","Z08084",2858,257,23,234," 8.2"
"1857","Z08085",7095,468,0,468," 6.6"
"1858","Z08086",3438,399,6,393,"11.4"
"1859","Z08087",12971,2992,1796,1196," 9.2"
"1860","Z08088",9914,532,17,515," 5.2"
"1861","Z08089",1755,145,3,142," 8.1"
"1862","Z08090",3099,103,13,90," 2.9"
"1863","Z08091",2110,135,0,135," 6.4"
"1864","Z08092",1481,170,149,21," 1.4"
"1865","Z08093",4141,249,0,249," 6.0"
"1866","Z08094",15402,1029,23,1006," 6.5"
"1867","Z08096",14844,1130,0,1130," 7.6"
"1868","Z08097",1193,77,0,77," 6.5"
"1869","Z08098",3769,387,114,273," 7.2"
"1870","Z08102",2965,551,0,551,"18.6"
"1871","Z08103",6282,1579,9,1570,"25.0"
"1872","Z08104",10612,1946,15,1931,"18.2"
"1873","Z08105",10246,1501,0,1501,"14.6"
"1874","Z08106",4265,203,0,203," 4.8"
"1875","Z08107",6101,912,0,912,"14.9"
"1876","Z08108",8131,742,29,713," 8.8"
"1877","Z08109",9265,1014,29,985,"10.6"
"1878","Z08110",6429,689,24,665,"10.3"
"1879","Z08201",4421,388,24,364," 8.2"
"1880","Z08202",5575,4713,4130,583,"10.5"
"1881","Z08203",9319,4928,4484,444," 4.8"
"1882","Z08204",13346,5593,4534,1059," 7.9"
"1883","Z08205",10989,1024,451,573," 5.2"
"1884","Z08210",7749,1483,1072,411," 5.3"
"1885","Z08215",5787,652,64,588,"10.2"
"1886","Z08221",2771,199,26,173," 6.2"
"1887","Z08223",2546,845,742,103," 4.0"
"1888","Z08224",188,22,0,22,"11.7"
"1889","Z08225",3212,157,34,123," 3.8"
"1890","Z08226",20204,14544,12645,1899," 9.4"
"1891","Z08230",2624,507,427,80," 3.0"
"1892","Z08232",6981,794,115,679," 9.7"
"1893","Z08234",15686,1310,218,1092," 7.0"
"1894","Z08241",375,22,22,0," 0.0"
"1895","Z08242",1826,536,366,170," 9.3"
"1896","Z08243",6885,5902,4973,929,"13.5"
"1897","Z08244",5541,924,592,332," 6.0"
"1898","Z08247",3237,2802,2463,339,"10.5"
"1899","Z08251",6543,2419,1898,521," 8.0"
"1900","Z08260",23896,17692,15839,1853," 7.8"
"1901","Z08270",3421,466,243,223," 6.5"
"1902","Z08302",15380,1579,87,1492," 9.7"
"1903","Z08310",867,142,46,96,"11.1"
"1904","Z08311",778,77,5,72," 9.3"
"1905","Z08312",3111,185,0,185," 5.9"
"1906","Z08316",155,20,0,20,"12.9"
"1907","Z08317",496,22,0,22," 4.4"
"1908","Z08318",4835,401,23,378," 7.8"
"1909","Z08321",302,222,183,39,"12.9"
"1910","Z08322",3863,362,6,356," 9.2"
"1911","Z08323",400,32,12,20," 5.0"
"1912","Z08326",691,119,0,119,"17.2"
"1913","Z08327",170,22,0,22,"12.9"
"1914","Z08328",574,74,0,74,"12.9"
"1915","Z08330",11505,947,117,830," 7.2"
"1916","Z08332",14804,1444,47,1397," 9.4"
"1917","Z08340",290,55,0,55,"19.0"
"1918","Z08341",1023,27,0,27," 2.6"
"1919","Z08343",1867,152,33,119," 6.4"
"1920","Z08344",2111,237,89,148," 7.0"
"1921","Z08349",1018,195,10,185,"18.2"
"1922","Z08350",438,86,42,44,"10.0"
"1923","Z08353",225,31,0,31,"13.8"
"1924","Z08360",16391,1403,127,1276," 7.8"
"1925","Z08361",6906,620,36,584," 8.5"
"1926","Z08401",19929,4296,1415,2881,"14.5"
"1927","Z08402",7256,3971,3524,447," 6.2"
"1928","Z08403",1752,1193,1137,56," 3.2"
"1929","Z08406",7603,3329,2782,547," 7.2"
"1930","Z08501",2443,149,13,136," 5.6"
"1931","Z08502",3810,164,32,132," 3.5"
"1932","Z08505",7469,603,14,589," 7.9"
"1933","Z08510",1765,187,22,165," 9.3"
"1934","Z08511",265,6,0,6," 2.3"
"1935","Z08512",4302,298,0,298," 6.9"
"1936","Z08514",1757,39,0,39," 2.2"
"1937","Z08515",1972,78,0,78," 4.0"
"1938","Z08518",2448,226,7,219," 8.9"
"1939","Z08520",9979,542,0,542," 5.4"
"1940","Z08525",2019,84,12,72," 3.6"
"1941","Z08527",21025,1013,45,968," 4.6"
"1942","Z08530",3442,231,6,225," 6.5"
"1943","Z08533",2196,70,0,70," 3.2"
"1944","Z08534",5102,161,72,89," 1.7"
"1945","Z08535",1814,15,0,15," 0.8"
"1946","Z08536",8892,836,29,807," 9.1"
"1947","Z08540",17981,1240,97,1143," 6.4"
"1948","Z08542",1829,217,54,163," 8.9"
"1949","Z08550",6829,235,37,198," 2.9"
"1950","Z08551",1832,63,0,63," 3.4"
"1951","Z08553",262,15,6,9," 3.4"
"1952","Z08554",1641,136,0,136," 8.3"
"1953","Z08558",2434,122,40,82," 3.4"
"1954","Z08559",2131,156,86,70," 3.3"
"1955","Z08562",1974,188,0,188," 9.5"
"1956","Z08608",581,176,0,176,"30.3"
"1957","Z08609",5779,1191,0,1191,"20.6"
"1958","Z08610",12352,1131,24,1107," 9.0"
"1959","Z08611",9792,1777,0,1777,"18.1"
"1960","Z08618",16027,2873,58,2815,"17.6"
"1961","Z08619",9421,726,23,703," 7.5"
"1962","Z08620",4709,348,0,348," 7.4"
"1963","Z08628",4177,237,15,222," 5.3"
"1964","Z08629",4287,389,0,389," 9.1"
"1965","Z08638",9157,1113,63,1050,"11.5"
"1966","Z08640",1036,149,24,125,"12.1"
"1967","Z08641",1334,178,0,178,"13.3"
"1968","Z08690",7422,94,9,85," 1.1"
"1969","Z08691",6040,130,0,130," 2.2"
"1970","Z08701",26699,2443,515,1928," 7.2"
"1971","Z08721",8558,912,492,420," 4.9"
"1972","Z08722",3939,225,30,195," 5.0"
"1973","Z08723",14309,1704,823,881," 6.2"
"1974","Z08724",18441,1579,399,1180," 6.4"
"1975","Z08730",2159,302,235,67," 3.1"
"1976","Z08731",9095,1239,749,490," 5.4"
"1977","Z08732",769,126,80,46," 6.0"
"1978","Z08733",903,80,13,67," 7.4"
"1979","Z08734",3391,329,225,104," 3.1"
"1980","Z08735",6966,5280,4491,789,"11.3"
"1981","Z08736",6158,1358,946,412," 6.7"
"1982","Z08740",1190,352,280,72," 6.1"
"1983","Z08741",1086,144,86,58," 5.3"
"1984","Z08742",12451,2840,1893,947," 7.6"
"1985","Z08750",2023,592,534,58," 2.9"
"1986","Z08751",5387,3541,2302,1239,"23.0"
"1987","Z08752",4382,3081,2784,297," 6.8"
"1988","Z08753",26136,2852,1573,1279," 4.9"
"1989","Z08755",10647,591,139,452," 4.2"
"1990","Z08757",18910,1922,294,1628," 8.6"
"1991","Z08758",3806,460,319,141," 3.7"
"1992","Z08759",21579,2788,382,2406,"11.1"
"1993","Z08801",2818,159,0,159," 5.6"
"1994","Z08802",1536,71,5,66," 4.3"
"1995","Z08804",1071,77,0,77," 7.2"
"1996","Z08805",5210,843,0,843,"16.2"
"1997","Z08807",13600,494,10,484," 3.6"
"1998","Z08809",2040,87,0,87," 4.3"
"1999","Z08810",2907,160,69,91," 3.1"
"2000","Z08812",5005,322,0,322," 6.4"
"2001","Z08816",17104,864,74,790," 4.6"
"2002","Z08817",16273,677,67,610," 3.7"
"2003","Z08820",13886,618,76,542," 3.9"
"2004","Z08821",104,13,0,13,"12.5"
"2005","Z08822",12164,490,40,450," 3.7"
"2006","Z08823",3971,289,0,289," 7.3"
"2007","Z08824",4209,76,0,76," 1.8"
"2008","Z08825",1805,171,17,154," 8.5"
"2009","Z08826",2310,144,3,141," 6.1"
"2010","Z08827",1766,64,0,64," 3.6"
"2011","Z08828",948,91,13,78," 8.2"
"2012","Z08829",1583,53,0,53," 3.3"
"2013","Z08830",6294,255,0,255," 4.1"
"2014","Z08831",20693,930,275,655," 3.2"
"2015","Z08832",847,13,0,13," 1.5"
"2016","Z08833",3423,140,17,123," 3.6"
"2017","Z08835",4478,689,0,689,"15.4"
"2018","Z08836",1341,22,0,22," 1.6"
"2019","Z08837",6792,458,70,388," 5.7"
"2020","Z08840",6044,168,12,156," 2.6"
"2021","Z08844",14106,739,44,695," 4.9"
"2022","Z08846",5101,219,0,219," 4.3"
"2023","Z08848",3277,277,22,255," 7.8"
"2024","Z08850",3195,136,0,136," 4.3"
"2025","Z08852",6834,324,29,295," 4.3"
"2026","Z08853",1781,19,19,0," 0.0"
"2027","Z08854",17344,735,30,705," 4.1"
"2028","Z08857",15286,663,150,513," 3.4"
"2029","Z08859",8268,630,67,563," 6.8"
"2030","Z08861",18265,1179,19,1160," 6.4"
"2031","Z08863",4607,207,0,207," 4.5"
"2032","Z08865",13099,1444,58,1386,"10.6"
"2033","Z08867",1989,174,17,157," 7.9"
"2034","Z08869",3071,359,68,291," 9.5"
"2035","Z08872",7484,332,33,299," 4.0"
"2036","Z08873",20385,1446,319,1127," 5.5"
"2037","Z08876",9290,1156,23,1133,"12.2"
"2038","Z08879",9986,579,119,460," 4.6"
"2039","Z08880",1851,246,28,218,"11.8"
"2040","Z08882",5970,596,42,554," 9.3"
"2041","Z08884",3419,144,28,116," 3.4"
"2042","Z08886",2467,140,0,140," 5.7"
"2043","Z08887",584,24,0,24," 4.1"
"2044","Z08889",3844,155,0,155," 4.0"
"2045","Z08901",15747,1418,56,1362," 8.6"
"2046","Z08902",15387,518,33,485," 3.2"
"2047","Z08904",6046,356,92,264," 4.4"
"2048","Z10001",13305,1666,895,771," 5.8"
"2049","Z10002",35691,2343,633,1710," 4.8"
"2050","Z10003",31575,4088,1594,2494," 7.9"
"2051","Z10004",2082,508,193,315,"15.1"
"2052","Z10005",5254,1002,368,634,"12.1"
"2053","Z10006",2155,410,54,356,"16.5"
"2054","Z10009",31531,1761,237,1524," 4.8"
"2055","Z10010",18044,1994,748,1246," 6.9"
"2056","Z10011",34012,4250,2081,2169," 6.4"
"2057","Z10012",14340,1870,804,1066," 7.4"
"2058","Z10013",13750,2192,981,1211," 8.8"
"2059","Z10014",21862,3076,1018,2058," 9.4"
"2060","Z10016",34644,6254,3298,2956," 8.5"
"2061","Z10017",12845,2688,1474,1214," 9.5"
"2062","Z10018",5546,834,306,528," 9.5"
"2063","Z10019",31998,8852,4853,3999,"12.5"
"2064","Z10021",29445,5706,3574,2132," 7.2"
"2065","Z10022",23493,5601,3934,1667," 7.1"
"2066","Z10023",40991,8236,3426,4810,"11.7"
"2067","Z10024",33948,5273,1358,3915,"11.5"
"2068","Z10025",47945,4489,1476,3013," 6.3"
"2069","Z10026",16384,1857,96,1761,"10.7"
"2070","Z10027",25538,2601,77,2524," 9.9"
"2071","Z10028",27642,2701,1240,1461," 5.3"
"2072","Z10029",32559,2444,437,2007," 6.2"
"2073","Z10030",13217,1326,0,1326,"10.0"
"2074","Z10031",23029,1838,106,1732," 7.5"
"2075","Z10032",21691,1448,193,1255," 5.8"
"2076","Z10033",20484,936,110,826," 4.0"
"2077","Z10034",16245,783,149,634," 3.9"
"2078","Z10035",14452,1453,98,1355," 9.4"
"2079","Z10036",18404,2949,941,2008,"10.9"
"2080","Z10037",9856,747,76,671," 6.8"
"2081","Z10038",10988,1208,403,805," 7.3"
"2082","Z10039",11265,634,40,594," 5.3"
"2083","Z10040",16823,821,78,743," 4.4"
"2084","Z10044",5263,641,207,434," 8.2"
"2085","Z10065",22375,5633,2667,2966,"13.3"
"2086","Z10069",3819,969,476,493,"12.9"
"2087","Z10075",16688,2543,1236,1307," 7.8"
"2088","Z10128",35411,3491,1374,2117," 6.0"
"2089","Z10162",808,137,102,35," 4.3"
"2090","Z10280",5247,659,274,385," 7.3"
"2091","Z10301",16071,2008,128,1880,"11.7"
"2092","Z10302",6567,550,27,523," 8.0"
"2093","Z10303",9071,1042,9,1033,"11.4"
"2094","Z10304",16082,1518,128,1390," 8.6"
"2095","Z10305",16091,1160,68,1092," 6.8"
"2096","Z10306",21634,1419,83,1336," 6.2"
"2097","Z10307",5402,292,9,283," 5.2"
"2098","Z10308",10940,265,30,235," 2.1"
"2099","Z10309",11570,518,40,478," 4.1"
"2100","Z10310",9310,1006,61,945,"10.2"
"2101","Z10312",22355,825,14,811," 3.6"
"2102","Z10314",33043,1749,182,1567," 4.7"
"2103","Z10451",19269,1129,20,1109," 5.8"
"2104","Z10452",26831,1399,16,1383," 5.2"
"2105","Z10453",28541,1739,66,1673," 5.9"
"2106","Z10454",13768,978,23,955," 6.9"
"2107","Z10455",14920,897,0,897," 6.0"
"2108","Z10456",31394,2139,19,2120," 6.8"
"2109","Z10457",25676,1927,20,1907," 7.4"
"2110","Z10458",28205,1856,71,1785," 6.3"
"2111","Z10459",17104,1416,213,1203," 7.0"
"2112","Z10460",21046,1270,0,1270," 6.0"
"2113","Z10461",20621,1535,50,1485," 7.2"
"2114","Z10462",31096,1751,323,1428," 4.6"
"2115","Z10463",29833,2375,243,2132," 7.1"
"2116","Z10464",2258,234,14,220," 9.7"
"2117","Z10465",16898,1338,140,1198," 7.1"
"2118","Z10466",24681,1790,27,1763," 7.1"
"2119","Z10467",37364,2186,68,2118," 5.7"
"2120","Z10468",26351,1720,38,1682," 6.4"
"2121","Z10469",23730,1716,78,1638," 6.9"
"2122","Z10470",6341,594,31,563," 8.9"
"2123","Z10471",9701,1081,96,985,"10.2"
"2124","Z10472",23404,2101,166,1935," 8.3"
"2125","Z10473",21807,1183,113,1070," 4.9"
"2126","Z10474",4162,549,122,427,"10.3"
"2127","Z10475",18910,639,0,639," 3.4"
"2128","Z10502",1930,71,0,71," 3.7"
"2129","Z10504",2654,181,0,181," 6.8"
"2130","Z10506",2175,313,249,64," 2.9"
"2131","Z10507",2184,239,15,224,"10.3"
"2132","Z10509",7119,530,227,303," 4.3"
"2133","Z10510",3652,169,98,71," 1.9"
"2134","Z10512",10319,1250,516,734," 7.1"
"2135","Z10514",4228,209,0,209," 4.9"
"2136","Z10516",2423,329,199,130," 5.4"
"2137","Z10517",166,5,5,0," 0.0"
"2138","Z10518",538,26,26,0," 0.0"
"2139","Z10522",3815,130,25,105," 2.8"
"2140","Z10523",3115,347,15,332,"10.7"
"2141","Z10524",1795,356,208,148," 8.2"
"2142","Z10526",720,70,0,70," 9.7"
"2143","Z10527",292,13,0,13," 4.5"
"2144","Z10528",4759,287,50,237," 5.0"
"2145","Z10530",6172,377,93,284," 4.6"
"2146","Z10532",1677,13,0,13," 0.8"
"2147","Z10533",2796,241,110,131," 4.7"
"2148","Z10536",3809,272,147,125," 3.3"
"2149","Z10538",6288,324,85,239," 3.8"
"2150","Z10541",9381,560,152,408," 4.3"
"2151","Z10543",8047,453,39,414," 5.1"
"2152","Z10546",481,49,0,49,"10.2"
"2153","Z10547",2794,229,110,119," 4.3"
"2154","Z10548",1282,76,0,76," 5.9"
"2155","Z10549",6206,504,253,251," 4.0"
"2156","Z10550",15174,1866,42,1824,"12.0"
"2157","Z10552",9042,756,38,718," 7.9"
"2158","Z10553",3563,243,0,243," 6.8"
"2159","Z10560",2094,360,182,178," 8.5"
"2160","Z10562",10782,724,86,638," 5.9"
"2161","Z10566",9935,863,82,781," 7.9"
"2162","Z10567",7284,390,128,262," 3.6"
"2163","Z10570",4390,170,43,127," 2.9"
"2164","Z10573",13510,1010,85,925," 6.8"
"2165","Z10576",2216,352,272,80," 3.6"
"2166","Z10577",862,37,24,13," 1.5"
"2167","Z10579",3697,553,419,134," 3.6"
"2168","Z10580",6321,386,99,287," 4.5"
"2169","Z10583",14334,632,94,538," 3.8"
"2170","Z10588",1095,40,0,40," 3.7"
"2171","Z10589",4038,264,86,178," 4.4"
"2172","Z10590",2807,250,164,86," 3.1"
"2173","Z10591",9194,566,128,438," 4.8"
"2174","Z10594",1683,96,0,96," 5.7"
"2175","Z10595",2332,100,0,100," 4.3"
"2176","Z10596",753,133,51,82,"10.9"
"2177","Z10598",10891,513,80,433," 4.0"
"2178","Z10601",5720,393,65,328," 5.7"
"2179","Z10603",7073,344,56,288," 4.1"
"2180","Z10604",4137,285,26,259," 6.3"
"2181","Z10605",7095,318,56,262," 3.7"
"2182","Z10606",5938,334,29,305," 5.1"
"2183","Z10607",2119,40,0,40," 1.9"
"2184","Z10701",26016,4392,91,4301,"16.5"
"2185","Z10703",7894,906,34,872,"11.0"
"2186","Z10704",13200,893,47,846," 6.4"
"2187","Z10705",15080,1508,33,1475," 9.8"
"2188","Z10707",4126,32,0,32," 0.8"
"2189","Z10708",9861,686,116,570," 5.8"
"2190","Z10709",3876,255,7,248," 6.4"
"2191","Z10710",10862,658,97,561," 5.2"
"2192","Z10801",15376,1197,96,1101," 7.2"
"2193","Z10803",4225,326,36,290," 6.9"
"2194","Z10804",5189,136,0,136," 2.6"
"2195","Z10805",8060,320,26,294," 3.6"
"2196","Z10901",9301,642,72,570," 6.1"
"2197","Z10913",1709,90,0,90," 5.3"
"2198","Z10916",1291,26,5,21," 1.6"
"2199","Z10918",4094,100,27,73," 1.8"
"2200","Z10920",3060,48,0,48," 1.6"
"2201","Z10921",1426,22,0,22," 1.5"
"2202","Z10922",713,165,39,126,"17.7"
"2203","Z10923",2688,65,0,65," 2.4"
"2204","Z10924",5066,451,57,394," 7.8"
"2205","Z10925",2333,500,261,239,"10.2"
"2206","Z10926",1524,131,19,112," 7.3"
"2207","Z10927",3823,211,13,198," 5.2"
"2208","Z10928",2006,137,53,84," 4.2"
"2209","Z10930",3104,307,163,144," 4.6"
"2210","Z10931",386,51,7,44,"11.4"
"2211","Z10940",19083,1727,103,1624," 8.5"
"2212","Z10941",4939,252,38,214," 4.3"
"2213","Z10950",14343,1578,540,1038," 7.2"
"2214","Z10952",9881,636,106,530," 5.4"
"2215","Z10953",72,22,0,22,"30.6"
"2216","Z10954",8951,337,103,234," 2.6"
"2217","Z10956",10501,418,55,363," 3.5"
"2218","Z10958",992,127,10,117,"11.8"
"2219","Z10960",6760,617,97,520," 7.7"
"2220","Z10962",1833,56,0,56," 3.1"
"2221","Z10963",943,120,10,110,"11.7"
"2222","Z10964",643,70,9,61," 9.5"
"2223","Z10965",5761,261,0,261," 4.5"
"2224","Z10968",1254,82,38,44," 3.5"
"2225","Z10969",550,12,0,12," 2.2"
"2226","Z10970",3662,187,0,187," 5.1"
"2227","Z10973",887,63,0,63," 7.1"
"2228","Z10974",1142,45,0,45," 3.9"
"2229","Z10977",16256,1134,37,1097," 6.7"
"2230","Z10980",4915,305,40,265," 5.4"
"2231","Z10983",2025,128,8,120," 5.9"
"2232","Z10986",664,65,0,65," 9.8"
"2233","Z10987",1564,179,101,78," 5.0"
"2234","Z10988",356,36,7,29," 8.1"
"2235","Z10989",3608,173,44,129," 3.6"
"2236","Z10990",7834,551,78,473," 6.0"
"2237","Z10992",3557,392,67,325," 9.1"
"2238","Z10993",1528,15,0,15," 1.0"
"2239","Z10996",881,67,0,67," 7.6"
"2240","Z10998",916,56,9,47," 5.1"
"2241","Z11001",9536,405,7,398," 4.2"
"2242","Z11003",12598,556,17,539," 4.3"
"2243","Z11004",5028,166,9,157," 3.1"
"2244","Z11005",1818,296,99,197,"10.8"
"2245","Z11010",8263,436,25,411," 5.0"
"2246","Z11020",2065,107,11,96," 4.6"
"2247","Z11021",8227,759,188,571," 6.9"
"2248","Z11023",3343,322,39,283," 8.5"
"2249","Z11024",2286,143,32,111," 4.9"
"2250","Z11030",6541,579,259,320," 4.9"
"2251","Z11040",13528,583,74,509," 3.8"
"2252","Z11050",12103,1056,155,901," 7.4"
"2253","Z11096",2679,172,0,172," 6.4"
"2254","Z11101",12989,1217,238,979," 7.5"
"2255","Z11102",15533,1494,93,1401," 9.0"
"2256","Z11103",18029,1422,312,1110," 6.2"
"2257","Z11104",12349,809,97,712," 5.8"
"2258","Z11105",16841,1309,169,1140," 6.8"
"2259","Z11106",18561,1557,224,1333," 7.2"
"2260","Z11109",3077,517,172,345,"11.2"
"2261","Z11201",28807,3143,338,2805," 9.7"
"2262","Z11203",30023,2576,35,2541," 8.5"
"2263","Z11204",26307,1827,286,1541," 5.9"
"2264","Z11205",16871,1673,26,1647," 9.8"
"2265","Z11206",31686,2161,105,2056," 6.5"
"2266","Z11207",35581,3576,344,3232," 9.1"
"2267","Z11208",35583,5777,2744,3033," 8.5"
"2268","Z11209",33265,2782,386,2396," 7.2"
"2269","Z11210",23535,1610,102,1508," 6.4"
"2270","Z11211",39665,2284,183,2101," 5.3"
"2271","Z11212",34087,2644,102,2542," 7.5"
"2272","Z11213",26560,2397,222,2175," 8.2"
"2273","Z11214",33320,1808,173,1635," 4.9"
"2274","Z11215",31159,1977,195,1782," 5.7"
"2275","Z11216",26721,3673,87,3586,"13.4"
"2276","Z11217",18280,1483,109,1374," 7.5"
"2277","Z11218",26248,1339,146,1193," 4.5"
"2278","Z11219",28493,2103,345,1758," 6.2"
"2279","Z11220",31817,2418,202,2216," 7.0"
"2280","Z11221",33376,4458,161,4297,"12.9"
"2281","Z11222",18317,1628,67,1561," 8.5"
"2282","Z11223",29772,2240,467,1773," 6.0"
"2283","Z11224",19901,1837,177,1660," 8.3"
"2284","Z11225",24842,1709,30,1679," 6.8"
"2285","Z11226",39457,3448,58,3390," 8.6"
"2286","Z11228",16467,1182,212,970," 5.9"
"2287","Z11229",32917,2153,186,1967," 6.0"
"2288","Z11230",32400,1747,257,1490," 4.6"
"2289","Z11231",16446,1181,29,1152," 7.0"
"2290","Z11232",9382,598,86,512," 5.5"
"2291","Z11233",30899,3912,44,3868,"12.5"
"2292","Z11234",34442,2257,197,2060," 6.0"
"2293","Z11235",35697,3632,443,3189," 8.9"
"2294","Z11236",34589,2147,149,1998," 5.8"
"2295","Z11237",17820,1238,32,1206," 6.8"
"2296","Z11238",25974,2664,39,2625,"10.1"
"2297","Z11239",6576,214,0,214," 3.3"
"2298","Z11354",22012,2006,446,1560," 7.1"
"2299","Z11355",30133,2779,1025,1754," 5.8"
"2300","Z11356",8366,654,149,505," 6.0"
"2301","Z11357",16023,1177,330,847," 5.3"
"2302","Z11358",14019,905,251,654," 4.7"
"2303","Z11360",9220,653,226,427," 4.6"
"2304","Z11361",11300,694,89,605," 5.4"
"2305","Z11362",7269,201,74,127," 1.7"
"2306","Z11363",2847,198,43,155," 5.4"
"2307","Z11364",13842,637,123,514," 3.7"
"2308","Z11365",16374,610,181,429," 2.6"
"2309","Z11366",4694,503,48,455," 9.7"
"2310","Z11367",15572,928,94,834," 5.4"
"2311","Z11368",31108,2013,75,1938," 6.2"
"2312","Z11369",12693,1211,156,1055," 8.3"
"2313","Z11370",10098,1289,188,1101,"10.9"
"2314","Z11372",26239,1446,340,1106," 4.2"
"2315","Z11373",34013,2662,752,1910," 5.6"
"2316","Z11374",20761,1278,290,988," 4.8"
"2317","Z11375",34761,2489,652,1837," 5.3"
"2318","Z11377",33840,2385,278,2107," 6.2"
"2319","Z11378",13563,1152,128,1024," 7.5"
"2320","Z11379",14630,1102,192,910," 6.2"
"2321","Z11385",38086,3149,364,2785," 7.3"
"2322","Z11411",6393,371,0,371," 5.8"
"2323","Z11412",11572,701,9,692," 6.0"
"2324","Z11413",13090,751,26,725," 5.5"
"2325","Z11414",11622,968,409,559," 4.8"
"2326","Z11415",9244,994,191,803," 8.7"
"2327","Z11416",7814,680,201,479," 6.1"
"2328","Z11417",10243,793,253,540," 5.3"
"2329","Z11418",12350,979,183,796," 6.4"
"2330","Z11419",13119,762,31,731," 5.6"
"2331","Z11420",14142,668,87,581," 4.1"
"2332","Z11421",13093,865,175,690," 5.3"
"2333","Z11422",10030,410,23,387," 3.9"
"2334","Z11423",10418,625,0,625," 6.0"
"2335","Z11426",6705,514,77,437," 6.5"
"2336","Z11427",8087,348,85,263," 3.3"
"2337","Z11428",5929,309,44,265," 4.5"
"2338","Z11429",7787,469,11,458," 5.9"
"2339","Z11432",19600,1238,192,1046," 5.3"
"2340","Z11433",11708,1314,36,1278,"10.9"
"2341","Z11434",22014,1283,80,1203," 5.5"
"2342","Z11435",19612,1126,49,1077," 5.5"
"2343","Z11436",6014,560,18,542," 9.0"
"2344","Z11501",7664,426,58,368," 4.8"
"2345","Z11507",2514,152,10,142," 5.6"
"2346","Z11509",1213,321,229,92," 7.6"
"2347","Z11510",11286,629,29,600," 5.3"
"2348","Z11514",1791,87,0,87," 4.9"
"2349","Z11516",2478,223,0,223," 9.0"
"2350","Z11518",4188,236,0,236," 5.6"
"2351","Z11520",14201,745,47,698," 4.9"
"2352","Z11530",9816,451,219,232," 2.4"
"2353","Z11542",10296,587,112,475," 4.6"
"2354","Z11545",4415,211,31,180," 4.1"
"2355","Z11548",444,25,0,25," 5.6"
"2356","Z11550",17947,1375,47,1328," 7.4"
"2357","Z11552",7447,284,8,276," 3.7"
"2358","Z11553",6568,537,16,521," 7.9"
"2359","Z11554",12837,519,0,519," 4.0"
"2360","Z11557",2702,339,86,253," 9.4"
"2361","Z11558",3363,275,0,275," 8.2"
"2362","Z11559",3171,434,150,284," 9.0"
"2363","Z11560",2522,221,93,128," 5.1"
"2364","Z11561",18633,2434,1125,1309," 7.0"
"2365","Z11563",8743,505,7,498," 5.7"
"2366","Z11565",3277,86,0,86," 2.6"
"2367","Z11566",11526,545,12,533," 4.6"
"2368","Z11568",1030,117,19,98," 9.5"
"2369","Z11569",760,224,124,100,"13.2"
"2370","Z11570",10339,394,15,379," 3.7"
"2371","Z11572",10679,460,33,427," 4.0"
"2372","Z11575",4550,268,0,268," 5.9"
"2373","Z11576",4669,168,47,121," 2.6"
"2374","Z11577",4347,233,49,184," 4.2"
"2375","Z11579",1996,42,12,30," 1.5"
"2376","Z11580",13362,634,51,583," 4.4"
"2377","Z11581",6966,193,21,172," 2.5"
"2378","Z11590",14781,697,119,578," 3.9"
"2379","Z11596",3712,159,0,159," 4.3"
"2380","Z11598",4112,348,44,304," 7.4"
"2381","Z11691",21532,1925,49,1876," 8.7"
"2382","Z11692",7230,981,34,947,"13.1"
"2383","Z11693",5041,529,56,473," 9.4"
"2384","Z11694",9367,1411,419,992,"10.6"
"2385","Z11701",9549,886,0,886," 9.3"
"2386","Z11702",5632,491,52,439," 7.8"
"2387","Z11703",5786,275,0,275," 4.8"
"2388","Z11704",13562,607,36,571," 4.2"
"2389","Z11705",2813,182,8,174," 6.2"
"2390","Z11706",21962,2504,1654,850," 3.9"
"2391","Z11709",2647,237,192,45," 1.7"
"2392","Z11710",11673,310,38,272," 2.3"
"2393","Z11713",3604,331,158,173," 4.8"
"2394","Z11714",8221,390,0,390," 4.7"
"2395","Z11715",1724,117,9,108," 6.3"
"2396","Z11716",3825,149,14,135," 3.5"
"2397","Z11717",14777,977,36,941," 6.4"
"2398","Z11718",1091,5,5,0," 0.0"
"2399","Z11720",9465,488,33,455," 4.8"
"2400","Z11721",2455,153,87,66," 2.7"
"2401","Z11722",10453,664,80,584," 5.6"
"2402","Z11724",1070,115,35,80," 7.5"
"2403","Z11725",9925,250,60,190," 1.9"
"2404","Z11726",6737,394,10,384," 5.7"
"2405","Z11727",11951,709,207,502," 4.2"
"2406","Z11729",9578,345,29,316," 3.3"
"2407","Z11730",4781,320,42,278," 5.8"
"2408","Z11731",10448,426,32,394," 3.8"
"2409","Z11732",1513,71,0,71," 4.7"
"2410","Z11735",11743,681,10,671," 5.7"
"2411","Z11738",5466,240,0,240," 4.4"
"2412","Z11739",449,5,0,5," 1.1"
"2413","Z11740",3577,232,43,189," 5.3"
"2414","Z11741",9587,377,65,312," 3.3"
"2415","Z11742",4660,142,0,142," 3.0"
"2416","Z11743",16042,899,173,726," 4.5"
"2417","Z11746",22457,1198,152,1046," 4.7"
"2418","Z11747",7439,347,0,347," 4.7"
"2419","Z11749",1049,75,0,75," 7.1"
"2420","Z11751",5539,378,54,324," 5.8"
"2421","Z11752",3227,240,0,240," 7.4"
"2422","Z11753",4213,136,115,21," 0.5"
"2423","Z11754",6980,368,125,243," 3.5"
"2424","Z11755",4242,149,41,108," 2.5"
"2425","Z11756",13883,424,11,413," 3.0"
"2426","Z11757",16156,1015,7,1008," 6.2"
"2427","Z11758",19263,1092,0,1092," 5.7"
"2428","Z11762",7602,217,7,210," 2.8"
"2429","Z11763",9974,627,0,627," 6.3"
"2430","Z11764",4422,322,50,272," 6.2"
"2431","Z11765",354,78,39,39,"11.0"
"2432","Z11766",4484,161,46,115," 2.6"
"2433","Z11767",4918,173,15,158," 3.2"
"2434","Z11768",8472,649,195,454," 5.4"
"2435","Z11769",4026,770,421,349," 8.7"
"2436","Z11771",3878,398,233,165," 4.3"
"2437","Z11772",17930,1194,347,847," 4.7"
"2438","Z11776",8565,450,124,326," 3.8"
"2439","Z11777",3817,221,17,204," 5.3"
"2440","Z11778",4921,653,130,523,"10.6"
"2441","Z11779",13376,422,51,371," 2.8"
"2442","Z11780",5639,426,69,357," 6.3"
"2443","Z11782",6734,1313,1092,221," 3.3"
"2444","Z11783",7278,176,0,176," 2.4"
"2445","Z11784",8519,480,59,421," 4.9"
"2446","Z11786",1997,111,48,63," 3.2"
"2447","Z11787",12360,434,51,383," 3.1"
"2448","Z11788",5848,288,55,233," 4.0"
"2449","Z11789",3068,340,92,248," 8.1"
"2450","Z11790",4936,234,122,112," 2.3"
"2451","Z11791",8436,317,72,245," 2.9"
"2452","Z11792",3326,249,174,75," 2.3"
"2453","Z11793",10860,446,60,386," 3.6"
"2454","Z11795",8247,250,56,194," 2.4"
"2455","Z11796",1300,47,25,22," 1.7"
"2456","Z11797",3213,212,0,212," 6.6"
"2457","Z11798",4308,338,15,323," 7.5"
"2458","Z11801",13459,663,8,655," 4.9"
"2459","Z11803",9841,298,0,298," 3.0"
"2460","Z11804",1734,68,0,68," 3.9"
"2461","Z11901",11722,1811,1199,612," 5.2"
"2462","Z11930",2355,1756,1722,34," 1.4"
"2463","Z11932",2039,1614,1522,92," 4.5"
"2464","Z11933",3318,744,562,182," 5.5"
"2465","Z11934",2740,301,95,206," 7.5"
"2466","Z11935",2071,755,693,62," 3.0"
"2467","Z11937",13112,6582,6100,482," 3.7"
"2468","Z11939",1096,634,556,78," 7.1"
"2469","Z11940",2174,256,210,46," 2.1"
"2470","Z11941",866,83,39,44," 5.1"
"2471","Z11942",2791,1199,959,240," 8.6"
"2472","Z11944",2873,1059,833,226," 7.9"
"2473","Z11946",8465,3255,2819,436," 5.2"
"2474","Z11948",940,431,334,97,"10.3"
"2475","Z11949",5155,258,0,258," 5.0"
"2476","Z11950",5287,384,0,384," 7.3"
"2477","Z11951",5337,737,279,458," 8.6"
"2478","Z11952",2571,688,570,118," 4.6"
"2479","Z11953",5511,360,36,324," 5.9"
"2480","Z11954",4696,2962,2719,243," 5.2"
"2481","Z11955",1602,102,10,92," 5.7"
"2482","Z11959",1515,1132,1086,46," 3.0"
"2483","Z11960",973,672,624,48," 4.9"
"2484","Z11961",5997,815,159,656,"10.9"
"2485","Z11963",5823,2991,2782,209," 3.6"
"2486","Z11964",2076,1214,1117,97," 4.7"
"2487","Z11965",825,558,523,35," 4.2"
"2488","Z11967",8678,864,145,719," 8.3"
"2489","Z11968",8815,4456,3987,469," 5.3"
"2490","Z11971",4201,1541,1162,379," 9.0"
"2491","Z11972",567,169,141,28," 4.9"
"2492","Z11975",700,536,497,39," 5.6"
"2493","Z11976",2148,1129,1051,78," 3.6"
"2494","Z11977",1558,676,568,108," 6.9"
"2495","Z11978",3945,2631,2354,277," 7.0"
"2496","Z11980",1751,108,25,83," 4.7"
"2497","Z12009",3165,283,47,236," 7.5"
"2498","Z12010",14029,2294,105,2189,"15.6"
"2499","Z12015",1469,450,259,191,"13.0"
"2500","Z12017",304,174,149,25," 8.2"
"2501","Z12018",3409,622,247,375,"11.0"
"2502","Z12019",5880,202,17,185," 3.1"
"2503","Z12020",13651,1028,195,833," 6.1"
"2504","Z12022",479,93,59,34," 7.1"
"2505","Z12023",1044,211,92,119,"11.4"
"2506","Z12025",3010,808,537,271," 9.0"
"2507","Z12027",1530,89,9,80," 5.2"
"2508","Z12029",790,376,316,60," 7.6"
"2509","Z12032",1214,848,756,92," 7.6"
"2510","Z12035",390,64,49,15," 3.8"
"2511","Z12036",155,63,54,9," 5.8"
"2512","Z12037",2193,482,239,243,"11.1"
"2513","Z12040",63,10,10,0," 0.0"
"2514","Z12041",262,68,0,68,"26.0"
"2515","Z12043",3552,571,199,372,"10.5"
"2516","Z12047",9512,1235,0,1235,"13.0"
"2517","Z12051",1917,406,173,233,"12.2"
"2518","Z12052",705,90,57,33," 4.7"
"2519","Z12053",1847,421,2,419,"22.7"
"2520","Z12054",6997,281,0,281," 4.0"
"2521","Z12056",1000,208,0,208,"20.8"
"2522","Z12057",917,55,8,47," 5.1"
"2523","Z12059",979,314,214,100,"10.2"
"2524","Z12060",852,270,227,43," 5.0"
"2525","Z12061",3950,187,0,187," 4.7"
"2526","Z12062",778,112,58,54," 6.9"
"2527","Z12065",18400,1010,23,987," 5.4"
"2528","Z12067",578,8,0,8," 1.4"
"2529","Z12068",1296,85,0,85," 6.6"
"2530","Z12072",1158,204,21,183,"15.8"
"2531","Z12074",1613,407,337,70," 4.3"
"2532","Z12075",1351,184,162,22," 1.6"
"2533","Z12076",1436,806,759,47," 3.3"
"2534","Z12077",2645,215,0,215," 8.1"
"2535","Z12078",12054,2405,797,1608,"13.3"
"2536","Z12083",1747,232,152,80," 4.6"
"2537","Z12084",2206,139,0,139," 6.3"
"2538","Z12085",245,48,0,48,"19.6"
"2539","Z12086",900,150,74,76," 8.4"
"2540","Z12087",443,48,48,0," 0.0"
"2541","Z12090",2706,335,9,326,"12.0"
"2542","Z12092",506,180,38,142,"28.1"
"2543","Z12095",5374,386,56,330," 6.1"
"2544","Z12106",1230,196,78,118," 9.6"
"2545","Z12108",941,794,755,39," 4.1"
"2546","Z12110",8086,379,30,349," 4.3"
"2547","Z12116",1295,440,306,134,"10.3"
"2548","Z12117",2121,685,490,195," 9.2"
"2549","Z12118",6361,496,30,466," 7.3"
"2550","Z12120",364,110,101,9," 2.5"
"2551","Z12122",2797,818,492,326,"11.7"
"2552","Z12123",2305,183,9,174," 7.5"
"2553","Z12124",256,43,12,31,"12.1"
"2554","Z12125",845,194,103,91,"10.8"
"2555","Z12132",139,22,14,8," 5.8"
"2556","Z12134",2954,1532,1343,189," 6.4"
"2557","Z12137",696,82,6,76,"10.9"
"2558","Z12139",739,662,645,17," 2.3"
"2559","Z12143",2225,94,26,68," 3.1"
"2560","Z12144",9372,764,80,684," 7.3"
"2561","Z12147",313,131,90,41,"13.1"
"2562","Z12148",1968,156,0,156," 7.9"
"2563","Z12149",1277,339,217,122," 9.6"
"2564","Z12154",1108,64,38,26," 2.3"
"2565","Z12155",1083,357,159,198,"18.3"
"2566","Z12157",1900,234,28,206,"10.8"
"2567","Z12158",2687,134,23,111," 4.1"
"2568","Z12159",3563,246,0,246," 6.9"
"2569","Z12164",547,462,454,8," 1.5"
"2570","Z12165",77,11,8,3," 3.9"
"2571","Z12167",1604,470,304,166,"10.3"
"2572","Z12170",1941,124,10,114," 5.9"
"2573","Z12172",195,69,11,58,"29.7"
"2574","Z12173",800,90,34,56," 7.0"
"2575","Z12175",504,257,223,34," 6.7"
"2576","Z12177",273,23,0,23," 8.4"
"2577","Z12180",24637,3494,404,3090,"12.5"
"2578","Z12182",6817,628,42,586," 8.6"
"2579","Z12183",1252,174,0,174,"13.9"
"2580","Z12184",3214,572,270,302," 9.4"
"2581","Z12185",862,64,14,50," 5.8"
"2582","Z12186",2735,214,104,110," 4.0"
"2583","Z12187",348,149,128,21," 6.0"
"2584","Z12188",4962,232,56,176," 3.5"
"2585","Z12189",8842,896,0,896,"10.1"
"2586","Z12192",766,162,93,69," 9.0"
"2587","Z12193",954,166,47,119,"12.5"
"2588","Z12197",1361,429,292,137,"10.1"
"2589","Z12198",3126,207,58,149," 4.8"
"2590","Z12202",5276,1283,0,1283,"24.3"
"2591","Z12203",14193,992,13,979," 6.9"
"2592","Z12204",3819,490,90,400,"10.5"
"2593","Z12205",12095,728,0,728," 6.0"
"2594","Z12206",7802,1806,9,1797,"23.0"
"2595","Z12207",1111,178,0,178,"16.0"
"2596","Z12208",10742,1082,52,1030," 9.6"
"2597","Z12209",4805,245,26,219," 4.6"
"2598","Z12210",5865,1368,0,1368,"23.3"
"2599","Z12211",4511,228,0,228," 5.1"
"2600","Z12302",11708,1212,81,1131," 9.7"
"2601","Z12303",12977,2151,54,2097,"16.2"
"2602","Z12304",9826,1245,42,1203,"12.2"
"2603","Z12305",3074,732,12,720,"23.4"
"2604","Z12306",11383,1857,29,1828,"16.1"
"2605","Z12307",3610,1335,20,1315,"36.4"
"2606","Z12308",6853,1658,32,1626,"23.7"
"2607","Z12401",16146,1745,267,1478," 9.2"
"2608","Z12404",1894,514,345,169," 8.9"
"2609","Z12406",786,348,281,67," 8.5"
"2610","Z12407",173,83,83,0," 0.0"
"2611","Z12409",510,182,140,42," 8.2"
"2612","Z12412",413,115,115,0," 0.0"
"2613","Z12413",1625,439,143,296,"18.2"
"2614","Z12414",5042,1158,349,809,"16.0"
"2615","Z12416",135,36,13,23,"17.0"
"2616","Z12418",397,246,209,37," 9.3"
"2617","Z12420",299,95,72,23," 7.7"
"2618","Z12421",688,499,482,17," 2.5"
"2619","Z12423",829,363,235,128,"15.4"
"2620","Z12427",441,297,297,0," 0.0"
"2621","Z12428",3317,954,362,592,"17.8"
"2622","Z12430",1123,639,553,86," 7.7"
"2623","Z12431",854,291,244,47," 5.5"
"2624","Z12433",286,85,36,49,"17.1"
"2625","Z12434",437,162,100,62,"14.2"
"2626","Z12435",273,153,133,20," 7.3"
"2627","Z12439",508,350,327,23," 4.5"
"2628","Z12441",136,122,122,0," 0.0"
"2629","Z12442",1560,1181,1109,72," 4.6"
"2630","Z12443",1702,196,101,95," 5.6"
"2631","Z12446",2615,667,293,374,"14.3"
"2632","Z12448",333,82,59,23," 6.9"
"2633","Z12449",1230,52,28,24," 2.0"
"2634","Z12451",826,243,143,100,"12.1"
"2635","Z12454",294,183,183,0," 0.0"
"2636","Z12455",1801,874,724,150," 8.3"
"2637","Z12458",1282,366,130,236,"18.4"
"2638","Z12461",1025,198,168,30," 2.9"
"2639","Z12463",764,271,210,61," 8.0"
"2640","Z12464",794,370,258,112,"14.1"
"2641","Z12466",1037,87,52,35," 3.4"
"2642","Z12468",919,480,436,44," 4.8"
"2643","Z12469",678,340,249,91,"13.4"
"2644","Z12470",345,143,96,47,"13.6"
"2645","Z12472",842,135,12,123,"14.6"
"2646","Z12473",541,166,116,50," 9.2"
"2647","Z12474",933,427,393,34," 3.6"
"2648","Z12477",8603,1209,485,724," 8.4"
"2649","Z12481",727,121,68,53," 7.3"
"2650","Z12482",316,73,11,62,"19.6"
"2651","Z12483",351,174,155,19," 5.4"
"2652","Z12484",1426,355,219,136," 9.5"
"2653","Z12485",1044,614,477,137,"13.1"
"2654","Z12486",583,69,53,16," 2.7"
"2655","Z12487",1380,172,58,114," 8.3"
"2656","Z12489",212,61,0,61,"28.8"
"2657","Z12491",876,171,68,103,"11.8"
"2658","Z12493",188,44,33,11," 5.9"
"2659","Z12494",530,212,206,6," 1.1"
"2660","Z12495",286,118,76,42,"14.7"
"2661","Z12498",3044,709,540,169," 5.6"
"2662","Z12501",1201,173,134,39," 3.2"
"2663","Z12503",545,206,190,16," 2.9"
"2664","Z12507",104,36,18,18,"17.3"
"2665","Z12508",7813,661,138,523," 6.7"
"2666","Z12514",1403,326,238,88," 6.3"
"2667","Z12515",638,17,0,17," 2.7"
"2668","Z12516",1198,395,319,76," 6.3"
"2669","Z12517",290,47,47,0," 0.0"
"2670","Z12518",2504,269,0,269,"10.7"
"2671","Z12522",2471,340,109,231," 9.3"
"2672","Z12523",873,191,137,54," 6.2"
"2673","Z12524",6489,425,93,332," 5.1"
"2674","Z12525",1297,263,138,125," 9.6"
"2675","Z12526",1973,387,274,113," 5.7"
"2676","Z12528",5875,727,75,652,"11.1"
"2677","Z12529",1800,784,597,187,"10.4"
"2678","Z12531",1533,303,185,118," 7.7"
"2679","Z12533",9353,775,431,344," 3.7"
"2680","Z12534",8723,1352,571,781," 9.0"
"2681","Z12538",5555,459,17,442," 8.0"
"2682","Z12540",2954,259,64,195," 6.6"
"2683","Z12542",2575,312,0,312,"12.1"
"2684","Z12545",2555,550,317,233," 9.1"
"2685","Z12546",1473,331,311,20," 1.4"
"2686","Z12547",1159,85,42,43," 3.7"
"2687","Z12548",632,42,42,0," 0.0"
"2688","Z12549",4020,267,61,206," 5.1"
"2689","Z12550",21319,3122,164,2958,"13.9"
"2690","Z12553",10382,952,39,913," 8.8"
"2691","Z12561",7130,765,300,465," 6.5"
"2692","Z12563",2843,406,286,120," 4.2"
"2693","Z12564",2800,292,143,149," 5.3"
"2694","Z12566",4162,487,204,283," 6.8"
"2695","Z12567",1562,336,198,138," 8.8"
"2696","Z12569",4327,262,71,191," 4.4"
"2697","Z12570",2747,266,117,149," 5.4"
"2698","Z12571",4561,606,276,330," 7.2"
"2699","Z12572",4380,611,340,271," 6.2"
"2700","Z12574",134,45,32,13," 9.7"
"2701","Z12577",460,21,0,21," 4.6"
"2702","Z12578",942,140,71,69," 7.3"
"2703","Z12580",1808,218,53,165," 9.1"
"2704","Z12581",990,212,132,80," 8.1"
"2705","Z12582",1458,90,15,75," 5.1"
"2706","Z12583",1009,116,39,77," 7.6"
"2707","Z12585",294,20,0,20," 6.8"
"2708","Z12586",4581,391,16,375," 8.2"
"2709","Z12589",5196,392,66,326," 6.3"
"2710","Z12590",13974,1098,26,1072," 7.7"
"2711","Z12592",612,152,49,103,"16.8"
"2712","Z12594",1718,275,128,147," 8.6"
"2713","Z12601",17382,1838,95,1743,"10.0"
"2714","Z12603",16449,1206,128,1078," 6.6"
"2715","Z12701",6754,2360,1460,900,"13.3"
"2716","Z12719",786,287,249,38," 4.8"
"2717","Z12721",2630,543,241,302,"11.5"
"2718","Z12723",1314,591,419,172,"13.1"
"2719","Z12724",211,62,34,28,"13.3"
"2720","Z12726",890,379,303,76," 8.5"
"2721","Z12729",947,179,50,129,"13.6"
"2722","Z12732",661,280,233,47," 7.1"
"2723","Z12733",981,707,666,41," 4.2"
"2724","Z12734",672,284,164,120,"17.9"
"2725","Z12737",1258,524,394,130,"10.3"
"2726","Z12740",989,341,306,35," 3.5"
"2727","Z12741",274,138,78,60,"21.9"
"2728","Z12742",99,48,36,12,"12.1"
"2729","Z12747",855,385,262,123,"14.4"
"2730","Z12748",1141,378,246,132,"11.6"
"2731","Z12749",418,233,226,7," 1.7"
"2732","Z12751",485,142,110,32," 6.6"
"2733","Z12754",3275,768,417,351,"10.7"
"2734","Z12758",3129,1353,988,365,"11.7"
"2735","Z12762",321,155,102,53,"16.5"
"2736","Z12763",591,294,226,68,"11.5"
"2737","Z12764",1405,653,470,183,"13.0"
"2738","Z12765",508,107,58,49," 9.6"
"2739","Z12768",948,614,567,47," 5.0"
"2740","Z12771",6265,852,140,712,"11.4"
"2741","Z12775",1528,712,540,172,"11.3"
"2742","Z12776",2000,1141,976,165," 8.2"
"2743","Z12777",574,221,170,51," 8.9"
"2744","Z12779",1516,770,588,182,"12.0"
"2745","Z12780",1138,213,47,166,"14.6"
"2746","Z12783",1288,656,502,154,"12.0"
"2747","Z12785",389,38,0,38," 9.8"
"2748","Z12786",863,654,543,111,"12.9"
"2749","Z12789",1716,879,654,225,"13.1"
"2750","Z12790",3111,1239,916,323,"10.4"
"2751","Z12791",454,129,75,54,"11.9"
"2752","Z12801",7193,750,131,619," 8.6"
"2753","Z12803",3576,209,64,145," 4.1"
"2754","Z12804",11918,1333,699,634," 5.3"
"2755","Z12809",1764,385,277,108," 6.1"
"2756","Z12810",382,92,82,10," 2.6"
"2757","Z12812",324,298,281,17," 5.2"
"2758","Z12814",1757,1171,1093,78," 4.4"
"2759","Z12815",1160,717,681,36," 3.1"
"2760","Z12816",2556,543,351,192," 7.5"
"2761","Z12817",2230,1292,1192,100," 4.5"
"2762","Z12822",2870,546,415,131," 4.6"
"2763","Z12827",1823,410,291,119," 6.5"
"2764","Z12828",4143,473,78,395," 9.5"
"2765","Z12831",6707,188,85,103," 1.5"
"2766","Z12832",3102,426,143,283," 9.1"
"2767","Z12833",2020,309,127,182," 9.0"
"2768","Z12834",2749,282,91,191," 6.9"
"2769","Z12835",2960,1915,1756,159," 5.4"
"2770","Z12836",741,449,422,27," 3.6"
"2771","Z12838",288,28,14,14," 4.9"
"2772","Z12839",5659,408,40,368," 6.5"
"2773","Z12841",297,235,235,0," 0.0"
"2774","Z12842",1498,1219,1159,60," 4.0"
"2775","Z12843",508,287,258,29," 5.7"
"2776","Z12844",294,172,149,23," 7.8"
"2777","Z12845",3620,1639,1439,200," 5.5"
"2778","Z12846",2006,772,683,89," 4.4"
"2779","Z12847",1332,1217,1180,37," 2.8"
"2780","Z12849",198,12,12,0," 0.0"
"2781","Z12850",1446,307,249,58," 4.0"
"2782","Z12851",426,314,302,12," 2.8"
"2783","Z12852",694,489,483,6," 0.9"
"2784","Z12853",1153,652,652,0," 0.0"
"2785","Z12857",507,299,293,6," 1.2"
"2786","Z12859",974,20,20,0," 0.0"
"2787","Z12860",532,298,298,0," 0.0"
"2788","Z12865",1937,323,193,130," 6.7"
"2789","Z12866",18313,2607,949,1658," 9.1"
"2790","Z12870",1796,1402,1347,55," 3.1"
"2791","Z12871",1843,204,4,200,"10.9"
"2792","Z12873",340,27,12,15," 4.4"
"2793","Z12874",388,304,297,7," 1.8"
"2794","Z12878",614,292,244,48," 7.8"
"2795","Z12883",2739,691,407,284,"10.4"
"2796","Z12885",2510,690,377,313,"12.5"
"2797","Z12887",2516,495,245,250," 9.9"
"2798","Z12901",14776,1545,325,1220," 8.3"
"2799","Z12903",722,76,50,26," 3.6"
"2800","Z12910",762,136,66,70," 9.2"
"2801","Z12912",1210,386,307,79," 6.5"
"2802","Z12913",704,134,121,13," 1.8"
"2803","Z12916",913,122,26,96,"10.5"
"2804","Z12917",587,65,16,49," 8.3"
"2805","Z12919",1305,98,38,60," 4.6"
"2806","Z12920",1503,482,342,140," 9.3"
"2807","Z12921",1115,189,146,43," 3.9"
"2808","Z12926",949,109,66,43," 4.5"
"2809","Z12927",595,485,458,27," 4.5"
"2810","Z12928",1131,376,206,170,"15.0"
"2811","Z12929",440,67,0,67,"15.2"
"2812","Z12930",388,88,51,37," 9.5"
"2813","Z12932",812,254,169,85,"10.5"
"2814","Z12934",481,80,39,41," 8.5"
"2815","Z12935",876,296,258,38," 4.3"
"2816","Z12936",484,278,215,63,"13.0"
"2817","Z12937",726,75,12,63," 8.7"
"2818","Z12941",927,372,289,83," 9.0"
"2819","Z12942",650,275,258,17," 2.6"
"2820","Z12943",540,440,423,17," 3.1"
"2821","Z12944",2195,447,260,187," 8.5"
"2822","Z12945",606,416,380,36," 5.9"
"2823","Z12946",3901,1542,1199,343," 8.8"
"2824","Z12950",479,135,86,49,"10.2"
"2825","Z12952",322,95,29,66,"20.5"
"2826","Z12953",5495,750,429,321," 5.8"
"2827","Z12956",470,97,29,68,"14.5"
"2828","Z12957",885,41,0,41," 4.6"
"2829","Z12960",606,96,65,31," 5.1"
"2830","Z12962",2382,30,30,0," 0.0"
"2831","Z12966",1375,127,73,54," 3.9"
"2832","Z12967",450,33,17,16," 3.6"
"2833","Z12972",2455,137,76,61," 2.5"
"2834","Z12974",722,198,40,158,"21.9"
"2835","Z12976",228,133,127,6," 2.6"
"2836","Z12980",1315,710,614,96," 7.3"
"2837","Z12981",1150,98,40,58," 5.0"
"2838","Z12983",4798,1370,908,462," 9.6"
"2839","Z12985",594,18,18,0," 0.0"
"2840","Z12986",3858,1336,1072,264," 6.8"
"2841","Z12989",836,411,394,17," 2.0"
"2842","Z12992",2356,180,85,95," 4.0"
"2843","Z12993",1179,563,493,70," 5.9"
"2844","Z12996",1665,755,695,60," 3.6"
"2845","Z12997",807,282,230,52," 6.4"
"2846","Z13021",18429,1867,413,1454," 7.9"
"2847","Z13026",902,290,230,60," 6.7"
"2848","Z13027",14060,1008,51,957," 6.8"
"2849","Z13028",860,304,264,40," 4.7"
"2850","Z13029",3112,238,51,187," 6.0"
"2851","Z13030",1885,248,163,85," 4.5"
"2852","Z13031",6374,229,0,229," 3.6"
"2853","Z13032",6108,813,278,535," 8.8"
"2854","Z13033",1605,233,101,132," 8.2"
"2855","Z13034",1174,400,320,80," 6.8"
"2856","Z13035",3700,553,211,342," 9.2"
"2857","Z13036",3557,393,129,264," 7.4"
"2858","Z13037",3597,352,67,285," 7.9"
"2859","Z13039",6867,277,40,237," 3.5"
"2860","Z13040",1285,295,162,133,"10.4"
"2861","Z13041",4042,196,15,181," 4.5"
"2862","Z13042",1389,347,277,70," 5.0"
"2863","Z13044",1179,242,127,115," 9.8"
"2864","Z13045",12063,1316,212,1104," 9.2"
"2865","Z13052",1087,410,332,78," 7.2"
"2866","Z13053",1981,133,30,103," 5.2"
"2867","Z13054",724,88,0,88,"12.2"
"2868","Z13057",6849,382,26,356," 5.2"
"2869","Z13060",1196,70,0,70," 5.9"
"2870","Z13061",735,277,257,20," 2.7"
"2871","Z13063",710,57,7,50," 7.0"
"2872","Z13066",5484,270,33,237," 4.3"
"2873","Z13068",2479,148,0,148," 6.0"
"2874","Z13069",10463,1183,106,1077,"10.3"
"2875","Z13071",414,61,0,61,"14.7"
"2876","Z13072",418,150,92,58,"13.9"
"2877","Z13073",2811,135,27,108," 3.8"
"2878","Z13074",1835,132,23,109," 5.9"
"2879","Z13077",2971,432,215,217," 7.3"
"2880","Z13078",3884,68,21,47," 1.2"
"2881","Z13080",1740,348,171,177,"10.2"
"2882","Z13081",670,231,191,40," 6.0"
"2883","Z13082",1960,202,0,202,"10.3"
"2884","Z13083",746,131,100,31," 4.2"
"2885","Z13084",1763,86,44,42," 2.4"
"2886","Z13087",105,9,9,0," 0.0"
"2887","Z13088",10950,703,18,685," 6.3"
"2888","Z13090",12565,567,0,567," 4.5"
"2889","Z13092",1101,98,16,82," 7.4"
"2890","Z13101",1007,116,12,104,"10.3"
"2891","Z13104",6127,216,48,168," 2.7"
"2892","Z13108",2610,110,27,83," 3.2"
"2893","Z13110",1289,357,270,87," 6.7"
"2894","Z13111",693,81,12,69,"10.0"
"2895","Z13112",830,108,51,57," 6.9"
"2896","Z13114",2951,497,264,233," 7.9"
"2897","Z13116",1480,71,0,71," 4.8"
"2898","Z13118",2807,676,495,181," 6.4"
"2899","Z13120",767,41,0,41," 5.3"
"2900","Z13126",15752,2105,359,1746,"11.1"
"2901","Z13131",1486,217,29,188,"12.7"
"2902","Z13132",1588,162,80,82," 5.2"
"2903","Z13135",2821,158,35,123," 4.4"
"2904","Z13140",1973,247,86,161," 8.2"
"2905","Z13141",283,69,28,41,"14.5"
"2906","Z13142",3423,988,710,278," 8.1"
"2907","Z13143",1369,309,174,135," 9.9"
"2908","Z13145",1196,370,334,36," 3.0"
"2909","Z13146",989,140,56,84," 8.5"
"2910","Z13147",505,46,9,37," 7.3"
"2911","Z13148",5320,740,379,361," 6.8"
"2912","Z13152",4497,1122,823,299," 6.6"
"2913","Z13157",849,485,428,57," 6.7"
"2914","Z13158",741,147,102,45," 6.1"
"2915","Z13159",2276,245,89,156," 6.9"
"2916","Z13160",950,148,120,28," 2.9"
"2917","Z13162",318,104,104,0," 0.0"
"2918","Z13163",180,20,5,15," 8.3"
"2919","Z13164",944,52,0,52," 5.5"
"2920","Z13165",4624,318,29,289," 6.2"
"2921","Z13166",2369,155,27,128," 5.4"
"2922","Z13167",1186,67,5,62," 5.2"
"2923","Z13202",2686,422,30,392,"14.6"
"2924","Z13203",8370,1413,26,1387,"16.6"
"2925","Z13204",9891,1864,45,1819,"18.4"
"2926","Z13205",8668,1402,9,1393,"16.1"
"2927","Z13206",8488,730,16,714," 8.4"
"2928","Z13207",6088,940,0,940,"15.4"
"2929","Z13208",10237,1677,48,1629,"15.9"
"2930","Z13209",6067,435,0,435," 7.2"
"2931","Z13210",8886,1327,65,1262,"14.2"
"2932","Z13211",2843,219,8,211," 7.4"
"2933","Z13212",9259,420,54,366," 4.0"
"2934","Z13214",3417,327,0,327," 9.6"
"2935","Z13215",6047,388,60,328," 5.4"
"2936","Z13219",6712,436,0,436," 6.5"
"2937","Z13224",3885,407,29,378," 9.7"
"2938","Z13302",988,367,317,50," 5.1"
"2939","Z13304",774,89,64,25," 3.2"
"2940","Z13305",118,12,0,12,"10.2"
"2941","Z13308",1489,132,75,57," 3.8"
"2942","Z13309",2666,436,326,110," 4.1"
"2943","Z13310",369,189,189,0," 0.0"
"2944","Z13315",676,155,115,40," 5.9"
"2945","Z13316",3049,466,282,184," 6.0"
"2946","Z13317",1566,226,46,180,"11.5"
"2947","Z13318",479,41,30,11," 2.3"
"2948","Z13319",366,44,0,44,"12.0"
"2949","Z13320",1170,263,147,116," 9.9"
"2950","Z13321",587,20,0,20," 3.4"
"2951","Z13322",482,129,89,40," 8.3"
"2952","Z13323",4356,398,95,303," 7.0"
"2953","Z13324",1453,557,469,88," 6.1"
"2954","Z13325",634,215,197,18," 2.8"
"2955","Z13326",3563,1171,917,254," 7.1"
"2956","Z13327",1238,458,398,60," 4.8"
"2957","Z13329",1883,284,127,157," 8.3"
"2958","Z13331",947,830,814,16," 1.7"
"2959","Z13332",1101,222,44,178,"16.2"
"2960","Z13334",776,327,308,19," 2.4"
"2961","Z13337",336,71,48,23," 6.8"
"2962","Z13338",1508,1007,850,157,"10.4"
"2963","Z13339",2983,453,69,384,"12.9"
"2964","Z13340",3421,357,25,332," 9.7"
"2965","Z13343",1168,477,416,61," 5.2"
"2966","Z13346",2372,710,403,307,"12.9"
"2967","Z13348",697,168,86,82,"11.8"
"2968","Z13350",4758,512,29,483,"10.2"
"2969","Z13354",1384,157,15,142,"10.3"
"2970","Z13355",310,10,10,0," 0.0"
"2971","Z13357",4991,258,48,210," 4.2"
"2972","Z13360",1051,924,917,7," 0.7"
"2973","Z13363",1000,138,70,68," 6.8"
"2974","Z13365",4218,646,128,518,"12.3"
"2975","Z13367",4197,832,656,176," 4.2"
"2976","Z13368",636,121,85,36," 5.7"
"2977","Z13402",800,136,97,39," 4.9"
"2978","Z13403",1690,66,13,53," 3.1"
"2979","Z13406",337,52,16,36,"10.7"
"2980","Z13407",2288,185,28,157," 6.9"
"2981","Z13408",1102,222,81,141,"12.8"
"2982","Z13411",1755,363,189,174," 9.9"
"2983","Z13413",7098,440,78,362," 5.1"
"2984","Z13416",1011,144,66,78," 7.7"
"2985","Z13417",1868,297,44,253,"13.5"
"2986","Z13420",2935,2376,2229,147," 5.0"
"2987","Z13421",6088,733,30,703,"11.5"
"2988","Z13424",968,70,0,70," 7.2"
"2989","Z13425",978,64,9,55," 5.6"
"2990","Z13428",713,96,12,84,"11.8"
"2991","Z13431",820,124,67,57," 7.0"
"2992","Z13433",912,154,78,76," 8.3"
"2993","Z13435",106,23,1,22,"20.8"
"2994","Z13436",577,551,546,5," 0.9"
"2995","Z13438",2159,571,421,150," 6.9"
"2996","Z13439",2509,891,629,262,"10.4"
"2997","Z13440",19093,2112,272,1840," 9.6"
"2998","Z13450",46,7,0,7,"15.2"
"2999","Z13452",2078,346,60,286,"13.8"
"3000","Z13454",399,116,90,26," 6.5"
"3001","Z13456",1861,195,63,132," 7.1"
"3002","Z13460",1960,197,101,96," 4.9"
"3003","Z13464",609,131,79,52," 8.5"
"3004","Z13471",1506,255,137,118," 7.8"
"3005","Z13472",290,178,149,29,"10.0"
"3006","Z13473",406,180,136,44,"10.8"
"3007","Z13476",1529,166,41,125," 8.2"
"3008","Z13480",1492,111,20,91," 6.1"
"3009","Z13486",364,41,0,41,"11.3"
"3010","Z13489",313,78,62,16," 5.1"
"3011","Z13491",1521,117,33,84," 5.5"
"3012","Z13492",5361,395,24,371," 6.9"
"3013","Z13493",919,261,156,105,"11.4"
"3014","Z13494",583,460,434,26," 4.5"
"3015","Z13495",964,10,0,10," 1.0"
"3016","Z13501",16590,2240,74,2166,"13.1"
"3017","Z13502",14917,1956,65,1891,"12.7"
"3018","Z13601",17524,1889,133,1756,"10.0"
"3019","Z13603",3691,139,0,139," 3.8"
"3020","Z13605",2368,459,350,109," 4.6"
"3021","Z13606",1176,71,0,71," 6.0"
"3022","Z13607",1729,916,799,117," 6.8"
"3023","Z13608",613,71,17,54," 8.8"
"3024","Z13612",1199,130,9,121,"10.1"
"3025","Z13613",1142,184,97,87," 7.6"
"3026","Z13615",473,52,0,52,"11.0"
"3027","Z13617",3929,530,115,415,"10.6"
"3028","Z13618",2256,1463,1347,116," 5.1"
"3029","Z13619",4488,442,77,365," 8.1"
"3030","Z13620",888,98,75,23," 2.6"
"3031","Z13621",300,103,73,30,"10.0"
"3032","Z13622",1441,493,360,133," 9.2"
"3033","Z13624",3656,1692,1429,263," 7.2"
"3034","Z13625",1124,276,227,49," 4.4"
"3035","Z13626",1257,341,229,112," 8.9"
"3036","Z13630",546,55,0,55,"10.1"
"3037","Z13634",2322,713,627,86," 3.7"
"3038","Z13635",518,119,85,34," 6.6"
"3039","Z13636",112,4,0,4," 3.6"
"3040","Z13637",1875,152,0,152," 8.1"
"3041","Z13638",118,28,0,28,"23.7"
"3042","Z13639",124,43,27,16,"12.9"
"3043","Z13640",905,718,637,81," 9.0"
"3044","Z13642",4309,762,296,466,"10.8"
"3045","Z13646",2799,1762,1588,174," 6.2"
"3046","Z13647",46,16,0,16,"34.8"
"3047","Z13648",1553,731,639,92," 5.9"
"3048","Z13650",1402,790,763,27," 1.9"
"3049","Z13651",218,118,106,12," 5.5"
"3050","Z13652",983,253,197,56," 5.7"
"3051","Z13654",1061,198,143,55," 5.2"
"3052","Z13655",1368,45,0,45," 3.3"
"3053","Z13656",1280,190,88,102," 8.0"
"3054","Z13658",903,114,84,30," 3.3"
"3055","Z13660",779,53,3,50," 6.4"
"3056","Z13661",944,325,244,81," 8.6"
"3057","Z13662",7681,491,107,384," 5.0"
"3058","Z13664",280,101,50,51,"18.2"
"3059","Z13665",461,121,106,15," 3.3"
"3060","Z13667",1210,97,54,43," 3.6"
"3061","Z13668",1572,181,67,114," 7.3"
"3062","Z13669",7369,1265,777,488," 6.6"
"3063","Z13670",387,182,153,29," 7.5"
"3064","Z13672",701,354,327,27," 3.9"
"3065","Z13673",885,28,0,28," 3.2"
"3066","Z13676",5643,415,145,270," 4.8"
"3067","Z13679",1639,933,805,128," 7.8"
"3068","Z13685",1466,379,301,78," 5.3"
"3069","Z13687",755,504,478,26," 3.4"
"3070","Z13693",1074,867,829,38," 3.5"
"3071","Z13694",733,90,58,32," 4.4"
"3072","Z13697",1082,191,20,171,"15.8"
"3073","Z13730",1658,448,183,265,"16.0"
"3074","Z13731",1285,835,765,70," 5.4"
"3075","Z13732",3081,185,0,185," 6.0"
"3076","Z13733",2538,531,335,196," 7.7"
"3077","Z13734",1035,161,50,111,"10.7"
"3078","Z13736",917,169,93,76," 8.3"
"3079","Z13739",649,301,247,54," 8.3"
"3080","Z13743",1514,170,113,57," 3.8"
"3081","Z13746",920,89,32,57," 6.2"
"3082","Z13748",1519,112,0,112," 7.4"
"3083","Z13750",597,231,185,46," 7.7"
"3084","Z13752",605,297,268,29," 4.8"
"3085","Z13753",2149,452,280,172," 8.0"
"3086","Z13754",2177,704,571,133," 6.1"
"3087","Z13755",939,384,357,27," 2.9"
"3088","Z13756",560,347,313,34," 6.1"
"3089","Z13760",20754,2019,80,1939," 9.3"
"3090","Z13774",112,46,46,0," 0.0"
"3091","Z13775",1027,393,295,98," 9.5"
"3092","Z13777",243,57,9,48,"19.8"
"3093","Z13780",602,129,94,35," 5.8"
"3094","Z13782",511,220,193,27," 5.3"
"3095","Z13783",2158,1130,993,137," 6.3"
"3096","Z13784",77,8,0,8,"10.4"
"3097","Z13786",344,143,119,24," 7.0"
"3098","Z13787",1800,392,169,223,"12.4"
"3099","Z13790",8694,956,26,930,"10.7"
"3100","Z13795",1550,43,0,43," 2.8"
"3101","Z13797",854,77,0,77," 9.0"
"3102","Z13802",242,98,0,98,"40.5"
"3103","Z13803",1756,209,83,126," 7.2"
"3104","Z13804",243,41,21,20," 8.2"
"3105","Z13807",740,236,143,93,"12.6"
"3106","Z13811",2000,214,85,129," 6.5"
"3107","Z13812",1065,130,27,103," 9.7"
"3108","Z13813",459,178,96,82,"17.9"
"3109","Z13815",6289,1024,415,609," 9.7"
"3110","Z13820",8542,1021,304,717," 8.4"
"3111","Z13825",1627,216,72,144," 8.9"
"3112","Z13830",2555,527,339,188," 7.4"
"3113","Z13832",373,121,61,60,"16.1"
"3114","Z13833",1899,109,28,81," 4.3"
"3115","Z13835",655,120,78,42," 6.4"
"3116","Z13838",2530,414,147,267,"10.6"
"3117","Z13841",372,132,94,38,"10.2"
"3118","Z13843",1054,277,179,98," 9.3"
"3119","Z13846",148,37,9,28,"18.9"
"3120","Z13849",2108,456,272,184," 8.7"
"3121","Z13850",9802,834,50,784," 8.0"
"3122","Z13856",4008,1204,1065,139," 3.5"
"3123","Z13862",1901,214,29,185," 9.7"
"3124","Z13864",501,35,35,0," 0.0"
"3125","Z13865",2951,523,323,200," 6.8"
"3126","Z13901",9335,1179,118,1061,"11.4"
"3127","Z13903",8789,945,37,908,"10.3"
"3128","Z13904",4167,442,12,430,"10.3"
"3129","Z13905",13395,2084,152,1932,"14.4"
"3130","Z14001",4047,164,18,146," 3.6"
"3131","Z14004",4288,177,0,177," 4.1"
"3132","Z14005",702,6,0,6," 0.9"
"3133","Z14006",5035,814,496,318," 6.3"
"3134","Z14008",648,130,17,113,"17.4"
"3135","Z14009",2693,393,249,144," 5.3"
"3136","Z14011",2721,170,19,151," 5.5"
"3137","Z14013",808,46,0,46," 5.7"
"3138","Z14020",10292,635,84,551," 5.4"
"3139","Z14024",871,210,161,49," 5.6"
"3140","Z14025",1337,121,14,107," 8.0"
"3141","Z14026",316,25,0,25," 7.9"
"3142","Z14028",711,147,18,129,"18.1"
"3143","Z14030",699,90,20,70,"10.0"
"3144","Z14031",4136,121,24,97," 2.3"
"3145","Z14032",2797,134,13,121," 4.3"
"3146","Z14033",1008,61,10,51," 5.1"
"3147","Z14034",915,91,20,71," 7.8"
"3148","Z14036",2392,301,27,274,"11.5"
"3149","Z14037",412,16,0,16," 3.9"
"3150","Z14040",868,52,13,39," 4.5"
"3151","Z14042",1879,309,170,139," 7.4"
"3152","Z14043",11169,558,24,534," 4.8"
"3153","Z14047",2835,235,33,202," 7.1"
"3154","Z14048",7307,1023,296,727," 9.9"
"3155","Z14051",7841,173,74,99," 1.3"
"3156","Z14052",7107,509,28,481," 6.8"
"3157","Z14054",612,51,12,39," 6.4"
"3158","Z14057",3344,201,59,142," 4.2"
"3159","Z14058",846,90,37,53," 6.3"
"3160","Z14059",4272,198,64,134," 3.1"
"3161","Z14063",6166,897,312,585," 9.5"
"3162","Z14065",925,181,93,88," 9.5"
"3163","Z14066",546,94,74,20," 3.7"
"3164","Z14067",2281,263,64,199," 8.7"
"3165","Z14068",2942,114,0,114," 3.9"
"3166","Z14069",441,73,45,28," 6.3"
"3167","Z14070",2294,292,47,245,"10.7"
"3168","Z14072",8320,458,29,429," 5.2"
"3169","Z14075",18330,525,52,473," 2.6"
"3170","Z14080",1859,121,44,77," 4.1"
"3171","Z14081",1692,433,320,113," 6.7"
"3172","Z14082",198,24,12,12," 6.1"
"3173","Z14085",2672,196,48,148," 5.5"
"3174","Z14086",13080,701,35,666," 5.1"
"3175","Z14091",426,54,21,33," 7.7"
"3176","Z14092",5089,393,168,225," 4.4"
"3177","Z14094",22455,2049,55,1994," 8.9"
"3178","Z14098",1713,573,430,143," 8.3"
"3179","Z14103",4703,323,43,280," 6.0"
"3180","Z14105",1951,157,17,140," 7.2"
"3181","Z14108",2368,184,14,170," 7.2"
"3182","Z14111",1386,111,0,111," 8.0"
"3183","Z14113",298,35,30,5," 1.7"
"3184","Z14120",19875,1133,95,1038," 5.2"
"3185","Z14125",1526,96,5,91," 6.0"
"3186","Z14126",411,116,37,79,"19.2"
"3187","Z14127",12656,767,10,757," 6.0"
"3188","Z14130",76,5,0,5," 6.6"
"3189","Z14131",2183,119,0,119," 5.5"
"3190","Z14132",2704,230,2,228," 8.4"
"3191","Z14135",80,5,0,5," 6.2"
"3192","Z14136",2325,281,125,156," 6.7"
"3193","Z14138",917,117,30,87," 9.5"
"3194","Z14139",1003,60,34,26," 2.6"
"3195","Z14141",3426,199,22,177," 5.2"
"3196","Z14145",729,39,39,0," 0.0"
"3197","Z14150",19961,1146,27,1119," 5.6"
"3198","Z14167",785,51,17,34," 4.3"
"3199","Z14171",1050,191,126,65," 6.2"
"3200","Z14174",2497,300,118,182," 7.3"
"3201","Z14201",7060,1027,0,1027,"14.5"
"3202","Z14202",2098,448,47,401,"19.1"
"3203","Z14203",1012,104,0,104,"10.3"
"3204","Z14204",5170,1067,30,1037,"20.1"
"3205","Z14206",10590,1561,22,1539,"14.5"
"3206","Z14207",11104,1742,32,1710,"15.4"
"3207","Z14208",5746,1397,0,1397,"24.3"
"3208","Z14209",4818,938,25,913,"18.9"
"3209","Z14210",7097,1143,12,1131,"15.9"
"3210","Z14211",12059,2870,16,2854,"23.7"
"3211","Z14212",6354,1705,0,1705,"26.8"
"3212","Z14213",10919,2037,13,2024,"18.5"
"3213","Z14214",9390,1351,8,1343,"14.3"
"3214","Z14215",18587,2628,13,2615,"14.1"
"3215","Z14216",11514,781,13,768," 6.7"
"3216","Z14217",11164,588,18,570," 5.1"
"3217","Z14218",9305,1059,23,1036,"11.1"
"3218","Z14219",5362,295,14,281," 5.2"
"3219","Z14220",10938,977,0,977," 8.9"
"3220","Z14221",23624,964,224,740," 3.1"
"3221","Z14222",7569,893,99,794,"10.5"
"3222","Z14223",10180,390,0,390," 3.8"
"3223","Z14224",18391,951,139,812," 4.4"
"3224","Z14225",16247,1410,14,1396," 8.6"
"3225","Z14226",12768,446,22,424," 3.3"
"3226","Z14227",11105,303,0,303," 2.7"
"3227","Z14228",9409,387,25,362," 3.8"
"3228","Z14301",7564,1934,58,1876,"24.8"
"3229","Z14303",3603,892,85,807,"22.4"
"3230","Z14304",13809,1166,20,1146," 8.3"
"3231","Z14305",8289,1606,14,1592,"19.2"
"3232","Z14411",5450,755,131,624,"11.4"
"3233","Z14414",3013,145,0,145," 4.8"
"3234","Z14416",1471,33,0,33," 2.2"
"3235","Z14420",7781,759,85,674," 8.7"
"3236","Z14422",982,46,0,46," 4.7"
"3237","Z14423",1974,84,6,78," 4.0"
"3238","Z14424",13310,1577,841,736," 5.5"
"3239","Z14425",4665,180,0,180," 3.9"
"3240","Z14427",1055,184,147,37," 3.5"
"3241","Z14428",3386,127,28,99," 2.9"
"3242","Z14432",2477,134,5,129," 5.2"
"3243","Z14433",1797,324,28,296,"16.5"
"3244","Z14435",1754,527,425,102," 5.8"
"3245","Z14437",4533,532,170,362," 8.0"
"3246","Z14441",230,74,65,9," 3.9"
"3247","Z14445",3676,192,25,167," 4.5"
"3248","Z14450",17467,530,77,453," 2.6"
"3249","Z14454",3692,423,143,280," 7.6"
"3250","Z14456",8339,668,196,472," 5.7"
"3251","Z14462",234,21,9,12," 5.1"
"3252","Z14464",3031,301,176,125," 4.1"
"3253","Z14466",812,97,46,51," 6.3"
"3254","Z14467",4255,241,32,209," 4.9"
"3255","Z14468",7194,432,184,248," 3.4"
"3256","Z14469",2822,224,16,208," 7.4"
"3257","Z14470",3483,163,11,152," 4.4"
"3258","Z14471",2021,826,722,104," 5.1"
"3259","Z14472",3582,155,0,155," 4.3"
"3260","Z14476",932,92,49,43," 4.6"
"3261","Z14477",982,245,193,52," 5.3"
"3262","Z14478",755,469,451,18," 2.4"
"3263","Z14480",388,63,47,16," 4.1"
"3264","Z14481",838,49,5,44," 5.3"
"3265","Z14482",3600,243,15,228," 6.3"
"3266","Z14485",1933,123,0,123," 6.4"
"3267","Z14487",2498,286,189,97," 3.9"
"3268","Z14489",3012,235,46,189," 6.3"
"3269","Z14502",4114,112,0,112," 2.7"
"3270","Z14504",833,44,11,33," 4.0"
"3271","Z14507",902,359,272,87," 9.6"
"3272","Z14510",2081,263,23,240,"11.5"
"3273","Z14512",2627,655,501,154," 5.9"
"3274","Z14513",6306,537,135,402," 6.4"
"3275","Z14514",2636,117,0,117," 4.4"
"3276","Z14516",1096,166,98,68," 6.2"
"3277","Z14517",1384,146,9,137," 9.9"
"3278","Z14519",5064,208,45,163," 3.2"
"3279","Z14521",1299,264,86,178,"13.7"
"3280","Z14522",4287,281,65,216," 5.0"
"3281","Z14525",992,20,9,11," 1.1"
"3282","Z14526",8342,283,21,262," 3.1"
"3283","Z14527",6743,1623,1226,397," 5.9"
"3284","Z14530",2724,458,267,191," 7.0"
"3285","Z14532",1907,123,0,123," 6.4"
"3286","Z14533",850,61,21,40," 4.7"
"3287","Z14534",12740,591,153,438," 3.4"
"3288","Z14536",298,47,14,33,"11.1"
"3289","Z14541",1342,403,297,106," 7.9"
"3290","Z14543",1269,31,31,0," 0.0"
"3291","Z14546",2138,92,13,79," 3.7"
"3292","Z14551",2529,375,143,232," 9.2"
"3293","Z14555",1012,524,432,92," 9.1"
"3294","Z14559",7206,245,43,202," 2.8"
"3295","Z14560",1120,288,111,177,"15.8"
"3296","Z14561",1168,78,0,78," 6.7"
"3297","Z14564",5983,187,43,144," 2.4"
"3298","Z14568",2293,159,61,98," 4.3"
"3299","Z14569",2996,329,191,138," 4.6"
"3300","Z14580",21216,909,126,783," 3.7"
"3301","Z14585",73,12,0,12,"16.4"
"3302","Z14586",4373,129,22,107," 2.4"
"3303","Z14589",3353,423,147,276," 8.2"
"3304","Z14590",3164,1098,788,310," 9.8"
"3305","Z14591",761,100,12,88,"11.6"
"3306","Z14604",1744,471,59,412,"23.6"
"3307","Z14605",5508,908,7,901,"16.4"
"3308","Z14606",12346,937,34,903," 7.3"
"3309","Z14607",10024,768,0,768," 7.7"
"3310","Z14608",6115,966,24,942,"15.4"
"3311","Z14609",19593,1824,102,1722," 8.8"
"3312","Z14610",7441,668,66,602," 8.1"
"3313","Z14611",7971,1105,14,1091,"13.7"
"3314","Z14612",15408,880,171,709," 4.6"
"3315","Z14613",6114,1385,18,1367,"22.4"
"3316","Z14615",7763,701,9,692," 8.9"
"3317","Z14616",12712,680,0,680," 5.3"
"3318","Z14617",10105,640,44,596," 5.9"
"3319","Z14618",8586,362,115,247," 2.9"
"3320","Z14619",6337,752,0,752,"11.9"
"3321","Z14620",12266,783,40,743," 6.1"
"3322","Z14621",14707,1925,0,1925,"13.1"
"3323","Z14622",5838,428,24,404," 6.9"
"3324","Z14623",9477,553,40,513," 5.4"
"3325","Z14624",14473,450,0,450," 3.1"
"3326","Z14625",4761,357,47,310," 6.5"
"3327","Z14626",13316,842,79,763," 5.7"
"3328","Z14701",19198,2406,267,2139,"11.1"
"3329","Z14706",2854,299,131,168," 5.9"
"3330","Z14709",989,394,309,85," 8.6"
"3331","Z14710",2116,790,684,106," 5.0"
"3332","Z14711",1070,269,186,83," 7.8"
"3333","Z14712",2113,634,564,70," 3.3"
"3334","Z14715",1606,476,309,167,"10.4"
"3335","Z14716",1026,124,24,100," 9.7"
"3336","Z14717",1018,736,726,10," 1.0"
"3337","Z14718",1011,134,109,25," 2.5"
"3338","Z14719",1854,472,315,157," 8.5"
"3339","Z14720",434,71,9,62,"14.3"
"3340","Z14723",612,167,140,27," 4.4"
"3341","Z14724",1492,601,499,102," 6.8"
"3342","Z14727",3424,1278,1042,236," 6.9"
"3343","Z14728",928,569,543,26," 2.8"
"3344","Z14729",437,78,63,15," 3.4"
"3345","Z14731",2648,1970,1774,196," 7.4"
"3346","Z14732",67,15,15,0," 0.0"
"3347","Z14733",1857,150,48,102," 5.5"
"3348","Z14735",1543,364,258,106," 6.9"
"3349","Z14736",162,47,47,0," 0.0"
"3350","Z14737",2546,815,661,154," 6.0"
"3351","Z14738",1937,398,283,115," 5.9"
"3352","Z14740",658,137,46,91,"13.8"
"3353","Z14741",1414,572,505,67," 4.7"
"3354","Z14743",986,234,167,67," 6.8"
"3355","Z14747",1019,87,38,49," 4.8"
"3356","Z14748",396,72,42,30," 7.6"
"3357","Z14753",583,129,62,67,"11.5"
"3358","Z14754",341,81,78,3," 0.9"
"3359","Z14755",1600,388,281,107," 6.7"
"3360","Z14757",2417,1034,897,137," 5.7"
"3361","Z14760",9279,1326,176,1150,"12.4"
"3362","Z14770",1231,98,27,71," 5.8"
"3363","Z14772",1686,236,175,61," 3.6"
"3364","Z14775",1200,242,111,131,"10.9"
"3365","Z14779",3223,525,153,372,"11.5"
"3366","Z14781",827,107,70,37," 4.5"
"3367","Z14784",474,161,132,29," 6.1"
"3368","Z14787",2628,507,309,198," 7.5"
"3369","Z14801",2516,324,148,176," 7.0"
"3370","Z14802",508,115,9,106,"20.9"
"3371","Z14803",549,96,50,46," 8.4"
"3372","Z14804",928,314,281,33," 3.6"
"3373","Z14805",463,52,32,20," 4.3"
"3374","Z14806",1114,271,173,98," 8.8"
"3375","Z14807",1433,214,143,71," 5.0"
"3376","Z14808",249,30,0,30,"12.0"
"3377","Z14809",1184,142,88,54," 4.6"
"3378","Z14810",5920,767,247,520," 8.8"
"3379","Z14812",1352,168,67,101," 7.5"
"3380","Z14813",1374,336,236,100," 7.3"
"3381","Z14815",735,335,306,29," 3.9"
"3382","Z14817",1068,81,44,37," 3.5"
"3383","Z14818",1030,205,170,35," 3.4"
"3384","Z14821",1381,117,27,90," 6.5"
"3385","Z14822",746,261,168,93,"12.5"
"3386","Z14823",1939,474,279,195,"10.1"
"3387","Z14824",249,24,8,16," 6.4"
"3388","Z14826",1151,286,182,104," 9.0"
"3389","Z14830",9392,774,77,697," 7.4"
"3390","Z14837",3075,940,716,224," 7.3"
"3391","Z14838",892,59,34,25," 2.8"
"3392","Z14840",2857,1435,1301,134," 4.7"
"3393","Z14841",617,241,156,85,"13.8"
"3394","Z14842",613,196,196,0," 0.0"
"3395","Z14843",6081,649,190,459," 7.5"
"3396","Z14845",9307,603,35,568," 6.1"
"3397","Z14847",1279,252,148,104," 8.1"
"3398","Z14850",26524,2342,493,1849," 7.0"
"3399","Z14858",711,66,35,31," 4.4"
"3400","Z14859",498,133,58,75,"15.1"
"3401","Z14860",869,343,298,45," 5.2"
"3402","Z14861",657,70,34,36," 5.5"
"3403","Z14865",1312,136,39,97," 7.4"
"3404","Z14867",2435,137,36,101," 4.1"
"3405","Z14869",554,44,4,40," 7.2"
"3406","Z14870",4501,240,12,228," 5.1"
"3407","Z14871",2196,72,6,66," 3.0"
"3408","Z14873",1736,639,562,77," 4.4"
"3409","Z14878",408,156,110,46,"11.3"
"3410","Z14879",1061,107,32,75," 7.1"
"3411","Z14880",966,361,311,50," 5.2"
"3412","Z14882",1907,318,151,167," 8.8"
"3413","Z14883",1796,286,36,250,"13.9"
"3414","Z14886",3274,283,161,122," 3.7"
"3415","Z14889",705,59,35,24," 3.4"
"3416","Z14891",2165,269,100,169," 7.8"
"3417","Z14892",3659,316,50,266," 7.3"
"3418","Z14894",642,80,0,80,"12.5"
"3419","Z14895",4999,733,336,397," 7.9"
"3420","Z14897",442,72,30,42," 9.5"
"3421","Z14898",767,157,114,43," 5.6"
"3422","Z14901",6231,754,19,735,"11.8"
"3423","Z14903",3402,329,44,285," 8.4"
"3424","Z14904",7216,723,68,655," 9.1"
"3425","Z15001",15011,1965,176,1789,"11.9"
"3426","Z15003",6061,843,104,739,"12.2"
"3427","Z15005",4342,251,14,237," 5.5"
"3428","Z15009",7003,508,38,470," 6.7"
"3429","Z15010",12854,1629,53,1576,"12.3"
"3430","Z15012",7265,799,12,787,"10.8"
"3431","Z15015",515,19,0,19," 3.7"
"3432","Z15017",7730,426,20,406," 5.3"
"3433","Z15018",350,58,8,50,"14.3"
"3434","Z15019",749,17,0,17," 2.3"
"3435","Z15021",3423,327,16,311," 9.1"
"3436","Z15022",5098,791,17,774,"15.2"
"3437","Z15024",3970,297,24,273," 6.9"
"3438","Z15025",7921,1035,0,1035,"13.1"
"3439","Z15026",1391,102,7,95," 6.8"
"3440","Z15027",1062,85,0,85," 8.0"
"3441","Z15031",342,24,0,24," 7.0"
"3442","Z15033",2655,721,26,695,"26.2"
"3443","Z15034",986,101,0,101,"10.2"
"3444","Z15035",1178,158,0,158,"13.4"
"3445","Z15037",5018,393,9,384," 7.7"
"3446","Z15042",3684,237,10,227," 6.2"
"3447","Z15043",948,149,24,125,"13.2"
"3448","Z15044",10824,568,26,542," 5.0"
"3449","Z15045",2318,329,6,323,"13.9"
"3450","Z15046",1098,72,6,66," 6.0"
"3451","Z15050",955,41,0,41," 4.3"
"3452","Z15052",1582,134,32,102," 6.4"
"3453","Z15055",746,51,0,51," 6.8"
"3454","Z15056",596,77,0,77,"12.9"
"3455","Z15057",5974,366,14,352," 5.9"
"3456","Z15059",1787,252,22,230,"12.9"
"3457","Z15060",316,31,0,31," 9.8"
"3458","Z15061",5764,604,11,593,"10.3"
"3459","Z15062",4545,974,54,920,"20.2"
"3460","Z15063",5194,682,9,673,"13.0"
"3461","Z15064",168,8,0,8," 4.8"
"3462","Z15065",5577,693,28,665,"11.9"
"3463","Z15066",5889,476,64,412," 7.0"
"3464","Z15067",1104,131,0,131,"11.9"
"3465","Z15068",18704,2121,53,2068,"11.1"
"3466","Z15071",4647,293,20,273," 5.9"
"3467","Z15074",4292,465,62,403," 9.4"
"3468","Z15081",239,21,0,21," 8.8"
"3469","Z15083",487,83,12,71,"14.6"
"3470","Z15084",4948,554,0,554,"11.2"
"3471","Z15085",3767,430,0,430,"11.4"
"3472","Z15086",169,17,0,17,"10.1"
"3473","Z15089",2953,306,10,296,"10.0"
"3474","Z15090",8790,424,0,424," 4.8"
"3475","Z15101",10504,618,0,618," 5.9"
"3476","Z15102",12750,508,16,492," 3.9"
"3477","Z15104",5019,1219,6,1213,"24.2"
"3478","Z15106",9608,704,22,682," 7.1"
"3479","Z15108",18271,1153,33,1120," 6.1"
"3480","Z15110",2988,677,21,656,"22.0"
"3481","Z15112",1878,362,0,362,"19.3"
"3482","Z15116",6181,211,11,200," 3.2"
"3483","Z15120",9580,1256,32,1224,"12.8"
"3484","Z15122",9680,1029,21,1008,"10.4"
"3485","Z15126",3123,215,0,215," 6.9"
"3486","Z15129",4669,278,16,262," 5.6"
"3487","Z15131",4173,252,30,222," 5.3"
"3488","Z15132",11934,2362,17,2345,"19.6"
"3489","Z15133",3153,264,31,233," 7.4"
"3490","Z15135",2393,151,31,120," 5.0"
"3491","Z15136",10664,1255,17,1238,"11.6"
"3492","Z15137",5082,590,0,590,"11.6"
"3493","Z15139",3256,161,6,155," 4.8"
"3494","Z15140",1884,330,0,330,"17.5"
"3495","Z15142",558,15,0,15," 2.7"
"3496","Z15143",8373,657,44,613," 7.3"
"3497","Z15144",2094,205,9,196," 9.4"
"3498","Z15145",3922,652,0,652,"16.6"
"3499","Z15146",13552,1020,43,977," 7.2"
"3500","Z15147",8937,692,0,692," 7.7"
"3501","Z15148",1556,395,0,395,"25.4"
"3502","Z15201",6985,732,0,732,"10.5"
"3503","Z15202",10843,1327,15,1312,"12.1"
"3504","Z15203",6286,1465,123,1342,"21.3"
"3505","Z15204",4088,411,6,405," 9.9"
"3506","Z15205",10885,687,0,687," 6.3"
"3507","Z15206",15371,1870,26,1844,"12.0"
"3508","Z15207",5911,874,0,874,"14.8"
"3509","Z15208",5298,916,56,860,"16.2"
"3510","Z15209",6094,558,0,558," 9.2"
"3511","Z15210",13129,2055,10,2045,"15.6"
"3512","Z15211",6715,1226,140,1086,"16.2"
"3513","Z15212",16057,3267,79,3188,"19.9"
"3514","Z15213",11138,1852,84,1768,"15.9"
"3515","Z15214",7152,1010,14,996,"13.9"
"3516","Z15215",6096,571,0,571," 9.4"
"3517","Z15216",11564,1016,0,1016," 8.8"
"3518","Z15217",12866,913,117,796," 6.2"
"3519","Z15218",7762,944,19,925,"11.9"
"3520","Z15219",6480,1279,102,1177,"18.2"
"3521","Z15220",8874,861,9,852," 9.6"
"3522","Z15221",18459,3092,136,2956,"16.0"
"3523","Z15222",2219,263,55,208," 9.4"
"3524","Z15223",3430,306,0,306," 8.9"
"3525","Z15224",5858,652,0,652,"11.1"
"3526","Z15225",614,33,0,33," 5.4"
"3527","Z15226",6775,622,5,617," 9.1"
"3528","Z15227",13047,904,14,890," 6.8"
"3529","Z15228",7738,399,0,399," 5.2"
"3530","Z15229",6635,368,14,354," 5.3"
"3531","Z15232",7046,789,46,743,"10.5"
"3532","Z15233",1606,445,0,445,"27.7"
"3533","Z15234",6811,372,0,372," 5.5"
"3534","Z15235",16327,1521,79,1442," 8.8"
"3535","Z15236",13191,914,35,879," 6.7"
"3536","Z15237",18853,852,62,790," 4.2"
"3537","Z15238",5834,461,37,424," 7.3"
"3538","Z15239",8851,305,0,305," 3.4"
"3539","Z15241",7768,291,16,275," 3.5"
"3540","Z15243",5851,138,7,131," 2.2"
"3541","Z15301",22166,2004,263,1741," 7.9"
"3542","Z15312",1544,147,19,128," 8.3"
"3543","Z15313",176,31,4,27,"15.3"
"3544","Z15314",1830,208,5,203,"11.1"
"3545","Z15317",16001,1182,266,916," 5.7"
"3546","Z15320",2506,277,38,239," 9.5"
"3547","Z15323",1904,159,6,153," 8.0"
"3548","Z15327",628,69,5,64,"10.2"
"3549","Z15329",636,96,0,96,"15.1"
"3550","Z15330",2348,263,3,260,"11.1"
"3551","Z15332",3828,266,8,258," 6.7"
"3552","Z15333",1042,107,7,100," 9.6"
"3553","Z15337",310,68,11,57,"18.4"
"3554","Z15338",765,123,4,119,"15.6"
"3555","Z15340",680,76,13,63," 9.3"
"3556","Z15342",2444,390,15,375,"15.3"
"3557","Z15345",754,107,5,102,"13.5"
"3558","Z15348",147,16,16,0," 0.0"
"3559","Z15349",892,98,24,74," 8.3"
"3560","Z15350",213,24,0,24,"11.3"
"3561","Z15352",419,92,29,63,"15.0"
"3562","Z15357",725,33,18,15," 2.1"
"3563","Z15358",471,74,0,74,"15.7"
"3564","Z15359",63,1,0,1," 1.6"
"3565","Z15360",760,80,18,62," 8.2"
"3566","Z15367",2994,46,0,46," 1.5"
"3567","Z15370",5306,649,121,528,"10.0"
"3568","Z15376",710,83,16,67," 9.4"
"3569","Z15401",15413,1725,84,1641,"10.6"
"3570","Z15411",619,294,277,17," 2.7"
"3571","Z15417",4357,806,19,787,"18.1"
"3572","Z15419",2374,527,17,510,"21.5"
"3573","Z15423",906,50,5,45," 5.0"
"3574","Z15424",1685,790,637,153," 9.1"
"3575","Z15425",8786,832,57,775," 8.8"
"3576","Z15427",517,44,0,44," 8.5"
"3577","Z15428",833,103,0,103,"12.4"
"3578","Z15431",1956,178,22,156," 8.0"
"3579","Z15432",204,20,0,20," 9.8"
"3580","Z15436",1118,103,20,83," 7.4"
"3581","Z15437",1199,371,236,135,"11.3"
"3582","Z15438",917,166,12,154,"16.8"
"3583","Z15440",237,46,30,16," 6.8"
"3584","Z15442",772,71,0,71," 9.2"
"3585","Z15445",1216,185,42,143,"11.8"
"3586","Z15456",1272,219,8,211,"16.6"
"3587","Z15458",1157,139,39,100," 8.6"
"3588","Z15459",810,203,93,110,"13.6"
"3589","Z15461",1700,183,22,161," 9.5"
"3590","Z15464",742,128,74,54," 7.3"
"3591","Z15468",1047,111,0,111,"10.6"
"3592","Z15469",941,77,35,42," 4.5"
"3593","Z15470",595,263,108,155,"26.1"
"3594","Z15473",1968,231,15,216,"11.0"
"3595","Z15474",1009,227,21,206,"20.4"
"3596","Z15475",520,140,68,72,"13.8"
"3597","Z15478",2786,273,15,258," 9.3"
"3598","Z15479",925,66,0,66," 7.1"
"3599","Z15480",830,104,25,79," 9.5"
"3600","Z15486",978,74,0,74," 7.6"
"3601","Z15501",7750,1301,768,533," 6.9"
"3602","Z15502",764,716,716,0," 0.0"
"3603","Z15521",817,83,21,62," 7.6"
"3604","Z15522",5840,906,468,438," 7.5"
"3605","Z15530",2295,236,94,142," 6.2"
"3606","Z15531",2067,412,191,221,"10.7"
"3607","Z15533",786,180,77,103,"13.1"
"3608","Z15534",470,94,71,23," 4.9"
"3609","Z15535",1231,399,266,133,"10.8"
"3610","Z15536",264,77,54,23," 8.7"
"3611","Z15537",3795,594,281,313," 8.2"
"3612","Z15538",619,316,301,15," 2.4"
"3613","Z15540",247,153,139,14," 5.7"
"3614","Z15541",1680,267,191,76," 4.5"
"3615","Z15542",478,43,6,37," 7.7"
"3616","Z15545",1350,174,84,90," 6.7"
"3617","Z15547",223,36,6,30,"13.5"
"3618","Z15550",1021,306,229,77," 7.5"
"3619","Z15551",448,91,79,12," 2.7"
"3620","Z15552",2713,492,210,282,"10.4"
"3621","Z15554",1179,135,95,40," 3.4"
"3622","Z15558",972,101,50,51," 5.2"
"3623","Z15559",1032,187,106,81," 7.8"
"3624","Z15560",86,18,9,9,"10.5"
"3625","Z15562",65,6,6,0," 0.0"
"3626","Z15563",1530,330,213,117," 7.6"
"3627","Z15601",27033,2510,99,2411," 8.9"
"3628","Z15610",1777,290,185,105," 5.9"
"3629","Z15611",288,101,0,101,"35.1"
"3630","Z15613",6203,337,22,315," 5.1"
"3631","Z15617",145,7,1,6," 4.1"
"3632","Z15618",1204,84,4,80," 6.6"
"3633","Z15623",332,33,0,33," 9.9"
"3634","Z15624",240,48,0,48,"20.0"
"3635","Z15626",2601,264,14,250," 9.6"
"3636","Z15627",3031,340,0,340,"11.2"
"3637","Z15628",343,115,81,34," 9.9"
"3638","Z15631",528,70,0,70,"13.3"
"3639","Z15632",3944,326,5,321," 8.1"
"3640","Z15636",1477,12,0,12," 0.8"
"3641","Z15637",770,41,0,41," 5.3"
"3642","Z15639",1042,96,0,96," 9.2"
"3643","Z15641",218,8,6,2," 0.9"
"3644","Z15642",19258,1181,72,1109," 5.8"
"3645","Z15644",8972,848,0,848," 9.5"
"3646","Z15646",128,45,21,24,"18.8"
"3647","Z15650",12742,1447,243,1204," 9.4"
"3648","Z15656",4713,404,24,380," 8.1"
"3649","Z15658",4934,948,570,378," 7.7"
"3650","Z15661",308,58,0,58,"18.8"
"3651","Z15663",209,8,0,8," 3.8"
"3652","Z15665",583,5,0,5," 0.9"
"3653","Z15666",7530,549,61,488," 6.5"
"3654","Z15668",5553,230,0,230," 4.1"
"3655","Z15670",1647,74,0,74," 4.5"
"3656","Z15671",389,65,44,21," 5.4"
"3657","Z15672",1621,38,0,38," 2.3"
"3658","Z15673",590,44,9,35," 5.9"
"3659","Z15675",447,22,0,22," 4.9"
"3660","Z15678",177,14,0,14," 7.9"
"3661","Z15679",1423,128,0,128," 9.0"
"3662","Z15681",2171,199,22,177," 8.2"
"3663","Z15683",3821,338,0,338," 8.8"
"3664","Z15684",344,66,0,66,"19.2"
"3665","Z15686",464,86,73,13," 2.8"
"3666","Z15687",569,96,45,51," 9.0"
"3667","Z15690",4492,673,32,641,"14.3"
"3668","Z15695",147,13,0,13," 8.8"
"3669","Z15696",184,20,0,20,"10.9"
"3670","Z15697",1493,142,0,142," 9.5"
"3671","Z15701",15206,1735,76,1659,"10.9"
"3672","Z15711",232,45,10,35,"15.1"
"3673","Z15714",2302,228,35,193," 8.4"
"3674","Z15717",5090,764,23,741,"14.6"
"3675","Z15722",1088,79,15,64," 5.9"
"3676","Z15725",633,54,20,34," 5.4"
"3677","Z15728",1631,197,26,171,"10.5"
"3678","Z15732",724,51,10,41," 5.7"
"3679","Z15733",51,3,0,3," 5.9"
"3680","Z15736",344,19,0,19," 5.5"
"3681","Z15742",421,59,20,39," 9.3"
"3682","Z15746",49,4,0,4," 8.2"
"3683","Z15747",817,63,29,34," 4.2"
"3684","Z15748",2996,250,43,207," 6.9"
"3685","Z15757",962,328,245,83," 8.6"
"3686","Z15759",1194,147,14,133,"11.1"
"3687","Z15762",350,11,8,3," 0.9"
"3688","Z15765",772,82,23,59," 7.6"
"3689","Z15767",6626,834,211,623," 9.4"
"3690","Z15770",66,8,0,8,"12.1"
"3691","Z15772",706,131,31,100,"14.2"
"3692","Z15773",214,29,0,29,"13.6"
"3693","Z15774",1304,27,0,27," 2.1"
"3694","Z15801",9441,1373,545,828," 8.8"
"3695","Z15821",493,435,435,0," 0.0"
"3696","Z15824",2479,275,139,136," 5.5"
"3697","Z15825",4670,773,520,253," 5.4"
"3698","Z15829",654,162,112,50," 7.6"
"3699","Z15834",2931,995,725,270," 9.2"
"3700","Z15840",903,76,35,41," 4.5"
"3701","Z15841",165,16,13,3," 1.8"
"3702","Z15845",1613,180,15,165,"10.2"
"3703","Z15846",1598,256,238,18," 1.1"
"3704","Z15848",431,68,55,13," 3.0"
"3705","Z15851",3163,357,165,192," 6.1"
"3706","Z15853",3668,867,646,221," 6.0"
"3707","Z15856",498,130,112,18," 3.6"
"3708","Z15857",6118,688,227,461," 7.5"
"3709","Z15861",527,470,470,0," 0.0"
"3710","Z15863",92,5,0,5," 5.4"
"3711","Z15864",855,124,64,60," 7.0"
"3712","Z15865",692,89,0,89,"12.9"
"3713","Z15870",1143,583,553,30," 2.6"
"3714","Z15901",2765,616,9,607,"22.0"
"3715","Z15902",6485,1213,85,1128,"17.4"
"3716","Z15904",6885,478,0,478," 6.9"
"3717","Z15905",10126,1103,187,916," 9.0"
"3718","Z15906",6048,872,26,846,"14.0"
"3719","Z15909",2606,369,15,354,"13.6"
"3720","Z15920",381,43,0,43,"11.3"
"3721","Z15921",90,17,0,17,"18.9"
"3722","Z15923",731,120,37,83,"11.4"
"3723","Z15926",1603,541,360,181,"11.3"
"3724","Z15927",475,46,0,46," 9.7"
"3725","Z15928",1081,92,52,40," 3.7"
"3726","Z15931",4023,378,65,313," 7.8"
"3727","Z15935",1127,88,84,4," 0.4"
"3728","Z15936",726,101,20,81,"11.2"
"3729","Z15938",1035,69,7,62," 6.0"
"3730","Z15942",919,48,0,48," 5.2"
"3731","Z15943",1835,228,35,193,"10.5"
"3732","Z15946",3105,316,121,195," 6.3"
"3733","Z15948",306,41,0,41,"13.4"
"3734","Z15949",265,17,0,17," 6.4"
"3735","Z15951",203,35,0,35,"17.2"
"3736","Z15954",1078,99,9,90," 8.3"
"3737","Z15955",1241,131,32,99," 8.0"
"3738","Z15956",1240,142,6,136,"11.0"
"3739","Z15958",905,67,7,60," 6.6"
"3740","Z15961",401,78,25,53,"13.2"
"3741","Z15963",5362,752,148,604,"11.3"
"3742","Z16001",19021,1300,165,1135," 6.0"
"3743","Z16002",6308,292,8,284," 4.5"
"3744","Z16020",495,52,14,38," 7.7"
"3745","Z16022",189,36,6,30,"15.9"
"3746","Z16023",2005,78,4,74," 3.7"
"3747","Z16025",2285,168,33,135," 5.9"
"3748","Z16028",1130,244,141,103," 9.1"
"3749","Z16029",321,14,7,7," 2.2"
"3750","Z16030",144,4,4,0," 0.0"
"3751","Z16033",2677,227,55,172," 6.4"
"3752","Z16034",764,49,20,29," 3.8"
"3753","Z16036",127,21,3,18,"14.2"
"3754","Z16037",1782,35,0,35," 2.0"
"3755","Z16038",1554,127,36,91," 5.9"
"3756","Z16040",424,53,12,41," 9.7"
"3757","Z16045",642,89,17,72,"11.2"
"3758","Z16046",6240,407,33,374," 6.0"
"3759","Z16049",1705,392,267,125," 7.3"
"3760","Z16051",1384,61,5,56," 4.0"
"3761","Z16052",1057,53,0,53," 5.0"
"3762","Z16053",1756,82,25,57," 3.2"
"3763","Z16054",191,26,0,26,"13.6"
"3764","Z16055",3501,201,37,164," 4.7"
"3765","Z16056",2214,166,3,163," 7.4"
"3766","Z16057",5497,752,275,477," 8.7"
"3767","Z16059",3268,138,20,118," 3.6"
"3768","Z16061",1163,110,23,87," 7.5"
"3769","Z16063",3251,134,43,91," 2.8"
"3770","Z16101",15585,1950,13,1937,"12.4"
"3771","Z16102",2749,369,6,363,"13.2"
"3772","Z16105",7072,488,40,448," 6.3"
"3773","Z16111",480,25,21,4," 0.8"
"3774","Z16112",715,63,0,63," 8.8"
"3775","Z16113",155,13,0,13," 8.4"
"3776","Z16114",271,29,19,10," 3.7"
"3777","Z16115",1433,117,24,93," 6.5"
"3778","Z16116",1268,150,0,150,"11.8"
"3779","Z16117",7777,670,41,629," 8.1"
"3780","Z16120",974,182,87,95," 9.8"
"3781","Z16123",1032,197,57,140,"13.6"
"3782","Z16124",847,90,50,40," 4.7"
"3783","Z16125",7838,682,163,519," 6.6"
"3784","Z16127",6017,599,135,464," 7.7"
"3785","Z16130",907,89,46,43," 4.7"
"3786","Z16131",372,90,29,61,"16.4"
"3787","Z16133",642,42,26,16," 2.5"
"3788","Z16134",2786,1096,986,110," 3.9"
"3789","Z16136",378,46,0,46,"12.2"
"3790","Z16137",4918,476,158,318," 6.5"
"3791","Z16142",2272,139,13,126," 5.5"
"3792","Z16143",1433,8,0,8," 0.6"
"3793","Z16145",1241,177,81,96," 7.7"
"3794","Z16146",7421,1426,16,1410,"19.0"
"3795","Z16148",7989,854,17,837,"10.5"
"3796","Z16150",3413,401,31,370,"10.8"
"3797","Z16151",39,2,0,2," 5.1"
"3798","Z16153",1205,135,78,57," 4.7"
"3799","Z16154",1265,68,0,68," 5.4"
"3800","Z16156",1244,128,44,84," 6.8"
"3801","Z16157",1582,185,8,177,"11.2"
"3802","Z16159",1945,196,43,153," 7.9"
"3803","Z16161",412,17,0,17," 4.1"
"3804","Z16201",8781,862,89,773," 8.8"
"3805","Z16210",590,185,138,47," 8.0"
"3806","Z16214",4651,763,186,577,"12.4"
"3807","Z16218",581,134,116,18," 3.1"
"3808","Z16222",1017,153,49,104,"10.2"
"3809","Z16223",92,23,9,14,"15.2"
"3810","Z16224",571,54,16,38," 6.7"
"3811","Z16226",4002,579,122,457,"11.4"
"3812","Z16229",2289,234,13,221," 9.7"
"3813","Z16230",187,20,0,20,"10.7"
"3814","Z16232",1921,223,54,169," 8.8"
"3815","Z16235",585,85,54,31," 5.3"
"3816","Z16239",2505,1839,1740,99," 4.0"
"3817","Z16240",766,154,61,93,"12.1"
"3818","Z16242",2130,193,84,109," 5.1"
"3819","Z16244",93,18,4,14,"15.1"
"3820","Z16246",111,12,0,12,"10.8"
"3821","Z16248",1456,162,49,113," 7.8"
"3822","Z16249",870,52,2,50," 5.7"
"3823","Z16254",1561,157,86,71," 4.5"
"3824","Z16255",788,135,58,77," 9.8"
"3825","Z16256",635,113,35,78,"12.3"
"3826","Z16258",1230,344,241,103," 8.4"
"3827","Z16262",1187,126,14,112," 9.4"
"3828","Z16263",154,6,0,6," 3.9"
"3829","Z16301",7958,1417,591,826,"10.4"
"3830","Z16313",1388,659,583,76," 5.5"
"3831","Z16314",2601,506,353,153," 5.9"
"3832","Z16316",4013,1615,1359,256," 6.4"
"3833","Z16317",713,108,56,52," 7.3"
"3834","Z16319",565,84,66,18," 3.2"
"3835","Z16323",7692,894,149,745," 9.7"
"3836","Z16327",1374,186,87,99," 7.2"
"3837","Z16335",13092,1536,314,1222," 9.3"
"3838","Z16340",1417,590,495,95," 6.7"
"3839","Z16341",1129,355,306,49," 4.3"
"3840","Z16342",1144,284,191,93," 8.1"
"3841","Z16343",193,47,0,47,"24.4"
"3842","Z16344",251,48,0,48,"19.1"
"3843","Z16345",1845,357,287,70," 3.8"
"3844","Z16346",1628,161,0,161," 9.9"
"3845","Z16347",1718,821,710,111," 6.5"
"3846","Z16350",1179,127,45,82," 7.0"
"3847","Z16351",2590,1886,1777,109," 4.2"
"3848","Z16353",5004,3759,3563,196," 3.9"
"3849","Z16354",5292,726,284,442," 8.4"
"3850","Z16360",623,82,47,35," 5.6"
"3851","Z16361",57,7,7,0," 0.0"
"3852","Z16362",599,102,68,34," 5.7"
"3853","Z16364",609,127,69,58," 9.5"
"3854","Z16365",9211,1282,559,723," 7.8"
"3855","Z16371",1596,237,126,111," 7.0"
"3856","Z16372",217,27,3,24,"11.1"
"3857","Z16373",1789,473,344,129," 7.2"
"3858","Z16374",1796,980,948,32," 1.8"
"3859","Z16401",1983,238,71,167," 8.4"
"3860","Z16402",344,28,20,8," 2.3"
"3861","Z16403",2630,410,252,158," 6.0"
"3862","Z16404",1555,328,207,121," 7.8"
"3863","Z16406",1512,200,107,93," 6.2"
"3864","Z16407",4872,567,142,425," 8.7"
"3865","Z16410",670,45,14,31," 4.6"
"3866","Z16411",734,138,111,27," 3.7"
"3867","Z16412",4837,542,115,427," 8.8"
"3868","Z16415",3488,207,33,174," 5.0"
"3869","Z16417",3277,181,15,166," 5.1"
"3870","Z16420",429,181,158,23," 5.4"
"3871","Z16423",1905,201,42,159," 8.3"
"3872","Z16424",3847,1873,1652,221," 5.7"
"3873","Z16426",1627,59,0,59," 3.6"
"3874","Z16428",5245,285,155,130," 2.5"
"3875","Z16433",2307,278,168,110," 4.8"
"3876","Z16434",1062,133,104,29," 2.7"
"3877","Z16435",896,182,73,109,"12.2"
"3878","Z16436",491,257,238,19," 3.9"
"3879","Z16438",4217,1076,760,316," 7.5"
"3880","Z16440",479,87,80,7," 1.5"
"3881","Z16441",4131,319,95,224," 5.4"
"3882","Z16442",1189,112,36,76," 6.4"
"3883","Z16501",1425,114,0,114," 8.0"
"3884","Z16502",8088,1017,13,1004,"12.4"
"3885","Z16503",7132,1243,5,1238,"17.4"
"3886","Z16504",7183,542,0,542," 7.5"
"3887","Z16505",8187,701,322,379," 4.6"
"3888","Z16506",10151,396,64,332," 3.3"
"3889","Z16507",4744,667,55,612,"12.9"
"3890","Z16508",7464,525,31,494," 6.6"
"3891","Z16509",12515,584,36,548," 4.4"
"3892","Z16510",10400,658,73,585," 5.6"
"3893","Z16511",5113,461,150,311," 6.1"
"3894","Z16602",13368,1111,35,1076," 8.0"
"3895","Z16611",1144,124,87,37," 3.2"
"3896","Z16613",648,62,16,46," 7.1"
"3897","Z16617",1347,158,48,110," 8.2"
"3898","Z16620",149,26,9,17,"11.4"
"3899","Z16621",393,92,60,32," 8.1"
"3900","Z16627",1115,231,77,154,"13.8"
"3901","Z16630",1995,143,27,116," 5.8"
"3902","Z16635",5257,307,27,280," 5.3"
"3903","Z16637",1108,91,58,33," 3.0"
"3904","Z16639",791,184,121,63," 8.0"
"3905","Z16640",597,242,196,46," 7.7"
"3906","Z16641",1204,143,0,143,"11.9"
"3907","Z16646",1113,102,44,58," 5.2"
"3908","Z16647",631,317,300,17," 2.7"
"3909","Z16648",6572,469,103,366," 5.6"
"3910","Z16650",1040,253,179,74," 7.1"
"3911","Z16651",1828,304,77,227,"12.4"
"3912","Z16652",7238,1400,900,500," 6.9"
"3913","Z16655",702,68,16,52," 7.4"
"3914","Z16656",630,122,51,71,"11.3"
"3915","Z16657",1032,491,424,67," 6.5"
"3916","Z16659",140,16,0,16,"11.4"
"3917","Z16661",443,94,23,71,"16.0"
"3918","Z16662",2600,213,49,164," 6.3"
"3919","Z16665",136,15,0,15,"11.0"
"3920","Z16666",1533,346,29,317,"20.7"
"3921","Z16667",545,17,10,7," 1.3"
"3922","Z16668",1680,171,31,140," 8.3"
"3923","Z16669",1368,452,396,56," 4.1"
"3924","Z16673",2297,163,24,139," 6.1"
"3925","Z16678",1364,239,125,114," 8.4"
"3926","Z16679",387,40,19,21," 5.4"
"3927","Z16680",244,69,14,55,"22.5"
"3928","Z16683",239,65,49,16," 6.7"
"3929","Z16686",5815,636,136,500," 8.6"
"3930","Z16689",212,32,25,7," 3.3"
"3931","Z16692",344,76,61,15," 4.4"
"3932","Z16693",1749,201,82,119," 6.8"
"3933","Z16695",401,18,0,18," 4.5"
"3934","Z16701",8330,954,325,629," 7.6"
"3935","Z16720",2225,1728,1674,54," 2.4"
"3936","Z16727",74,5,5,0," 0.0"
"3937","Z16729",380,45,35,10," 2.6"
"3938","Z16731",1323,148,89,59," 4.5"
"3939","Z16732",189,21,5,16," 8.5"
"3940","Z16735",3816,1084,853,231," 6.1"
"3941","Z16738",830,260,244,16," 1.9"
"3942","Z16740",630,172,152,20," 3.2"
"3943","Z16743",1948,249,198,51," 2.6"
"3944","Z16745",237,18,9,9," 3.8"
"3945","Z16746",740,217,169,48," 6.5"
"3946","Z16748",1587,506,330,176,"11.1"
"3947","Z16749",2180,591,543,48," 2.2"
"3948","Z16750",215,47,41,6," 2.8"
"3949","Z16801",19162,1970,545,1425," 7.4"
"3950","Z16803",11296,1007,255,752," 6.7"
"3951","Z16820",478,104,63,41," 8.6"
"3952","Z16822",1193,391,310,81," 6.8"
"3953","Z16823",11778,894,353,541," 4.6"
"3954","Z16827",1837,208,114,94," 5.1"
"3955","Z16828",2129,155,104,51," 2.4"
"3956","Z16829",413,154,100,54,"13.1"
"3957","Z16830",6765,799,254,545," 8.1"
"3958","Z16832",371,175,151,24," 6.5"
"3959","Z16833",2532,312,140,172," 6.8"
"3960","Z16834",133,68,44,24,"18.0"
"3961","Z16836",1067,606,561,45," 4.2"
"3962","Z16838",878,143,74,69," 7.9"
"3963","Z16839",276,60,0,60,"21.7"
"3964","Z16841",2681,466,310,156," 5.8"
"3965","Z16844",1245,127,64,63," 5.1"
"3966","Z16848",193,31,21,10," 5.2"
"3967","Z16849",160,14,14,0," 0.0"
"3968","Z16853",149,36,0,36,"24.2"
"3969","Z16854",446,90,36,54,"12.1"
"3970","Z16858",1727,228,114,114," 6.6"
"3971","Z16859",281,81,75,6," 2.1"
"3972","Z16863",363,76,47,29," 8.0"
"3973","Z16865",847,34,11,23," 2.7"
"3974","Z16866",4360,512,130,382," 8.8"
"3975","Z16868",191,39,0,39,"20.4"
"3976","Z16872",659,226,200,26," 3.9"
"3977","Z16874",653,96,50,46," 7.0"
"3978","Z16875",1876,252,131,121," 6.4"
"3979","Z16877",767,47,28,19," 2.5"
"3980","Z16878",988,155,80,75," 7.6"
"3981","Z16882",275,135,135,0," 0.0"
"3982","Z16901",5124,906,690,216," 4.2"
"3983","Z16911",199,34,31,3," 1.5"
"3984","Z16914",1136,352,283,69," 6.1"
"3985","Z16915",3653,1392,1072,320," 8.8"
"3986","Z16917",723,223,183,40," 5.5"
"3987","Z16922",2080,1292,1128,164," 7.9"
"3988","Z16923",854,254,207,47," 5.5"
"3989","Z16925",1513,300,198,102," 6.7"
"3990","Z16926",402,90,68,22," 5.5"
"3991","Z16927",303,41,32,9," 3.0"
"3992","Z16928",638,115,60,55," 8.6"
"3993","Z16929",1084,122,55,67," 6.2"
"3994","Z16930",654,167,146,21," 3.2"
"3995","Z16932",320,55,46,9," 2.8"
"3996","Z16933",3182,498,153,345,"10.8"
"3997","Z16935",759,218,181,37," 4.9"
"3998","Z16936",965,211,108,103,"10.7"
"3999","Z16938",844,549,519,30," 3.6"
"4000","Z16939",188,19,17,2," 1.1"
"4001","Z16940",143,12,2,10," 7.0"
"4002","Z16942",392,92,42,50,"12.8"
"4003","Z16947",2407,534,421,113," 4.7"
"4004","Z16948",1090,492,434,58," 5.3"
"4005","Z16950",2013,587,507,80," 4.0"
"4006","Z17002",259,21,21,0," 0.0"
"4007","Z17003",4345,181,9,172," 4.0"
"4008","Z17004",1781,126,61,65," 3.6"
"4009","Z17005",183,24,9,15," 8.2"
"4010","Z17006",618,241,233,8," 1.3"
"4011","Z17007",2247,91,0,91," 4.0"
"4012","Z17011",14398,740,39,701," 4.9"
"4013","Z17013",14889,1009,54,955," 6.4"
"4014","Z17015",8378,290,4,286," 3.4"
"4015","Z17016",341,57,0,57,"16.7"
"4016","Z17017",800,70,17,53," 6.6"
"4017","Z17018",1866,169,57,112," 6.0"
"4018","Z17019",7324,386,0,386," 5.3"
"4019","Z17020",4004,329,12,317," 7.9"
"4020","Z17021",664,264,214,50," 7.5"
"4021","Z17022",11412,612,55,557," 4.9"
"4022","Z17023",1488,127,3,124," 8.3"
"4023","Z17024",807,78,60,18," 2.2"
"4024","Z17025",7099,295,0,295," 4.2"
"4025","Z17026",1455,80,58,22," 1.5"
"4026","Z17030",372,32,0,32," 8.6"
"4027","Z17032",3566,339,147,192," 5.4"
"4028","Z17033",6929,401,85,316," 4.6"
"4029","Z17034",1192,132,14,118," 9.9"
"4030","Z17035",512,177,134,43," 8.4"
"4031","Z17036",9578,726,151,575," 6.0"
"4032","Z17037",614,279,195,84,"13.7"
"4033","Z17038",3377,246,45,201," 6.0"
"4034","Z17040",1108,145,69,76," 6.9"
"4035","Z17042",15521,961,68,893," 5.8"
"4036","Z17043",3260,326,0,326,"10.0"
"4037","Z17044",10201,1188,137,1051,"10.3"
"4038","Z17045",1464,198,74,124," 8.5"
"4039","Z17046",12740,1044,151,893," 7.0"
"4040","Z17047",1031,99,82,17," 1.6"
"4041","Z17048",1711,279,26,253,"14.8"
"4042","Z17049",1287,159,64,95," 7.4"
"4043","Z17050",14935,673,103,570," 3.8"
"4044","Z17051",2278,420,318,102," 4.5"
"4045","Z17052",847,230,178,52," 6.1"
"4046","Z17053",2211,104,18,86," 3.9"
"4047","Z17055",15867,665,11,654," 4.1"
"4048","Z17056",50,13,0,13,"26.0"
"4049","Z17057",9720,770,100,670," 6.9"
"4050","Z17058",907,193,120,73," 8.0"
"4051","Z17059",3238,301,104,197," 6.1"
"4052","Z17060",559,61,48,13," 2.3"
"4053","Z17061",3301,349,41,308," 9.3"
"4054","Z17062",1766,254,167,87," 4.9"
"4055","Z17063",1833,556,488,68," 3.7"
"4056","Z17064",606,328,312,16," 2.6"
"4057","Z17065",1709,93,0,93," 5.4"
"4058","Z17066",2706,348,148,200," 7.4"
"4059","Z17067",5571,297,19,278," 5.0"
"4060","Z17068",1730,96,33,63," 3.6"
"4061","Z17070",7286,571,12,559," 7.7"
"4062","Z17073",1965,31,6,25," 1.3"
"4063","Z17074",3310,426,181,245," 7.4"
"4064","Z17078",9158,420,59,361," 3.9"
"4065","Z17080",114,10,0,10," 8.8"
"4066","Z17081",203,48,0,48,"23.6"
"4067","Z17082",1661,230,113,117," 7.0"
"4068","Z17084",1825,133,75,58," 3.2"
"4069","Z17086",964,111,61,50," 5.2"
"4070","Z17088",364,21,21,0," 0.0"
"4071","Z17090",2350,112,14,98," 4.2"
"4072","Z17094",1156,78,48,30," 2.6"
"4073","Z17098",1190,229,5,224,"18.8"
"4074","Z17099",534,54,0,54,"10.1"
"4075","Z17101",1894,504,67,437,"23.1"
"4076","Z17102",5147,822,21,801,"15.6"
"4077","Z17103",5567,1234,0,1234,"22.2"
"4078","Z17104",9180,1347,20,1327,"14.5"
"4079","Z17109",11050,814,75,739," 6.7"
"4080","Z17110",11420,1330,19,1311,"11.5"
"4081","Z17111",13142,779,71,708," 5.4"
"4082","Z17112",14842,714,37,677," 4.6"
"4083","Z17113",4568,582,5,577,"12.6"
"4084","Z17201",11089,1138,0,1138,"10.3"
"4085","Z17202",12642,790,96,694," 5.5"
"4086","Z17212",336,56,32,24," 7.1"
"4087","Z17215",134,43,21,22,"16.4"
"4088","Z17220",157,28,23,5," 3.2"
"4089","Z17222",4893,589,343,246," 5.0"
"4090","Z17223",146,13,9,4," 2.7"
"4091","Z17224",917,119,61,58," 6.3"
"4092","Z17225",7442,226,28,198," 2.7"
"4093","Z17228",547,80,30,50," 9.1"
"4094","Z17229",616,89,64,25," 4.1"
"4095","Z17233",2535,338,151,187," 7.4"
"4096","Z17236",3596,497,49,448,"12.5"
"4097","Z17237",679,54,0,54," 8.0"
"4098","Z17238",777,131,64,67," 8.6"
"4099","Z17239",156,69,52,17,"10.9"
"4100","Z17240",1254,100,22,78," 6.2"
"4101","Z17241",4848,371,103,268," 5.5"
"4102","Z17243",1000,327,222,105,"10.5"
"4103","Z17244",995,106,58,48," 4.8"
"4104","Z17251",80,14,0,14,"17.5"
"4105","Z17252",1520,101,0,101," 6.6"
"4106","Z17255",588,147,52,95,"16.2"
"4107","Z17257",11846,1159,37,1122," 9.5"
"4108","Z17262",538,40,6,34," 6.3"
"4109","Z17264",1251,324,216,108," 8.6"
"4110","Z17266",215,10,10,0," 0.0"
"4111","Z17267",1311,242,141,101," 7.7"
"4112","Z17268",12478,984,33,951," 7.6"
"4113","Z17271",148,43,9,34,"23.0"
"4114","Z17272",190,8,0,8," 4.2"
"4115","Z17301",1534,58,0,58," 3.8"
"4116","Z17302",1232,204,132,72," 5.8"
"4117","Z17304",1146,59,40,19," 1.7"
"4118","Z17307",2526,285,130,155," 6.1"
"4119","Z17309",849,16,16,0," 0.0"
"4120","Z17313",4528,185,0,185," 4.1"
"4121","Z17315",10782,507,0,507," 4.7"
"4122","Z17316",3284,271,85,186," 5.7"
"4123","Z17317",343,28,0,28," 8.2"
"4124","Z17318",154,23,0,23,"14.9"
"4125","Z17319",4324,258,2,256," 5.9"
"4126","Z17320",3201,255,193,62," 1.9"
"4127","Z17321",917,58,10,48," 5.2"
"4128","Z17324",1916,317,242,75," 3.9"
"4129","Z17325",11214,777,179,598," 5.3"
"4130","Z17327",3263,336,65,271," 8.3"
"4131","Z17329",897,38,7,31," 3.5"
"4132","Z17331",20964,1411,71,1340," 6.4"
"4133","Z17339",2941,180,82,98," 3.3"
"4134","Z17340",4427,168,10,158," 3.6"
"4135","Z17344",1552,59,0,59," 3.8"
"4136","Z17345",3276,203,31,172," 5.3"
"4137","Z17347",2391,72,0,72," 3.0"
"4138","Z17349",2894,71,18,53," 1.8"
"4139","Z17350",5243,594,55,539,"10.3"
"4140","Z17352",507,46,0,46," 9.1"
"4141","Z17353",1559,179,39,140," 9.0"
"4142","Z17356",8749,362,51,311," 3.6"
"4143","Z17360",2515,245,4,241," 9.6"
"4144","Z17361",2367,152,0,152," 6.4"
"4145","Z17362",5395,309,28,281," 5.2"
"4146","Z17363",3823,217,14,203," 5.3"
"4147","Z17364",1578,132,0,132," 8.4"
"4148","Z17365",1063,105,64,41," 3.9"
"4149","Z17366",2444,223,0,223," 9.1"
"4150","Z17368",3147,176,51,125," 4.0"
"4151","Z17370",2170,295,0,295,"13.6"
"4152","Z17371",149,11,0,11," 7.4"
"4153","Z17372",1717,140,26,114," 6.6"
"4154","Z17401",7712,1259,0,1259,"16.3"
"4155","Z17402",14497,702,33,669," 4.6"
"4156","Z17403",16128,1614,72,1542," 9.6"
"4157","Z17404",15054,1244,65,1179," 7.8"
"4158","Z17406",9591,652,59,593," 6.2"
"4159","Z17407",861,46,0,46," 5.3"
"4160","Z17408",9258,334,0,334," 3.6"
"4161","Z17501",1802,32,0,32," 1.8"
"4162","Z17509",1413,107,18,89," 6.3"
"4163","Z17512",7431,523,20,503," 6.8"
"4164","Z17516",1867,78,0,78," 4.2"
"4165","Z17517",6069,156,59,97," 1.6"
"4166","Z17518",475,18,18,0," 0.0"
"4167","Z17519",2166,75,0,75," 3.5"
"4168","Z17520",1880,111,79,32," 1.7"
"4169","Z17522",12888,302,49,253," 2.0"
"4170","Z17527",2002,87,0,87," 4.3"
"4171","Z17529",1539,20,0,20," 1.3"
"4172","Z17532",1143,41,0,41," 3.6"
"4173","Z17535",581,12,0,12," 2.1"
"4174","Z17536",877,17,0,17," 1.9"
"4175","Z17538",2571,124,0,124," 4.8"
"4176","Z17540",3396,153,0,153," 4.5"
"4177","Z17543",17090,873,103,770," 4.5"
"4178","Z17545",8475,305,101,204," 2.4"
"4179","Z17547",2871,311,3,308,"10.7"
"4180","Z17551",3877,252,0,252," 6.5"
"4181","Z17552",8455,450,0,450," 5.3"
"4182","Z17554",3421,235,47,188," 5.5"
"4183","Z17555",2260,50,10,40," 1.8"
"4184","Z17557",5263,181,0,181," 3.4"
"4185","Z17560",2217,73,0,73," 3.3"
"4186","Z17562",1387,20,0,20," 1.4"
"4187","Z17563",1349,88,9,79," 5.9"
"4188","Z17565",1073,31,0,31," 2.9"
"4189","Z17566",4418,276,68,208," 4.7"
"4190","Z17569",2022,39,0,39," 1.9"
"4191","Z17572",1330,53,53,0," 0.0"
"4192","Z17578",2728,173,34,139," 5.1"
"4193","Z17579",2131,50,5,45," 2.1"
"4194","Z17581",353,29,0,29," 8.2"
"4195","Z17582",806,39,0,39," 4.8"
"4196","Z17584",3893,165,37,128," 3.3"
"4197","Z17601",20835,747,37,710," 3.4"
"4198","Z17602",20236,1262,108,1154," 5.7"
"4199","Z17603",26697,2012,116,1896," 7.1"
"4200","Z17701",20069,2333,451,1882," 9.4"
"4201","Z17702",4857,307,140,167," 3.4"
"4202","Z17721",754,35,8,27," 3.6"
"4203","Z17724",2471,443,249,194," 7.9"
"4204","Z17728",2167,173,42,131," 6.0"
"4205","Z17737",2704,248,136,112," 4.1"
"4206","Z17740",5436,624,285,339," 6.2"
"4207","Z17744",1410,147,60,87," 6.2"
"4208","Z17745",8574,1452,768,684," 8.0"
"4209","Z17747",1414,361,315,46," 3.3"
"4210","Z17748",132,8,0,8," 6.1"
"4211","Z17751",3047,311,173,138," 4.5"
"4212","Z17752",1980,242,31,211,"10.7"
"4213","Z17754",5343,409,68,341," 6.4"
"4214","Z17756",4883,356,61,295," 6.0"
"4215","Z17758",816,422,359,63," 7.7"
"4216","Z17760",610,329,282,47," 7.7"
"4217","Z17762",244,15,2,13," 5.3"
"4218","Z17763",137,14,7,7," 5.1"
"4219","Z17764",1839,903,681,222,"12.1"
"4220","Z17765",618,197,154,43," 7.0"
"4221","Z17771",1734,437,351,86," 5.0"
"4222","Z17772",975,98,5,93," 9.5"
"4223","Z17774",670,165,78,87,"13.0"
"4224","Z17777",2995,130,16,114," 3.8"
"4225","Z17801",7547,556,29,527," 7.0"
"4226","Z17810",951,115,69,46," 4.8"
"4227","Z17812",608,126,53,73,"12.0"
"4228","Z17813",859,120,73,47," 5.5"
"4229","Z17815",12355,932,158,774," 6.3"
"4230","Z17820",2783,482,217,265," 9.5"
"4231","Z17821",8138,643,74,569," 7.0"
"4232","Z17824",1913,279,57,222,"11.6"
"4233","Z17827",300,23,3,20," 6.7"
"4234","Z17829",86,9,0,9,"10.5"
"4235","Z17830",1017,215,152,63," 6.2"
"4236","Z17835",104,9,0,9," 8.7"
"4237","Z17837",6961,550,122,428," 6.1"
"4238","Z17841",2081,299,182,117," 5.6"
"4239","Z17842",3598,284,125,159," 4.4"
"4240","Z17844",4576,547,343,204," 4.5"
"4241","Z17845",1301,508,445,63," 4.8"
"4242","Z17846",1622,151,55,96," 5.9"
"4243","Z17847",5486,368,8,360," 6.6"
"4244","Z17851",4576,965,40,925,"20.2"
"4245","Z17853",1283,109,37,72," 5.6"
"4246","Z17855",419,21,10,11," 2.6"
"4247","Z17856",1579,107,107,0," 0.0"
"4248","Z17857",3425,153,16,137," 4.0"
"4249","Z17859",1409,193,115,78," 5.5"
"4250","Z17860",1064,19,0,19," 1.8"
"4251","Z17864",801,67,9,58," 7.2"
"4252","Z17866",3897,657,34,623,"16.0"
"4253","Z17870",5902,631,142,489," 8.3"
"4254","Z17872",5876,1445,104,1341,"22.8"
"4255","Z17876",862,39,0,39," 4.5"
"4256","Z17878",570,57,21,36," 6.3"
"4257","Z17881",792,164,13,151,"19.1"
"4258","Z17886",387,56,36,20," 5.2"
"4259","Z17889",1114,110,49,61," 5.5"
"4260","Z17901",11709,1825,39,1786,"15.3"
"4261","Z17921",3367,473,71,402,"11.9"
"4262","Z17922",2136,200,178,22," 1.0"
"4263","Z17931",2631,344,9,335,"12.7"
"4264","Z17934",279,87,2,85,"30.5"
"4265","Z17935",852,233,16,217,"25.5"
"4266","Z17938",1036,78,60,18," 1.7"
"4267","Z17941",390,60,14,46,"11.8"
"4268","Z17954",2422,513,49,464,"19.2"
"4269","Z17959",699,95,0,95,"13.6"
"4270","Z17960",1807,244,91,153," 8.5"
"4271","Z17961",3208,175,28,147," 4.6"
"4272","Z17963",4077,443,167,276," 6.8"
"4273","Z17964",312,23,8,15," 4.8"
"4274","Z17965",965,99,4,95," 9.8"
"4275","Z17967",1189,151,67,84," 7.1"
"4276","Z17970",1575,215,9,206,"13.1"
"4277","Z17972",4688,313,23,290," 6.2"
"4278","Z17976",4084,1338,183,1155,"28.3"
"4279","Z17978",129,43,0,43,"33.3"
"4280","Z17980",1495,250,19,231,"15.5"
"4281","Z17981",1102,105,0,105," 9.5"
"4282","Z17982",210,52,11,41,"19.5"
"4283","Z17983",710,84,0,84,"11.8"
"4284","Z18011",2178,104,6,98," 4.5"
"4285","Z18013",7019,493,98,395," 5.6"
"4286","Z18014",4534,131,0,131," 2.9"
"4287","Z18015",11957,991,108,883," 7.4"
"4288","Z18017",15833,914,48,866," 5.5"
"4289","Z18018",14516,808,96,712," 4.9"
"4290","Z18020",7642,172,60,112," 1.5"
"4291","Z18030",401,66,14,52,"13.0"
"4292","Z18031",3573,218,8,210," 5.9"
"4293","Z18032",4093,253,0,253," 6.2"
"4294","Z18034",2899,236,38,198," 6.8"
"4295","Z18036",4857,184,45,139," 2.9"
"4296","Z18037",3126,143,0,143," 4.6"
"4297","Z18038",1153,45,0,45," 3.9"
"4298","Z18040",6324,252,91,161," 2.5"
"4299","Z18041",2225,171,0,171," 7.7"
"4300","Z18042",17737,2316,177,2139,"12.1"
"4301","Z18045",10445,370,103,267," 2.6"
"4302","Z18049",7816,454,47,407," 5.2"
"4303","Z18051",1354,51,10,41," 3.0"
"4304","Z18052",11264,244,0,244," 2.2"
"4305","Z18053",1070,116,30,86," 8.0"
"4306","Z18054",1855,256,80,176," 9.5"
"4307","Z18055",5338,370,131,239," 4.5"
"4308","Z18056",362,58,13,45,"12.4"
"4309","Z18058",4159,475,258,217," 5.2"
"4310","Z18059",463,54,0,54,"11.7"
"4311","Z18062",10182,411,165,246," 2.4"
"4312","Z18064",9549,458,32,426," 4.5"
"4313","Z18066",2316,141,9,132," 5.7"
"4314","Z18067",7973,421,0,421," 5.3"
"4315","Z18069",3091,164,0,164," 5.3"
"4316","Z18070",377,14,0,14," 3.7"
"4317","Z18071",4457,347,76,271," 6.1"
"4318","Z18072",2682,275,0,275,"10.3"
"4319","Z18073",3491,219,0,219," 6.3"
"4320","Z18074",2335,111,0,111," 4.8"
"4321","Z18076",1274,42,0,42," 3.3"
"4322","Z18077",1035,81,16,65," 6.3"
"4323","Z18078",2910,216,13,203," 7.0"
"4324","Z18080",4840,177,0,177," 3.7"
"4325","Z18083",196,11,0,11," 5.6"
"4326","Z18085",368,22,13,9," 2.4"
"4327","Z18088",3410,158,23,135," 4.0"
"4328","Z18091",2443,166,0,166," 6.8"
"4329","Z18092",1259,41,16,25," 2.0"
"4330","Z18101",1829,270,0,270,"14.8"
"4331","Z18102",18131,2673,91,2582,"14.2"
"4332","Z18103",18478,671,86,585," 3.2"
"4333","Z18104",17579,1188,152,1036," 5.9"
"4334","Z18106",2890,50,0,50," 1.7"
"4335","Z18109",7040,759,129,630," 8.9"
"4336","Z18201",11736,1884,130,1754,"14.9"
"4337","Z18202",5540,1046,409,637,"11.5"
"4338","Z18210",6517,3625,3129,496," 7.6"
"4339","Z18211",669,93,45,48," 7.2"
"4340","Z18216",526,93,14,79,"15.0"
"4341","Z18219",671,29,0,29," 4.3"
"4342","Z18222",3711,216,67,149," 4.0"
"4343","Z18224",2954,485,4,481,"16.3"
"4344","Z18229",4727,1283,871,412," 8.7"
"4345","Z18232",2147,512,92,420,"19.6"
"4346","Z18235",8724,1095,421,674," 7.7"
"4347","Z18237",1610,232,41,191,"11.9"
"4348","Z18240",1849,278,218,60," 3.2"
"4349","Z18241",356,78,46,32," 9.0"
"4350","Z18244",247,60,25,35,"14.2"
"4351","Z18249",1650,131,26,105," 6.4"
"4352","Z18250",1414,246,112,134," 9.5"
"4353","Z18252",5211,675,149,526,"10.1"
"4354","Z18254",441,45,0,45,"10.2"
"4355","Z18255",2096,327,130,197," 9.4"
"4356","Z18256",181,14,6,8," 4.4"
"4357","Z18301",11643,2242,1064,1178,"10.1"
"4358","Z18302",8938,2880,2066,814," 9.1"
"4359","Z18321",697,127,127,0," 0.0"
"4360","Z18322",1004,168,59,109,"10.9"
"4361","Z18323",260,227,209,18," 6.9"
"4362","Z18324",6030,2782,2269,513," 8.5"
"4363","Z18325",1509,528,421,107," 7.1"
"4364","Z18327",302,34,13,21," 7.0"
"4365","Z18328",5115,2539,2091,448," 8.8"
"4366","Z18330",3164,447,382,65," 2.1"
"4367","Z18331",378,47,25,22," 5.8"
"4368","Z18334",2208,570,476,94," 4.3"
"4369","Z18335",328,37,37,0," 0.0"
"4370","Z18336",1731,155,46,109," 6.3"
"4371","Z18337",6487,1481,893,588," 9.1"
"4372","Z18343",2001,351,254,97," 4.8"
"4373","Z18344",1619,393,163,230,"14.2"
"4374","Z18346",1208,436,297,139,"11.5"
"4375","Z18347",4715,3526,3339,187," 4.0"
"4376","Z18350",2849,2137,2010,127," 4.5"
"4377","Z18351",216,22,0,22,"10.2"
"4378","Z18352",436,15,0,15," 3.4"
"4379","Z18353",4767,760,313,447," 9.4"
"4380","Z18354",387,93,28,65,"16.8"
"4381","Z18360",11495,1361,297,1064," 9.3"
"4382","Z18371",514,235,217,18," 3.5"
"4383","Z18372",1874,921,765,156," 8.3"
"4384","Z18403",3113,214,12,202," 6.5"
"4385","Z18405",1386,356,300,56," 4.0"
"4386","Z18407",6740,918,251,667," 9.9"
"4387","Z18411",9387,572,114,458," 4.9"
"4388","Z18414",2293,262,97,165," 7.2"
"4389","Z18415",915,398,337,61," 6.7"
"4390","Z18417",964,516,459,57," 5.9"
"4391","Z18419",2114,368,219,149," 7.0"
"4392","Z18421",2346,314,70,244,"10.4"
"4393","Z18424",4354,2358,2042,316," 7.3"
"4394","Z18425",784,244,169,75," 9.6"
"4395","Z18426",4478,2591,2397,194," 4.3"
"4396","Z18427",72,12,0,12,"16.7"
"4397","Z18428",9912,5089,4715,374," 3.8"
"4398","Z18431",5978,1052,498,554," 9.3"
"4399","Z18433",3159,500,239,261," 8.3"
"4400","Z18434",1802,197,0,197,"10.9"
"4401","Z18436",10108,5051,4605,446," 4.4"
"4402","Z18438",1361,838,803,35," 2.6"
"4403","Z18443",383,191,179,12," 3.1"
"4404","Z18444",5715,538,136,402," 7.0"
"4405","Z18445",1375,472,365,107," 7.8"
"4406","Z18446",1802,349,242,107," 5.9"
"4407","Z18447",4816,450,12,438," 9.1"
"4408","Z18452",2439,236,0,236," 9.7"
"4409","Z18453",656,184,147,37," 5.6"
"4410","Z18457",79,11,11,0," 0.0"
"4411","Z18458",2050,768,668,100," 4.9"
"4412","Z18460",124,8,8,0," 0.0"
"4413","Z18463",92,4,4,0," 0.0"
"4414","Z18464",1188,650,577,73," 6.1"
"4415","Z18465",1133,513,454,59," 5.2"
"4416","Z18466",7921,2760,1997,763," 9.6"
"4417","Z18469",235,94,75,19," 8.1"
"4418","Z18471",304,35,0,35,"11.5"
"4419","Z18472",1998,433,293,140," 7.0"
"4420","Z18503",623,67,22,45," 7.2"
"4421","Z18504",9883,1552,63,1489,"15.1"
"4422","Z18505",9479,1163,203,960,"10.1"
"4423","Z18507",2130,145,43,102," 4.8"
"4424","Z18508",5590,609,29,580,"10.4"
"4425","Z18509",5250,657,23,634,"12.1"
"4426","Z18510",5362,829,16,813,"15.2"
"4427","Z18512",5700,450,0,450," 7.9"
"4428","Z18517",2471,321,0,321,"13.0"
"4429","Z18518",4047,301,0,301," 7.4"
"4430","Z18602",163,48,40,8," 4.9"
"4431","Z18603",8822,839,43,796," 9.0"
"4432","Z18610",2429,932,687,245,"10.1"
"4433","Z18612",6922,767,111,656," 9.5"
"4434","Z18614",2141,993,833,160," 7.5"
"4435","Z18615",841,154,89,65," 7.7"
"4436","Z18616",683,431,394,37," 5.4"
"4437","Z18617",1036,327,23,304,"29.3"
"4438","Z18618",2293,693,422,271,"11.8"
"4439","Z18621",2452,421,195,226," 9.2"
"4440","Z18623",1364,326,201,125," 9.2"
"4441","Z18624",1487,1226,1148,78," 5.2"
"4442","Z18625",512,273,251,22," 4.3"
"4443","Z18626",504,311,295,16," 3.2"
"4444","Z18630",1582,387,241,146," 9.2"
"4445","Z18631",563,12,0,12," 2.1"
"4446","Z18634",6633,913,3,910,"13.7"
"4447","Z18635",1790,89,31,58," 3.2"
"4448","Z18636",636,95,31,64,"10.1"
"4449","Z18640",8208,1024,41,983,"12.0"
"4450","Z18641",3107,345,0,345,"11.1"
"4451","Z18642",1974,115,0,115," 5.8"
"4452","Z18643",6110,682,62,620,"10.1"
"4453","Z18644",3151,188,5,183," 5.8"
"4454","Z18651",4514,781,0,781,"17.3"
"4455","Z18655",3060,549,201,348,"11.4"
"4456","Z18656",1087,242,100,142,"13.1"
"4457","Z18657",5689,841,458,383," 6.7"
"4458","Z18660",1558,220,87,133," 8.5"
"4459","Z18661",3713,1331,1055,276," 7.4"
"4460","Z18701",1184,244,13,231,"19.5"
"4461","Z18702",18926,3143,218,2925,"15.5"
"4462","Z18704",15423,1759,18,1741,"11.3"
"4463","Z18705",7330,846,29,817,"11.1"
"4464","Z18706",7939,890,128,762," 9.6"
"4465","Z18707",6414,292,141,151," 2.4"
"4466","Z18708",3669,103,0,103," 2.8"
"4467","Z18709",1630,263,60,203,"12.5"
"4468","Z18801",4127,719,497,222," 5.4"
"4469","Z18810",2530,191,78,113," 4.5"
"4470","Z18812",1087,404,361,43," 4.0"
"4471","Z18816",78,17,17,0," 0.0"
"4472","Z18817",88,11,0,11,"12.5"
"4473","Z18821",558,46,2,44," 7.9"
"4474","Z18822",1686,129,58,71," 4.2"
"4475","Z18823",104,4,0,4," 3.8"
"4476","Z18824",727,172,92,80,"11.0"
"4477","Z18825",91,38,33,5," 5.5"
"4478","Z18826",949,216,152,64," 6.7"
"4479","Z18828",203,60,41,19," 9.4"
"4480","Z18830",428,117,94,23," 5.4"
"4481","Z18831",564,57,48,9," 1.6"
"4482","Z18832",956,271,186,85," 8.9"
"4483","Z18833",1356,557,464,93," 6.9"
"4484","Z18834",2010,560,422,138," 6.9"
"4485","Z18837",1443,274,169,105," 7.3"
"4486","Z18840",5348,620,175,445," 8.3"
"4487","Z18842",96,9,4,5," 5.2"
"4488","Z18843",107,20,7,13,"12.1"
"4489","Z18844",871,146,95,51," 5.9"
"4490","Z18845",170,52,37,15," 8.8"
"4491","Z18846",546,224,184,40," 7.3"
"4492","Z18847",3229,937,605,332,"10.3"
"4493","Z18848",4550,802,391,411," 9.0"
"4494","Z18850",1006,196,118,78," 7.8"
"4495","Z18851",507,212,184,28," 5.5"
"4496","Z18853",2107,502,360,142," 6.7"
"4497","Z18854",565,79,42,37," 6.5"
"4498","Z18901",10909,675,63,612," 5.6"
"4499","Z18902",7473,271,79,192," 2.6"
"4500","Z18914",7587,259,26,233," 3.1"
"4501","Z18917",934,70,0,70," 7.5"
"4502","Z18920",177,15,7,8," 4.5"
"4503","Z18923",376,56,56,0," 0.0"
"4504","Z18925",2339,107,62,45," 1.9"
"4505","Z18929",2956,82,0,82," 2.8"
"4506","Z18930",1164,75,28,47," 4.0"
"4507","Z18932",214,25,0,25,"11.7"
"4508","Z18938",6840,835,330,505," 7.4"
"4509","Z18940",11250,562,139,423," 3.8"
"4510","Z18942",1464,195,59,136," 9.3"
"4511","Z18944",9470,321,0,321," 3.4"
"4512","Z18947",2384,84,17,67," 2.8"
"4513","Z18951",13854,333,33,300," 2.2"
"4514","Z18954",3331,156,0,156," 4.7"
"4515","Z18955",665,71,0,71,"10.7"
"4516","Z18960",5152,218,13,205," 4.0"
"4517","Z18962",217,6,0,6," 2.8"
"4518","Z18964",5259,304,0,304," 5.8"
"4519","Z18966",14380,286,75,211," 1.5"
"4520","Z18969",5942,192,0,192," 3.2"
"4521","Z18970",319,17,0,17," 5.3"
"4522","Z18972",1778,274,87,187,"10.5"
"4523","Z18974",16520,477,84,393," 2.4"
"4524","Z18976",7241,186,0,186," 2.6"
"4525","Z18977",1587,63,0,63," 4.0"
"4526","Z19001",6606,248,30,218," 3.3"
"4527","Z19002",12720,382,0,382," 3.0"
"4528","Z19003",5677,456,80,376," 6.6"
"4529","Z19004",4089,257,30,227," 5.6"
"4530","Z19006",8083,284,13,271," 3.4"
"4531","Z19007",8725,825,0,825," 9.5"
"4532","Z19008",7398,201,29,172," 2.3"
"4533","Z19009",294,23,0,23," 7.8"
"4534","Z19010",8116,710,106,604," 7.4"
"4535","Z19012",2360,93,0,93," 3.9"
"4536","Z19013",15565,3247,12,3235,"20.8"
"4537","Z19014",7973,407,11,396," 5.0"
"4538","Z19015",6932,617,0,617," 8.9"
"4539","Z19018",9902,709,0,709," 7.2"
"4540","Z19020",23627,1851,33,1818," 7.7"
"4541","Z19021",4050,383,0,383," 9.5"
"4542","Z19022",1644,274,0,274,"16.7"
"4543","Z19023",8607,1360,51,1309,"15.2"
"4544","Z19025",2096,129,0,129," 6.2"
"4545","Z19026",12860,922,16,906," 7.0"
"4546","Z19027",8737,492,18,474," 5.4"
"4547","Z19029",1678,158,22,136," 8.1"
"4548","Z19030",4781,290,0,290," 6.1"
"4549","Z19031",2017,120,0,120," 5.9"
"4550","Z19032",2672,318,27,291,"10.9"
"4551","Z19033",3133,94,0,94," 3.0"
"4552","Z19034",2216,256,0,256,"11.6"
"4553","Z19035",1626,207,68,139," 8.5"
"4554","Z19036",5598,333,0,333," 5.9"
"4555","Z19038",11539,481,57,424," 3.7"
"4556","Z19040",8374,559,0,559," 6.7"
"4557","Z19041",2581,210,7,203," 7.9"
"4558","Z19043",1157,113,0,113," 9.8"
"4559","Z19044",7000,484,16,468," 6.7"
"4560","Z19046",7841,744,57,687," 8.8"
"4561","Z19047",13598,670,115,555," 4.1"
"4562","Z19050",11853,1062,7,1055," 8.9"
"4563","Z19053",10134,640,15,625," 6.2"
"4564","Z19054",6581,364,0,364," 5.5"
"4565","Z19055",5098,376,0,376," 7.4"
"4566","Z19056",5589,186,0,186," 3.3"
"4567","Z19057",6633,391,0,391," 5.9"
"4568","Z19061",8173,590,0,590," 7.2"
"4569","Z19063",14936,961,58,903," 6.0"
"4570","Z19064",8790,273,0,273," 3.1"
"4571","Z19066",1901,89,48,41," 2.2"
"4572","Z19067",20785,1274,162,1112," 5.4"
"4573","Z19070",2921,214,0,214," 7.3"
"4574","Z19072",4239,268,66,202," 4.8"
"4575","Z19073",8188,391,45,346," 4.2"
"4576","Z19074",2280,208,29,179," 7.9"
"4577","Z19075",2741,48,0,48," 1.8"
"4578","Z19076",2756,252,0,252," 9.1"
"4579","Z19078",4677,237,0,237," 5.1"
"4580","Z19079",3643,318,0,318," 8.7"
"4581","Z19082",16121,2498,68,2430,"15.1"
"4582","Z19083",13733,505,53,452," 3.3"
"4583","Z19085",2032,207,136,71," 3.5"
"4584","Z19086",4551,243,57,186," 4.1"
"4585","Z19087",12754,542,40,502," 3.9"
"4586","Z19090",7608,438,0,438," 5.8"
"4587","Z19094",1844,95,0,95," 5.2"
"4588","Z19095",3510,426,68,358,"10.2"
"4589","Z19096",5634,140,8,132," 2.3"
"4590","Z19102",3323,516,31,485,"14.6"
"4591","Z19103",16571,1961,469,1492," 9.0"
"4592","Z19106",6996,813,209,604," 8.6"
"4593","Z19107",7667,1036,180,856,"11.2"
"4594","Z19111",25997,1976,74,1902," 7.3"
"4595","Z19114",13704,870,0,870," 6.3"
"4596","Z19115",14253,658,47,611," 4.3"
"4597","Z19116",13202,532,9,523," 4.0"
"4598","Z19118",4568,298,13,285," 6.2"
"4599","Z19119",13294,1238,40,1198," 9.0"
"4600","Z19120",25186,2199,23,2176," 8.6"
"4601","Z19121",16808,4550,60,4490,"26.7"
"4602","Z19122",7096,1190,0,1190,"16.8"
"4603","Z19123",7349,897,40,857,"11.7"
"4604","Z19124",25809,3631,77,3554,"13.8"
"4605","Z19125",10736,1549,190,1359,"12.7"
"4606","Z19126",6516,752,22,730,"11.2"
"4607","Z19127",2692,506,0,506,"18.8"
"4608","Z19128",16687,1423,0,1423," 8.5"
"4609","Z19129",5107,556,5,551,"10.8"
"4610","Z19130",13879,1497,122,1375," 9.9"
"4611","Z19131",21085,3344,33,3311,"15.7"
"4612","Z19132",18243,4796,0,4796,"26.3"
"4613","Z19133",10780,2104,0,2104,"19.5"
"4614","Z19134",23448,3472,97,3375,"14.4"
"4615","Z19135",13294,1816,7,1809,"13.6"
"4616","Z19136",13329,1092,0,1092," 8.2"
"4617","Z19137",3228,284,12,272," 8.4"
"4618","Z19138",13410,2066,5,2061,"15.4"
"4619","Z19139",20556,4542,35,4507,"21.9"
"4620","Z19140",22201,3917,28,3889,"17.5"
"4621","Z19141",14201,1722,15,1707,"12.0"
"4622","Z19142",11411,1873,22,1851,"16.2"
"4623","Z19143",30233,4979,32,4947,"16.4"
"4624","Z19144",21670,4737,103,4634,"21.4"
"4625","Z19145",20621,2460,150,2310,"11.2"
"4626","Z19146",19244,3116,152,2964,"15.4"
"4627","Z19147",18592,2296,115,2181,"11.7"
"4628","Z19148",21748,2253,122,2131," 9.8"
"4629","Z19149",20267,1726,176,1550," 7.6"
"4630","Z19150",10636,816,29,787," 7.4"
"4631","Z19151",13266,1297,65,1232," 9.3"
"4632","Z19152",13499,727,17,710," 5.3"
"4633","Z19153",5725,484,13,471," 8.2"
"4634","Z19154",13127,1046,0,1046," 8.0"
"4635","Z19301",2785,63,0,63," 2.3"
"4636","Z19310",1009,30,19,11," 1.1"
"4637","Z19311",3071,171,0,171," 5.6"
"4638","Z19312",4462,115,8,107," 2.4"
"4639","Z19316",76,33,0,33,"43.4"
"4640","Z19317",3776,73,0,73," 1.9"
"4641","Z19320",20881,1635,84,1551," 7.4"
"4642","Z19330",1975,62,0,62," 3.1"
"4643","Z19333",3262,415,11,404,"12.4"
"4644","Z19335",18247,742,52,690," 3.8"
"4645","Z19341",7007,292,60,232," 3.3"
"4646","Z19342",7917,404,12,392," 5.0"
"4647","Z19343",3029,68,0,68," 2.2"
"4648","Z19344",4561,306,17,289," 6.3"
"4649","Z19348",8781,517,15,502," 5.7"
"4650","Z19350",4128,154,21,133," 3.2"
"4651","Z19352",2860,118,13,105," 3.7"
"4652","Z19355",9349,386,107,279," 3.0"
"4653","Z19358",231,40,0,40,"17.3"
"4654","Z19362",2228,169,0,169," 7.6"
"4655","Z19363",5980,251,3,248," 4.1"
"4656","Z19365",2733,123,0,123," 4.5"
"4657","Z19374",283,14,0,14," 4.9"
"4658","Z19380",20307,736,0,736," 3.6"
"4659","Z19382",20688,704,122,582," 2.8"
"4660","Z19390",5003,138,0,138," 2.8"
"4661","Z19401",18136,2233,37,2196,"12.1"
"4662","Z19403",18701,878,94,784," 4.2"
"4663","Z19405",2752,287,0,287,"10.4"
"4664","Z19406",10744,820,21,799," 7.4"
"4665","Z19422",7578,448,50,398," 5.3"
"4666","Z19425",5081,135,4,131," 2.6"
"4667","Z19426",12476,397,10,387," 3.1"
"4668","Z19428",8064,621,0,621," 7.7"
"4669","Z19438",9431,302,32,270," 2.9"
"4670","Z19440",7398,263,97,166," 2.2"
"4671","Z19444",4540,203,8,195," 4.3"
"4672","Z19446",22849,1140,54,1086," 4.8"
"4673","Z19453",670,55,0,55," 8.2"
"4674","Z19454",11408,298,11,287," 2.5"
"4675","Z19460",17170,760,49,711," 4.1"
"4676","Z19462",5931,111,5,106," 1.8"
"4677","Z19464",19217,1394,0,1394," 7.3"
"4678","Z19465",6853,364,0,364," 5.3"
"4679","Z19468",10374,342,6,336," 3.2"
"4680","Z19473",6250,236,9,227," 3.6"
"4681","Z19475",4285,122,0,122," 2.8"
"4682","Z19501",443,12,0,12," 2.7"
"4683","Z19503",542,10,0,10," 1.8"
"4684","Z19504",1971,59,44,15," 0.8"
"4685","Z19505",1269,44,3,41," 3.2"
"4686","Z19506",2903,196,16,180," 6.2"
"4687","Z19507",1284,57,0,57," 4.4"
"4688","Z19508",6440,212,9,203," 3.2"
"4689","Z19510",2847,65,0,65," 2.3"
"4690","Z19512",7188,207,10,197," 2.7"
"4691","Z19518",5465,98,0,98," 1.8"
"4692","Z19520",2478,147,33,114," 4.6"
"4693","Z19522",5779,158,23,135," 2.3"
"4694","Z19525",5533,249,8,241," 4.4"
"4695","Z19526",4803,224,55,169," 3.5"
"4696","Z19529",1382,66,35,31," 2.2"
"4697","Z19530",5322,540,15,525," 9.9"
"4698","Z19533",2472,127,43,84," 3.4"
"4699","Z19534",886,70,47,23," 2.6"
"4700","Z19539",1735,77,0,77," 4.4"
"4701","Z19540",4607,227,54,173," 3.8"
"4702","Z19541",1617,41,0,41," 2.5"
"4703","Z19543",2172,99,11,88," 4.1"
"4704","Z19545",250,20,0,20," 8.0"
"4705","Z19547",1749,183,57,126," 7.2"
"4706","Z19549",131,29,0,29,"22.1"
"4707","Z19551",2020,93,0,93," 4.6"
"4708","Z19555",1455,41,5,36," 2.5"
"4709","Z19559",145,16,0,16,"11.0"
"4710","Z19560",3365,206,0,206," 6.1"
"4711","Z19562",1154,20,0,20," 1.7"
"4712","Z19564",89,35,0,35,"39.3"
"4713","Z19565",3634,289,0,289," 8.0"
"4714","Z19567",2113,163,0,163," 7.7"
"4715","Z19601",13723,1765,40,1725,"12.6"
"4716","Z19602",8227,1578,0,1578,"19.2"
"4717","Z19604",9440,1282,0,1282,"13.6"
"4718","Z19605",8014,472,23,449," 5.6"
"4719","Z19606",13804,862,86,776," 5.6"
"4720","Z19607",9968,426,0,426," 4.3"
"4721","Z19608",8308,334,0,334," 4.0"
"4722","Z19609",4152,300,0,300," 7.2"
"4723","Z19610",6728,408,0,408," 6.1"
"4724","Z19611",4231,305,0,305," 7.2"
"4725","Z19701",14943,828,188,640," 4.3"
"4726","Z19702",20652,1354,40,1314," 6.4"
"4727","Z19703",6603,556,0,556," 8.4"
"4728","Z19706",802,79,6,73," 9.1"
"4729","Z19707",5876,150,24,126," 2.1"
"4730","Z19709",12517,502,0,502," 4.0"
"4731","Z19711",20402,1419,82,1337," 6.6"
"4732","Z19713",12752,716,25,691," 5.4"
"4733","Z19720",22852,1563,111,1452," 6.4"
"4734","Z19730",395,27,6,21," 5.3"
"4735","Z19733",101,10,0,10," 9.9"
"4736","Z19734",3969,220,59,161," 4.1"
"4737","Z19801",8014,1796,155,1641,"20.5"
"4738","Z19802",11923,1641,130,1511,"12.7"
"4739","Z19803",8733,291,44,247," 2.8"
"4740","Z19804",7621,630,39,591," 7.8"
"4741","Z19805",17804,2339,25,2314,"13.0"
"4742","Z19806",5876,837,146,691,"11.8"
"4743","Z19807",3437,379,101,278," 8.1"
"4744","Z19808",16079,807,167,640," 4.0"
"4745","Z19809",6583,599,0,599," 9.1"
"4746","Z19810",10375,346,6,340," 3.3"
"4747","Z19901",14512,1158,154,1004," 6.9"
"4748","Z19904",13397,1698,262,1436,"10.7"
"4749","Z19930",8500,7330,6758,572," 6.7"
"4750","Z19931",133,21,8,13," 9.8"
"4751","Z19933",3598,319,62,257," 7.1"
"4752","Z19934",5472,356,40,316," 5.8"
"4753","Z19936",113,10,0,10," 8.8"
"4754","Z19938",3260,161,0,161," 4.9"
"4755","Z19939",3794,1372,1094,278," 7.3"
"4756","Z19940",2114,275,115,160," 7.6"
"4757","Z19941",1076,106,3,103," 9.6"
"4758","Z19943",4983,468,0,468," 9.4"
"4759","Z19944",1766,1420,1307,113," 6.4"
"4760","Z19945",4222,1517,1328,189," 4.5"
"4761","Z19946",1910,333,152,181," 9.5"
"4762","Z19947",6430,626,85,541," 8.4"
"4763","Z19950",2788,269,15,254," 9.1"
"4764","Z19951",845,133,38,95,"11.2"
"4765","Z19952",4383,427,119,308," 7.0"
"4766","Z19953",1658,208,60,148," 8.9"
"4767","Z19954",636,60,1,59," 9.3"
"4768","Z19956",6518,724,150,574," 8.8"
"4769","Z19958",16842,6757,5951,806," 4.8"
"4770","Z19960",2806,342,91,251," 8.9"
"4771","Z19962",4104,409,13,396," 9.6"
"4772","Z19963",8878,1415,591,824," 9.3"
"4773","Z19964",527,85,35,50," 9.5"
"4774","Z19966",16393,5666,4260,1406," 8.6"
"4775","Z19967",476,175,139,36," 7.6"
"4776","Z19968",4739,889,612,277," 5.8"
"4777","Z19970",7291,3959,3597,362," 5.0"
"4778","Z19971",15547,9483,8712,771," 5.0"
"4779","Z19973",10058,1125,151,974," 9.7"
"4780","Z19975",6985,3216,2648,568," 8.1"
"4781","Z19977",8943,761,137,624," 7.0"
"4782","Z19979",237,32,0,32,"13.5"
"4783","Z20001",19701,1784,178,1606," 8.2"
"4784","Z20002",27566,3223,159,3064,"11.1"
"4785","Z20003",13143,1231,334,897," 6.8"
"4786","Z20004",1545,410,128,282,"18.3"
"4787","Z20005",9024,673,113,560," 6.2"
"4788","Z20006",850,102,49,53," 6.2"
"4789","Z20007",13325,1340,298,1042," 7.8"
"4790","Z20008",16994,1499,340,1159," 6.8"
"4791","Z20009",28559,1877,103,1774," 6.2"
"4792","Z20010",13828,1002,71,931," 6.7"
"4793","Z20011",26245,1874,120,1754," 6.7"
"4794","Z20012",6257,492,42,450," 7.2"
"4795","Z20015",6788,343,107,236," 3.5"
"4796","Z20016",15045,1034,146,888," 5.9"
"4797","Z20017",8084,566,112,454," 5.6"
"4798","Z20018",8293,627,23,604," 7.3"
"4799","Z20019",26106,3486,62,3424,"13.1"
"4800","Z20020",24464,3380,46,3334,"13.6"
"4801","Z20024",7736,693,159,534," 6.9"
"4802","Z20032",16593,2358,64,2294,"13.8"
"4803","Z20036",4147,319,131,188," 4.5"
"4804","Z20037",8408,1320,596,724," 8.6"
"4805","Z20105",4757,84,4,80," 1.7"
"4806","Z20106",2152,175,89,86," 4.0"
"4807","Z20109",13721,1072,36,1036," 7.6"
"4808","Z20110",15060,957,0,957," 6.4"
"4809","Z20111",10217,359,25,334," 3.3"
"4810","Z20112",8484,365,0,365," 4.3"
"4811","Z20115",2727,330,171,159," 5.8"
"4812","Z20117",1483,343,174,169,"11.4"
"4813","Z20119",1594,102,16,86," 5.4"
"4814","Z20120",14058,206,24,182," 1.3"
"4815","Z20121",10414,417,0,417," 4.0"
"4816","Z20124",4972,109,0,109," 2.2"
"4817","Z20130",130,58,34,24,"18.5"
"4818","Z20132",5656,353,87,266," 4.7"
"4819","Z20135",1403,216,100,116," 8.3"
"4820","Z20136",9142,232,27,205," 2.2"
"4821","Z20137",462,60,3,57,"12.3"
"4822","Z20141",2222,162,0,162," 7.3"
"4823","Z20144",561,100,36,64,"11.4"
"4824","Z20147",21168,592,86,506," 2.4"
"4825","Z20148",12550,551,54,497," 4.0"
"4826","Z20151",7086,229,45,184," 2.6"
"4827","Z20152",9130,429,92,337," 3.7"
"4828","Z20155",11248,495,0,495," 4.4"
"4829","Z20158",1596,158,22,136," 8.5"
"4830","Z20164",12572,431,0,431," 3.4"
"4831","Z20165",11820,433,27,406," 3.4"
"4832","Z20166",3648,153,0,153," 4.2"
"4833","Z20169",7439,232,34,198," 2.7"
"4834","Z20170",14166,824,66,758," 5.4"
"4835","Z20171",17111,656,247,409," 2.4"
"4836","Z20175",11038,368,38,330," 3.0"
"4837","Z20176",17178,1078,142,936," 5.4"
"4838","Z20180",2413,143,79,64," 2.7"
"4839","Z20181",2546,52,0,52," 2.0"
"4840","Z20184",373,128,52,76,"20.4"
"4841","Z20186",5984,442,14,428," 7.2"
"4842","Z20187",5633,225,68,157," 2.8"
"4843","Z20190",9163,641,202,439," 4.8"
"4844","Z20191",11980,452,9,443," 3.7"
"4845","Z20197",669,51,0,51," 7.6"
"4846","Z20198",1321,354,150,204,"15.4"
"4847","Z20601",8866,368,0,368," 4.2"
"4848","Z20602",10407,669,45,624," 6.0"
"4849","Z20603",11212,481,26,455," 4.1"
"4850","Z20607",3634,170,44,126," 3.5"
"4851","Z20613",5112,359,6,353," 6.9"
"4852","Z20615",183,18,18,0," 0.0"
"4853","Z20616",2248,273,27,246,"10.9"
"4854","Z20618",327,77,31,46,"14.1"
"4855","Z20619",4650,352,14,338," 7.3"
"4856","Z20620",538,35,0,35," 6.5"
"4857","Z20622",1646,66,8,58," 3.5"
"4858","Z20623",958,103,25,78," 8.1"
"4859","Z20624",512,36,0,36," 7.0"
"4860","Z20625",426,157,88,69,"16.2"
"4861","Z20628",148,48,48,0," 0.0"
"4862","Z20629",258,147,71,76,"29.5"
"4863","Z20634",2941,305,19,286," 9.7"
"4864","Z20636",3941,458,203,255," 6.5"
"4865","Z20639",4959,355,99,256," 5.2"
"4866","Z20640",4402,540,41,499,"11.3"
"4867","Z20646",6865,252,0,252," 3.7"
"4868","Z20650",5529,525,190,335," 6.1"
"4869","Z20653",9868,908,191,717," 7.3"
"4870","Z20657",7873,962,407,555," 7.0"
"4871","Z20659",8277,473,114,359," 4.3"
"4872","Z20662",1272,202,103,99," 7.8"
"4873","Z20667",319,107,0,107,"33.5"
"4874","Z20670",481,88,0,88,"18.3"
"4875","Z20674",555,212,107,105,"18.9"
"4876","Z20675",624,22,0,22," 3.5"
"4877","Z20676",1610,221,139,82," 5.1"
"4878","Z20677",876,104,0,104,"11.9"
"4879","Z20678",4604,269,57,212," 4.6"
"4880","Z20685",2379,220,104,116," 4.9"
"4881","Z20688",1166,222,119,103," 8.8"
"4882","Z20689",587,49,0,49," 8.3"
"4883","Z20693",503,33,11,22," 4.4"
"4884","Z20695",2509,289,13,276,"11.0"
"4885","Z20705",9333,543,19,524," 5.6"
"4886","Z20706",13190,996,9,987," 7.5"
"4887","Z20707",12818,794,44,750," 5.9"
"4888","Z20708",10633,849,53,796," 7.5"
"4889","Z20710",4056,370,5,365," 9.0"
"4890","Z20711",2523,141,53,88," 3.5"
"4891","Z20712",3853,235,0,235," 6.1"
"4892","Z20714",2137,287,167,120," 5.6"
"4893","Z20715",9121,397,28,369," 4.0"
"4894","Z20716",8527,303,0,303," 3.6"
"4895","Z20720",7555,362,6,356," 4.7"
"4896","Z20721",9807,448,0,448," 4.6"
"4897","Z20722",1993,215,0,215,"10.8"
"4898","Z20723",11424,472,20,452," 4.0"
"4899","Z20724",6922,335,57,278," 4.0"
"4900","Z20732",3701,344,213,131," 3.5"
"4901","Z20733",1145,94,43,51," 4.5"
"4902","Z20735",13108,645,36,609," 4.6"
"4903","Z20736",3312,191,9,182," 5.5"
"4904","Z20737",6263,372,0,372," 5.9"
"4905","Z20740",10094,962,11,951," 9.4"
"4906","Z20743",15720,1597,62,1535," 9.8"
"4907","Z20744",19684,1132,91,1041," 5.3"
"4908","Z20745",12169,1485,134,1351,"11.1"
"4909","Z20746",12588,1590,0,1590,"12.6"
"4910","Z20747",16458,1783,20,1763,"10.7"
"4911","Z20748",16544,1898,117,1781,"10.8"
"4912","Z20751",1011,86,54,32," 3.2"
"4913","Z20754",2445,112,0,112," 4.6"
"4914","Z20755",3044,370,0,370,"12.2"
"4915","Z20759",1306,38,38,0," 0.0"
"4916","Z20762",1229,332,0,332,"27.0"
"4917","Z20763",830,26,0,26," 3.1"
"4918","Z20764",1938,233,161,72," 3.7"
"4919","Z20765",282,32,32,0," 0.0"
"4920","Z20769",2172,46,0,46," 2.1"
"4921","Z20770",10878,695,0,695," 6.4"
"4922","Z20772",16627,745,0,745," 4.5"
"4923","Z20774",17619,1131,26,1105," 6.3"
"4924","Z20776",1254,40,0,40," 3.2"
"4925","Z20777",1189,29,0,29," 2.4"
"4926","Z20778",759,58,0,58," 7.6"
"4927","Z20779",629,113,102,11," 1.7"
"4928","Z20781",4178,368,4,364," 8.7"
"4929","Z20782",12063,616,10,606," 5.0"
"4930","Z20783",13805,504,16,488," 3.5"
"4931","Z20784",10508,668,0,668," 6.4"
"4932","Z20785",15030,1401,0,1401," 9.3"
"4933","Z20794",3742,435,0,435,"11.6"
"4934","Z20812",102,1,0,1," 1.0"
"4935","Z20814",13714,1057,197,860," 6.3"
"4936","Z20815",13807,700,159,541," 3.9"
"4937","Z20816",6581,371,59,312," 4.7"
"4938","Z20817",13695,710,23,687," 5.0"
"4939","Z20818",810,56,0,56," 6.9"
"4940","Z20832",8819,157,9,148," 1.7"
"4941","Z20833",2629,82,0,82," 3.1"
"4942","Z20837",2036,119,0,119," 5.8"
"4943","Z20838",93,2,2,0," 0.0"
"4944","Z20841",3135,179,0,179," 5.7"
"4945","Z20842",726,96,12,84,"11.6"
"4946","Z20850",19282,869,19,850," 4.4"
"4947","Z20851",5248,279,34,245," 4.7"
"4948","Z20852",21171,1095,177,918," 4.3"
"4949","Z20853",10046,198,48,150," 1.5"
"4950","Z20854",17410,602,82,520," 3.0"
"4951","Z20855",4945,20,0,20," 0.4"
"4952","Z20860",860,18,0,18," 2.1"
"4953","Z20861",635,54,0,54," 8.5"
"4954","Z20866",4791,222,21,201," 4.2"
"4955","Z20871",5392,150,10,140," 2.6"
"4956","Z20872",4509,284,0,284," 6.3"
"4957","Z20874",22728,823,51,772," 3.4"
"4958","Z20876",8948,374,0,374," 4.2"
"4959","Z20877",13153,855,0,855," 6.5"
"4960","Z20878",23746,981,82,899," 3.8"
"4961","Z20879",8564,300,0,300," 3.5"
"4962","Z20880",228,3,0,3," 1.3"
"4963","Z20882",4660,217,38,179," 3.8"
"4964","Z20886",12784,855,0,855," 6.7"
"4965","Z20895",7385,329,43,286," 3.9"
"4966","Z20896",315,5,2,3," 1.0"
"4967","Z20901",12889,448,56,392," 3.0"
"4968","Z20902",17451,824,8,816," 4.7"
"4969","Z20903",7505,303,0,303," 4.0"
"4970","Z20904",21801,1217,66,1151," 5.3"
"4971","Z20905",5985,161,12,149," 2.5"
"4972","Z20906",26003,1154,101,1053," 4.0"
"4973","Z20910",20505,1076,54,1022," 5.0"
"4974","Z20912",10135,622,43,579," 5.7"
"4975","Z21001",9878,696,18,678," 6.9"
"4976","Z21005",900,286,0,286,"31.8"
"4977","Z21009",11900,794,12,782," 6.6"
"4978","Z21012",7925,420,91,329," 4.2"
"4979","Z21013",1789,73,0,73," 4.1"
"4980","Z21014",14379,431,17,414," 2.9"
"4981","Z21015",10458,650,96,554," 5.3"
"4982","Z21017",2908,103,0,103," 3.5"
"4983","Z21028",1273,42,0,42," 3.3"
"4984","Z21029",3634,115,31,84," 2.3"
"4985","Z21030",10919,745,45,700," 6.4"
"4986","Z21032",3600,309,77,232," 6.4"
"4987","Z21034",1320,77,12,65," 4.9"
"4988","Z21037",8280,572,356,216," 2.6"
"4989","Z21040",9486,760,0,760," 8.0"
"4990","Z21042",13772,414,38,376," 2.7"
"4991","Z21043",17046,898,55,843," 4.9"
"4992","Z21044",18260,957,78,879," 4.8"
"4993","Z21045",15352,505,8,497," 3.2"
"4994","Z21046",6581,226,45,181," 2.8"
"4995","Z21047",4270,181,0,181," 4.2"
"4996","Z21048",4016,219,16,203," 5.1"
"4997","Z21050",6492,134,33,101," 1.6"
"4998","Z21052",116,12,0,12,"10.3"
"4999","Z21054",4126,284,16,268," 6.5"
"5000","Z21057",1663,170,29,141," 8.5"
"5001","Z21060",13251,887,159,728," 5.5"
"5002","Z21061",22514,1250,0,1250," 5.6"
"5003","Z21071",253,28,0,28,"11.1"
"5004","Z21074",5700,176,34,142," 2.5"
"5005","Z21075",10780,367,0,367," 3.4"
"5006","Z21076",6395,336,18,318," 5.0"
"5007","Z21077",192,18,0,18," 9.4"
"5008","Z21078",8318,723,68,655," 7.9"
"5009","Z21084",2696,137,0,137," 5.1"
"5010","Z21085",6691,374,46,328," 4.9"
"5011","Z21087",2005,128,0,128," 6.4"
"5012","Z21090",3920,266,72,194," 4.9"
"5013","Z21093",16090,764,129,635," 3.9"
"5014","Z21102",4133,294,30,264," 6.4"
"5015","Z21104",1667,7,7,0," 0.0"
"5016","Z21108",6548,330,0,330," 5.0"
"5017","Z21111",1699,105,0,105," 6.2"
"5018","Z21113",13305,649,16,633," 4.8"
"5019","Z21114",10075,291,0,291," 2.9"
"5020","Z21117",24142,1534,21,1513," 6.3"
"5021","Z21120",2592,52,8,44," 1.7"
"5022","Z21122",23071,1266,173,1093," 4.7"
"5023","Z21128",5207,220,0,220," 4.2"
"5024","Z21131",2715,233,17,216," 8.0"
"5025","Z21132",936,74,0,74," 7.9"
"5026","Z21133",12199,874,0,874," 7.2"
"5027","Z21136",13115,753,32,721," 5.5"
"5028","Z21140",1322,44,0,44," 3.3"
"5029","Z21144",11913,569,0,569," 4.8"
"5030","Z21146",9821,521,203,318," 3.2"
"5031","Z21152",2237,19,14,5," 0.2"
"5032","Z21154",2317,186,21,165," 7.1"
"5033","Z21155",1050,47,17,30," 2.9"
"5034","Z21157",14443,750,34,716," 5.0"
"5035","Z21158",7773,324,27,297," 3.8"
"5036","Z21160",992,89,12,77," 7.8"
"5037","Z21161",2028,134,15,119," 5.9"
"5038","Z21162",1409,100,4,96," 6.8"
"5039","Z21163",2577,119,0,119," 4.6"
"5040","Z21201",10593,1420,45,1375,"13.0"
"5041","Z21202",10357,2346,239,2107,"20.3"
"5042","Z21204",8193,751,35,716," 8.7"
"5043","Z21205",7164,1958,14,1944,"27.1"
"5044","Z21206",21995,2408,91,2317,"10.5"
"5045","Z21207",20891,2274,18,2256,"10.8"
"5046","Z21208",15909,1279,77,1202," 7.6"
"5047","Z21209",12393,521,10,511," 4.1"
"5048","Z21210",5751,293,81,212," 3.7"
"5049","Z21211",8815,830,36,794," 9.0"
"5050","Z21212",14612,1475,65,1410," 9.6"
"5051","Z21213",15219,4147,67,4080,"26.8"
"5052","Z21214",9153,1101,28,1073,"11.7"
"5053","Z21215",26932,4618,63,4555,"16.9"
"5054","Z21216",14982,4566,28,4538,"30.3"
"5055","Z21217",21963,7068,30,7038,"32.0"
"5056","Z21218",22861,4123,94,4029,"17.6"
"5057","Z21219",3679,256,18,238," 6.5"
"5058","Z21220",16492,1606,82,1524," 9.2"
"5059","Z21221",17698,1709,148,1561," 8.8"
"5060","Z21222",23183,2400,207,2193," 9.5"
"5061","Z21223",13862,5036,5,5031,"36.3"
"5062","Z21224",22908,3374,163,3211,"14.0"
"5063","Z21225",14075,2059,56,2003,"14.2"
"5064","Z21226",3122,401,76,325,"10.4"
"5065","Z21227",13405,1101,35,1066," 8.0"
"5066","Z21228",19680,1112,26,1086," 5.5"
"5067","Z21229",20442,2610,112,2498,"12.2"
"5068","Z21230",17225,2537,204,2333,"13.5"
"5069","Z21231",8734,1158,5,1153,"13.2"
"5070","Z21234",31209,2039,21,2018," 6.5"
"5071","Z21236",16337,993,9,984," 6.0"
"5072","Z21237",12473,894,24,870," 7.0"
"5073","Z21239",12727,1110,73,1037," 8.1"
"5074","Z21244",14743,952,0,952," 6.5"
"5075","Z21286",8598,542,73,469," 5.5"
"5076","Z21401",17540,1500,426,1074," 6.1"
"5077","Z21403",14217,1476,475,1001," 7.0"
"5078","Z21409",7815,467,122,345," 4.4"
"5079","Z21502",19225,2626,147,2479,"12.9"
"5080","Z21520",1186,323,216,107," 9.0"
"5081","Z21521",703,121,4,117,"16.6"
"5082","Z21529",225,7,0,7," 3.1"
"5083","Z21530",896,169,123,46," 5.1"
"5084","Z21531",1338,418,307,111," 8.3"
"5085","Z21532",6765,961,102,859,"12.7"
"5086","Z21536",1726,233,120,113," 6.5"
"5087","Z21538",295,88,45,43,"14.6"
"5088","Z21539",1123,178,27,151,"13.4"
"5089","Z21541",2368,1736,1307,429,"18.1"
"5090","Z21545",833,38,0,38," 4.6"
"5091","Z21550",8240,2494,1709,785," 9.5"
"5092","Z21555",963,287,228,59," 6.1"
"5093","Z21557",770,77,10,67," 8.7"
"5094","Z21561",2691,1655,1357,298,"11.1"
"5095","Z21562",1534,286,0,286,"18.6"
"5096","Z21601",11715,1564,404,1160," 9.9"
"5097","Z21610",324,194,159,35,"10.8"
"5098","Z21612",418,197,160,37," 8.9"
"5099","Z21613",9061,1634,430,1204,"13.3"
"5100","Z21617",4084,454,96,358," 8.8"
"5101","Z21619",2816,479,334,145," 5.1"
"5102","Z21620",6078,1084,756,328," 5.4"
"5103","Z21622",381,109,82,27," 7.1"
"5104","Z21623",743,115,16,99,"13.3"
"5105","Z21625",1121,48,0,48," 4.3"
"5106","Z21628",329,44,0,44,"13.4"
"5107","Z21629",4053,470,64,406,"10.0"
"5108","Z21632",2776,318,18,300,"10.8"
"5109","Z21634",304,201,154,47,"15.5"
"5110","Z21635",1192,266,163,103," 8.6"
"5111","Z21638",2247,418,318,100," 4.5"
"5112","Z21639",1806,230,35,195,"10.8"
"5113","Z21640",605,48,18,30," 5.0"
"5114","Z21643",2496,489,11,478,"19.2"
"5115","Z21645",587,241,163,78,"13.3"
"5116","Z21647",179,78,42,36,"20.1"
"5117","Z21649",640,121,0,121,"18.9"
"5118","Z21651",1203,182,49,133,"11.1"
"5119","Z21654",966,423,310,113,"11.7"
"5120","Z21655",2021,172,13,159," 7.9"
"5121","Z21657",284,3,0,3," 1.1"
"5122","Z21658",1766,309,240,69," 3.9"
"5123","Z21659",773,183,30,153,"19.8"
"5124","Z21660",1484,143,25,118," 8.0"
"5125","Z21661",1869,719,533,186,"10.0"
"5126","Z21662",444,178,148,30," 6.8"
"5127","Z21663",2095,674,551,123," 5.9"
"5128","Z21664",295,38,3,35,"11.9"
"5129","Z21665",189,44,44,0," 0.0"
"5130","Z21666",5112,901,698,203," 4.0"
"5131","Z21668",736,75,28,47," 6.4"
"5132","Z21669",205,115,101,14," 6.8"
"5133","Z21671",581,201,156,45," 7.7"
"5134","Z21673",1481,129,69,60," 4.1"
"5135","Z21677",264,72,55,17," 6.4"
"5136","Z21678",1164,439,301,138,"11.9"
"5137","Z21701",16056,826,89,737," 4.6"
"5138","Z21702",15821,664,35,629," 4.0"
"5139","Z21703",13189,790,27,763," 5.8"
"5140","Z21704",5007,52,0,52," 1.0"
"5141","Z21710",1889,101,0,101," 5.3"
"5142","Z21711",363,64,0,64,"17.6"
"5143","Z21713",3971,301,112,189," 4.8"
"5144","Z21716",2093,131,0,131," 6.3"
"5145","Z21719",690,186,20,166,"24.1"
"5146","Z21722",2070,89,7,82," 4.0"
"5147","Z21727",1795,125,9,116," 6.5"
"5148","Z21734",345,20,0,20," 5.8"
"5149","Z21737",609,25,0,25," 4.1"
"5150","Z21740",25547,2315,387,1928," 7.5"
"5151","Z21742",13980,846,233,613," 4.4"
"5152","Z21750",1899,377,95,282,"14.8"
"5153","Z21754",2145,8,0,8," 0.4"
"5154","Z21755",2113,9,0,9," 0.4"
"5155","Z21756",1387,31,0,31," 2.2"
"5156","Z21757",1253,73,0,73," 5.8"
"5157","Z21758",1896,151,0,151," 8.0"
"5158","Z21766",496,254,190,64,"12.9"
"5159","Z21767",575,47,0,47," 8.2"
"5160","Z21769",4263,265,30,235," 5.5"
"5161","Z21770",1898,41,0,41," 2.2"
"5162","Z21771",10193,264,20,244," 2.4"
"5163","Z21773",2066,117,62,55," 2.7"
"5164","Z21774",4372,103,0,103," 2.4"
"5165","Z21776",2067,205,26,179," 8.7"
"5166","Z21778",406,66,0,66,"16.3"
"5167","Z21780",578,27,9,18," 3.1"
"5168","Z21782",1866,207,156,51," 2.7"
"5169","Z21783",3436,173,41,132," 3.8"
"5170","Z21784",13963,456,18,438," 3.1"
"5171","Z21787",4237,275,0,275," 6.5"
"5172","Z21788",5121,419,31,388," 7.6"
"5173","Z21791",2184,135,0,135," 6.2"
"5174","Z21793",3659,71,35,36," 1.0"
"5175","Z21794",1016,87,52,35," 3.4"
"5176","Z21795",4076,314,23,291," 7.1"
"5177","Z21797",3100,185,0,185," 6.0"
"5178","Z21798",868,54,0,54," 6.2"
"5179","Z21801",12276,1605,173,1432,"11.7"
"5180","Z21804",16388,1700,187,1513," 9.2"
"5181","Z21811",15182,6191,5677,514," 3.4"
"5182","Z21813",1129,288,215,73," 6.5"
"5183","Z21814",350,72,17,55,"15.7"
"5184","Z21817",2849,718,332,386,"13.5"
"5185","Z21821",699,283,197,86,"12.3"
"5186","Z21822",858,6,0,6," 0.7"
"5187","Z21826",2009,87,0,87," 4.3"
"5188","Z21830",1364,92,21,71," 5.2"
"5189","Z21835",348,23,0,23," 6.6"
"5190","Z21837",1103,72,0,72," 6.5"
"5191","Z21838",852,218,133,85,"10.0"
"5192","Z21841",366,21,0,21," 5.7"
"5193","Z21842",32798,27541,20444,7097,"21.6"
"5194","Z21850",1128,117,24,93," 8.2"
"5195","Z21851",3279,541,189,352,"10.7"
"5196","Z21853",4586,970,393,577,"12.6"
"5197","Z21861",413,38,15,23," 5.6"
"5198","Z21863",2074,294,104,190," 9.2"
"5199","Z21864",285,24,0,24," 8.4"
"5200","Z21865",260,27,0,27,"10.4"
"5201","Z21869",481,140,62,78,"16.2"
"5202","Z21872",282,48,0,48,"17.0"
"5203","Z21874",915,51,0,51," 5.6"
"5204","Z21875",2714,356,141,215," 7.9"
"5205","Z21901",7781,1052,409,643," 8.3"
"5206","Z21903",2509,279,119,160," 6.4"
"5207","Z21904",2816,228,82,146," 5.2"
"5208","Z21911",4092,389,34,355," 8.7"
"5209","Z21912",391,58,58,0," 0.0"
"5210","Z21913",361,34,6,28," 7.8"
"5211","Z21915",1603,435,278,157," 9.8"
"5212","Z21918",1420,100,41,59," 4.2"
"5213","Z21919",2276,942,610,332,"14.6"
"5214","Z21921",17243,1581,331,1250," 7.2"
"5215","Z22003",19933,704,0,704," 3.5"
"5216","Z22015",15067,370,0,370," 2.5"
"5217","Z22025",6135,111,0,111," 1.8"
"5218","Z22026",5025,323,0,323," 6.4"
"5219","Z22027",721,64,0,64," 8.9"
"5220","Z22030",19859,560,43,517," 2.6"
"5221","Z22031",12432,615,33,582," 4.7"
"5222","Z22032",9925,306,6,300," 3.0"
"5223","Z22033",15866,592,87,505," 3.2"
"5224","Z22039",5976,116,12,104," 1.7"
"5225","Z22041",11226,565,13,552," 4.9"
"5226","Z22042",12472,589,46,543," 4.4"
"5227","Z22043",9857,510,48,462," 4.7"
"5228","Z22044",6096,360,34,326," 5.3"
"5229","Z22046",6474,190,0,190," 2.9"
"5230","Z22060",3102,248,9,239," 7.7"
"5231","Z22066",6037,233,122,111," 1.8"
"5232","Z22079",11675,577,199,378," 3.2"
"5233","Z22101",11083,459,45,414," 3.7"
"5234","Z22102",10821,793,93,700," 6.5"
"5235","Z22124",6964,224,6,218," 3.1"
"5236","Z22134",1608,85,6,79," 4.9"
"5237","Z22150",9349,496,29,467," 5.0"
"5238","Z22151",5815,311,0,311," 5.3"
"5239","Z22152",10590,332,0,332," 3.1"
"5240","Z22153",10545,302,34,268," 2.5"
"5241","Z22172",3353,155,0,155," 4.6"
"5242","Z22180",8732,197,14,183," 2.1"
"5243","Z22181",5527,245,93,152," 2.8"
"5244","Z22182",9191,218,30,188," 2.0"
"5245","Z22191",22153,1049,96,953," 4.3"
"5246","Z22192",20301,761,30,731," 3.6"
"5247","Z22193",23946,708,0,708," 3.0"
"5248","Z22201",19710,2338,462,1876," 9.5"
"5249","Z22202",15199,3008,1376,1632,"10.7"
"5250","Z22203",11871,801,89,712," 6.0"
"5251","Z22204",22753,1516,24,1492," 6.6"
"5252","Z22205",6988,213,0,213," 3.0"
"5253","Z22206",11334,996,118,878," 7.7"
"5254","Z22207",12053,660,55,605," 5.0"
"5255","Z22209",8287,1393,448,945,"11.4"
"5256","Z22213",1452,98,0,98," 6.7"
"5257","Z22301",5471,253,41,212," 3.9"
"5258","Z22302",9135,679,132,547," 6.0"
"5259","Z22303",7339,603,55,548," 7.5"
"5260","Z22304",23412,2424,122,2302," 9.8"
"5261","Z22305",6922,726,168,558," 8.1"
"5262","Z22306",12364,766,10,756," 6.1"
"5263","Z22307",4790,373,95,278," 5.8"
"5264","Z22308",4696,109,13,96," 2.0"
"5265","Z22309",12176,827,69,758," 6.2"
"5266","Z22310",11966,481,45,436," 3.6"
"5267","Z22311",8558,879,0,879,"10.3"
"5268","Z22312",12118,971,43,928," 7.7"
"5269","Z22314",18510,2296,777,1519," 8.2"
"5270","Z22315",11090,476,15,461," 4.2"
"5271","Z22401",11252,1172,61,1111," 9.9"
"5272","Z22405",10648,478,34,444," 4.2"
"5273","Z22406",8321,546,12,534," 6.4"
"5274","Z22407",20433,1026,29,997," 4.9"
"5275","Z22408",9890,575,49,526," 5.3"
"5276","Z22427",1233,58,11,47," 3.8"
"5277","Z22432",264,104,0,104,"39.4"
"5278","Z22435",1228,156,66,90," 7.3"
"5279","Z22436",459,83,32,51,"11.1"
"5280","Z22437",454,108,41,67,"14.8"
"5281","Z22438",149,64,23,41,"27.5"
"5282","Z22443",4908,1467,969,498,"10.1"
"5283","Z22448",179,32,4,28,"15.6"
"5284","Z22460",997,369,145,224,"22.5"
"5285","Z22469",1306,696,635,61," 4.7"
"5286","Z22473",3512,1293,922,371,"10.6"
"5287","Z22480",646,156,89,67,"10.4"
"5288","Z22482",1937,382,50,332,"17.1"
"5289","Z22485",9527,1295,269,1026,"10.8"
"5290","Z22488",827,419,300,119,"14.4"
"5291","Z22503",2847,929,692,237," 8.3"
"5292","Z22508",5615,510,427,83," 1.5"
"5293","Z22511",1119,490,367,123,"11.0"
"5294","Z22514",1150,181,67,114," 9.9"
"5295","Z22520",3342,1131,626,505,"15.1"
"5296","Z22535",204,21,0,21,"10.3"
"5297","Z22539",2051,783,575,208,"10.1"
"5298","Z22542",888,161,55,106,"11.9"
"5299","Z22546",6776,551,83,468," 6.9"
"5300","Z22551",7340,481,171,310," 4.2"
"5301","Z22553",4840,362,36,326," 6.7"
"5302","Z22554",17759,968,152,816," 4.6"
"5303","Z22556",9031,362,6,356," 3.9"
"5304","Z22560",3004,625,286,339,"11.3"
"5305","Z22567",1091,116,60,56," 5.1"
"5306","Z22572",2924,712,211,501,"17.1"
"5307","Z22576",1069,409,229,180,"16.8"
"5308","Z22578",1786,708,590,118," 6.6"
"5309","Z22580",2172,232,64,168," 7.7"
"5310","Z22601",12422,1295,77,1218," 9.8"
"5311","Z22602",11026,869,176,693," 6.3"
"5312","Z22603",5836,470,102,368," 6.3"
"5313","Z22610",846,172,115,57," 6.7"
"5314","Z22611",3716,384,36,348," 9.4"
"5315","Z22620",1089,201,96,105," 9.6"
"5316","Z22624",1013,55,0,55," 5.4"
"5317","Z22625",1565,123,50,73," 4.7"
"5318","Z22627",349,75,8,67,"19.2"
"5319","Z22630",13162,1296,543,753," 5.7"
"5320","Z22637",1023,244,225,19," 1.9"
"5321","Z22641",169,20,20,0," 0.0"
"5322","Z22642",1861,300,139,161," 8.7"
"5323","Z22644",1041,122,114,8," 0.8"
"5324","Z22655",7865,643,29,614," 7.8"
"5325","Z22656",1081,85,19,66," 6.1"
"5326","Z22657",4909,599,129,470," 9.6"
"5327","Z22660",808,60,32,28," 3.5"
"5328","Z22663",691,105,0,105,"15.2"
"5329","Z22664",3918,405,115,290," 7.4"
"5330","Z22701",12699,1029,136,893," 7.0"
"5331","Z22712",2897,276,43,233," 8.0"
"5332","Z22713",597,59,33,26," 4.4"
"5333","Z22714",396,18,18,0," 0.0"
"5334","Z22715",650,12,0,12," 1.8"
"5335","Z22727",2409,462,251,211," 8.8"
"5336","Z22728",1298,136,0,136,"10.5"
"5337","Z22733",596,47,47,0," 0.0"
"5338","Z22734",1191,69,0,69," 5.8"
"5339","Z22737",1043,126,28,98," 9.4"
"5340","Z22738",516,70,34,36," 7.0"
"5341","Z22740",744,166,100,66," 8.9"
"5342","Z22742",716,45,18,27," 3.8"
"5343","Z22747",698,161,146,15," 2.1"
"5344","Z22801",14106,1390,79,1311," 9.3"
"5345","Z22802",11441,638,74,564," 4.9"
"5346","Z22810",1075,807,658,149,"13.9"
"5347","Z22811",222,45,35,10," 4.5"
"5348","Z22812",3223,121,20,101," 3.1"
"5349","Z22815",3743,398,163,235," 6.3"
"5350","Z22820",217,111,68,43,"19.8"
"5351","Z22821",2330,236,121,115," 4.9"
"5352","Z22824",2886,365,72,293,"10.2"
"5353","Z22827",4756,620,150,470," 9.9"
"5354","Z22830",913,206,149,57," 6.2"
"5355","Z22835",5773,1144,642,502," 8.7"
"5356","Z22841",1294,99,31,68," 5.3"
"5357","Z22842",3008,966,722,244," 8.1"
"5358","Z22843",1062,168,129,39," 3.7"
"5359","Z22844",2257,297,132,165," 7.3"
"5360","Z22847",409,25,13,12," 2.9"
"5361","Z22849",2336,465,216,249,"10.7"
"5362","Z22851",2848,519,275,244," 8.6"
"5363","Z22853",2006,211,50,161," 8.0"
"5364","Z22901",15776,1779,253,1526," 9.7"
"5365","Z22902",10518,834,145,689," 6.6"
"5366","Z22903",16461,2145,313,1832,"11.1"
"5367","Z22911",7414,400,32,368," 5.0"
"5368","Z22920",2113,413,133,280,"13.3"
"5369","Z22922",1127,316,37,279,"24.8"
"5370","Z22932",3381,391,130,261," 7.7"
"5371","Z22936",1812,77,38,39," 2.2"
"5372","Z22937",751,106,41,65," 8.7"
"5373","Z22939",2208,268,27,241,"10.9"
"5374","Z22940",474,63,10,53,"11.2"
"5375","Z22942",3904,542,277,265," 6.8"
"5376","Z22946",119,22,0,22,"18.5"
"5377","Z22947",2095,252,56,196," 9.4"
"5378","Z22949",605,88,0,88,"14.5"
"5379","Z22952",1051,165,61,104," 9.9"
"5380","Z22958",3089,2079,1857,222," 7.2"
"5381","Z22959",578,81,0,81,"14.0"
"5382","Z22960",4685,821,188,633,"13.5"
"5383","Z22963",6470,453,157,296," 4.6"
"5384","Z22967",1052,323,147,176,"16.7"
"5385","Z22968",3865,303,140,163," 4.2"
"5386","Z22969",623,170,48,122,"19.6"
"5387","Z22971",760,129,28,101,"13.3"
"5388","Z22973",3042,401,234,167," 5.5"
"5389","Z22974",2079,95,0,95," 4.6"
"5390","Z22976",322,151,45,106,"32.9"
"5391","Z22980",14354,1223,196,1027," 7.2"
"5392","Z23002",4260,498,108,390," 9.2"
"5393","Z23004",425,96,0,96,"22.6"
"5394","Z23005",6165,251,10,241," 3.9"
"5395","Z23009",2558,171,0,171," 6.7"
"5396","Z23015",1700,153,31,122," 7.2"
"5397","Z23024",4341,1095,605,490,"11.3"
"5398","Z23027",566,107,0,107,"18.9"
"5399","Z23030",2246,258,97,161," 7.2"
"5400","Z23032",163,47,0,47,"28.8"
"5401","Z23035",809,251,147,104,"12.9"
"5402","Z23038",794,65,0,65," 8.2"
"5403","Z23039",601,111,23,88,"14.6"
"5404","Z23040",2088,391,80,311,"14.9"
"5405","Z23043",1702,962,887,75," 4.4"
"5406","Z23047",782,120,28,92,"11.8"
"5407","Z23050",298,7,7,0," 0.0"
"5408","Z23055",336,22,0,22," 6.5"
"5409","Z23059",12832,819,17,802," 6.2"
"5410","Z23060",13529,697,0,697," 5.2"
"5411","Z23061",9024,1027,490,537," 6.0"
"5412","Z23062",1203,192,72,120,"10.0"
"5413","Z23063",1989,269,44,225,"11.3"
"5414","Z23065",878,54,0,54," 6.2"
"5415","Z23069",1122,53,3,50," 4.5"
"5416","Z23070",265,41,28,13," 4.9"
"5417","Z23071",945,265,191,74," 7.8"
"5418","Z23072",5171,567,195,372," 7.2"
"5419","Z23076",405,85,75,10," 2.5"
"5420","Z23079",275,101,95,6," 2.2"
"5421","Z23083",876,138,0,138,"15.8"
"5422","Z23084",793,99,25,74," 9.3"
"5423","Z23085",224,29,0,29,"12.9"
"5424","Z23086",1267,105,45,60," 4.7"
"5425","Z23089",2225,281,212,69," 3.1"
"5426","Z23092",316,115,70,45,"14.2"
"5427","Z23093",5970,1136,456,680,"11.4"
"5428","Z23102",1095,20,13,7," 0.6"
"5429","Z23103",2030,83,21,62," 3.1"
"5430","Z23106",436,116,0,116,"26.6"
"5431","Z23109",1263,131,40,91," 7.2"
"5432","Z23110",326,66,47,19," 5.8"
"5433","Z23111",14912,800,141,659," 4.4"
"5434","Z23112",19087,1270,102,1168," 6.1"
"5435","Z23113",9704,420,19,401," 4.1"
"5436","Z23114",6856,216,58,158," 2.3"
"5437","Z23116",10044,302,0,302," 3.0"
"5438","Z23117",5233,1830,1288,542,"10.4"
"5439","Z23120",2233,43,0,43," 1.9"
"5440","Z23123",803,168,0,168,"20.9"
"5441","Z23124",1375,52,0,52," 3.8"
"5442","Z23129",174,24,0,24,"13.8"
"5443","Z23139",9563,501,63,438," 4.6"
"5444","Z23140",2583,282,90,192," 7.4"
"5445","Z23141",2467,71,0,71," 2.9"
"5446","Z23146",1264,72,0,72," 5.7"
"5447","Z23148",998,132,19,113,"11.3"
"5448","Z23149",1299,199,44,155,"11.9"
"5449","Z23150",5240,499,0,499," 9.5"
"5450","Z23153",533,83,0,83,"15.6"
"5451","Z23156",821,155,55,100,"12.2"
"5452","Z23168",2595,347,118,229," 8.8"
"5453","Z23169",897,377,321,56," 6.2"
"5454","Z23175",1434,567,250,317,"22.1"
"5455","Z23177",264,82,70,12," 4.5"
"5456","Z23181",2550,219,81,138," 5.4"
"5457","Z23185",20666,3352,1062,2290,"11.1"
"5458","Z23188",18259,1721,595,1126," 6.2"
"5459","Z23192",2703,105,0,105," 3.9"
"5460","Z23219",2130,366,24,342,"16.1"
"5461","Z23220",15379,2143,51,2092,"13.6"
"5462","Z23221",8017,456,53,403," 5.0"
"5463","Z23222",11324,1892,15,1877,"16.6"
"5464","Z23223",23249,2785,63,2722,"11.7"
"5465","Z23224",15127,2005,13,1992,"13.2"
"5466","Z23225",20065,2089,41,2048,"10.2"
"5467","Z23226",7621,717,36,681," 8.9"
"5468","Z23227",13086,1379,75,1304,"10.0"
"5469","Z23230",2800,199,0,199," 7.1"
"5470","Z23234",17244,1851,73,1778,"10.3"
"5471","Z23235",13540,903,85,818," 6.0"
"5472","Z23236",10362,583,105,478," 4.6"
"5473","Z23237",8477,708,16,692," 8.2"
"5474","Z23301",680,192,30,162,"23.8"
"5475","Z23303",549,47,0,47," 8.6"
"5476","Z23308",891,122,26,96,"10.8"
"5477","Z23310",2967,989,418,571,"19.2"
"5478","Z23314",3105,259,0,259," 8.3"
"5479","Z23315",725,112,0,112,"15.4"
"5480","Z23320",23260,1518,137,1381," 5.9"
"5481","Z23321",13184,727,68,659," 5.0"
"5482","Z23322",20456,931,24,907," 4.4"
"5483","Z23323",13185,715,16,699," 5.3"
"5484","Z23324",9505,830,0,830," 8.7"
"5485","Z23325",7093,431,75,356," 5.0"
"5486","Z23336",4361,2959,2445,514,"11.8"
"5487","Z23347",397,156,99,57,"14.4"
"5488","Z23350",2013,505,220,285,"14.2"
"5489","Z23356",1013,525,377,148,"14.6"
"5490","Z23359",463,111,0,111,"24.0"
"5491","Z23405",584,135,63,72,"12.3"
"5492","Z23410",1238,137,9,128,"10.3"
"5493","Z23413",476,90,13,77,"16.2"
"5494","Z23415",894,246,0,246,"27.5"
"5495","Z23417",2166,474,171,303,"14.0"
"5496","Z23418",428,84,30,54,"12.6"
"5497","Z23420",1268,190,118,72," 5.7"
"5498","Z23421",2186,429,145,284,"13.0"
"5499","Z23430",7393,506,129,377," 5.1"
"5500","Z23432",583,101,18,83,"14.2"
"5501","Z23433",508,21,0,21," 4.1"
"5502","Z23434",19578,2168,112,2056,"10.5"
"5503","Z23435",10712,824,44,780," 7.3"
"5504","Z23436",416,16,0,16," 3.8"
"5505","Z23437",1736,142,18,124," 7.1"
"5506","Z23438",809,93,5,88,"10.9"
"5507","Z23440",265,53,22,31,"11.7"
"5508","Z23451",23400,3602,1743,1859," 7.9"
"5509","Z23452",23891,1423,14,1409," 5.9"
"5510","Z23453",12830,749,40,709," 5.5"
"5511","Z23454",24254,1833,157,1676," 6.9"
"5512","Z23455",21094,1567,193,1374," 6.5"
"5513","Z23456",18685,1785,1061,724," 3.9"
"5514","Z23457",1659,70,0,70," 4.2"
"5515","Z23459",274,19,0,19," 6.9"
"5516","Z23462",26628,2288,90,2198," 8.3"
"5517","Z23464",28109,1246,84,1162," 4.1"
"5518","Z23480",331,174,116,58,"17.5"
"5519","Z23487",2393,163,0,163," 6.8"
"5520","Z23502",8531,864,9,855,"10.0"
"5521","Z23503",15439,1873,177,1696,"11.0"
"5522","Z23504",8559,1054,44,1010,"11.8"
"5523","Z23505",13284,1114,13,1101," 8.3"
"5524","Z23507",3607,110,5,105," 2.9"
"5525","Z23508",6764,725,0,725,"10.7"
"5526","Z23509",5540,526,39,487," 8.8"
"5527","Z23510",3612,398,10,388,"10.7"
"5528","Z23513",12498,913,16,897," 7.2"
"5529","Z23517",2651,303,17,286,"10.8"
"5530","Z23518",12742,986,78,908," 7.1"
"5531","Z23523",2772,210,0,210," 7.6"
"5532","Z23601",11690,1095,18,1077," 9.2"
"5533","Z23602",17023,1608,29,1579," 9.3"
"5534","Z23603",1563,200,5,195,"12.5"
"5535","Z23604",821,107,0,107,"13.0"
"5536","Z23605",6545,934,8,926,"14.1"
"5537","Z23606",12502,1235,68,1167," 9.3"
"5538","Z23608",18000,1221,101,1120," 6.2"
"5539","Z23651",337,157,0,157,"46.6"
"5540","Z23661",6376,881,0,881,"13.8"
"5541","Z23662",4726,109,20,89," 1.9"
"5542","Z23663",5954,931,0,931,"15.6"
"5543","Z23664",4689,741,107,634,"13.5"
"5544","Z23665",1419,136,0,136," 9.6"
"5545","Z23666",23238,2429,19,2410,"10.4"
"5546","Z23669",17803,1834,60,1774,"10.0"
"5547","Z23690",1512,181,11,170,"11.2"
"5548","Z23692",7962,630,82,548," 6.9"
"5549","Z23693",8915,412,51,361," 4.0"
"5550","Z23696",1522,126,18,108," 7.1"
"5551","Z23701",10109,933,21,912," 9.0"
"5552","Z23702",5094,623,0,623,"12.2"
"5553","Z23703",10472,658,40,618," 5.9"
"5554","Z23704",8831,1405,10,1395,"15.8"
"5555","Z23707",6481,611,16,595," 9.2"
"5556","Z23801",1325,165,31,134,"10.1"
"5557","Z23803",18471,3904,340,3564,"19.3"
"5558","Z23805",8653,1117,157,960,"11.1"
"5559","Z23821",821,125,6,119,"14.5"
"5560","Z23824",3250,498,70,428,"13.2"
"5561","Z23827",656,153,58,95,"14.5"
"5562","Z23828",157,31,0,31,"19.7"
"5563","Z23829",546,87,0,87,"15.9"
"5564","Z23830",421,20,0,20," 4.8"
"5565","Z23831",13829,672,107,565," 4.1"
"5566","Z23832",11697,578,0,578," 4.9"
"5567","Z23833",1106,169,0,169,"15.3"
"5568","Z23834",10739,936,81,855," 8.0"
"5569","Z23836",5247,591,15,576,"11.0"
"5570","Z23837",2002,138,0,138," 6.9"
"5571","Z23838",5797,297,60,237," 4.1"
"5572","Z23840",909,81,39,42," 4.6"
"5573","Z23841",1495,142,57,85," 5.7"
"5574","Z23843",376,78,21,57,"15.2"
"5575","Z23844",369,76,9,67,"18.2"
"5576","Z23845",295,117,117,0," 0.0"
"5577","Z23847",6090,813,103,710,"11.7"
"5578","Z23851",6008,659,19,640,"10.7"
"5579","Z23857",547,279,133,146,"26.7"
"5580","Z23860",12194,1581,66,1515,"12.4"
"5581","Z23866",904,92,6,86," 9.5"
"5582","Z23867",1025,254,30,224,"21.9"
"5583","Z23868",2674,676,172,504,"18.8"
"5584","Z23872",1127,244,76,168,"14.9"
"5585","Z23875",4352,538,177,361," 8.3"
"5586","Z23878",428,28,0,28," 6.5"
"5587","Z23882",1053,211,92,119,"11.3"
"5588","Z23888",1074,147,43,104," 9.7"
"5589","Z23889",353,140,0,140,"39.7"
"5590","Z23890",1561,291,75,216,"13.8"
"5591","Z23897",376,116,71,45,"12.0"
"5592","Z23899",207,83,33,50,"24.2"
"5593","Z23901",6843,1120,372,748,"10.9"
"5594","Z23915",306,57,8,49,"16.0"
"5595","Z23917",1814,556,300,256,"14.1"
"5596","Z23919",3087,1986,1779,207," 6.7"
"5597","Z23920",1798,302,81,221,"12.3"
"5598","Z23921",1123,239,54,185,"16.5"
"5599","Z23923",1314,340,99,241,"18.3"
"5600","Z23924",2963,654,124,530,"17.9"
"5601","Z23927",3527,1680,1077,603,"17.1"
"5602","Z23930",2662,518,105,413,"15.5"
"5603","Z23936",2893,614,91,523,"18.1"
"5604","Z23937",923,160,38,122,"13.2"
"5605","Z23944",2124,553,64,489,"23.0"
"5606","Z23947",1983,486,96,390,"19.7"
"5607","Z23950",1584,344,116,228,"14.4"
"5608","Z23954",803,167,141,26," 3.2"
"5609","Z23958",1574,334,39,295,"18.7"
"5610","Z23959",632,156,26,130,"20.6"
"5611","Z23960",791,125,17,108,"13.7"
"5612","Z23962",337,76,34,42,"12.5"
"5613","Z23964",498,90,34,56,"11.2"
"5614","Z23966",1295,244,52,192,"14.8"
"5615","Z23967",653,193,74,119,"18.2"
"5616","Z23968",388,75,0,75,"19.3"
"5617","Z23970",3973,701,154,547,"13.8"
"5618","Z23974",2171,497,131,366,"16.9"
"5619","Z23976",155,94,0,94,"60.6"
"5620","Z24011",254,56,0,56,"22.0"
"5621","Z24012",13582,951,72,879," 6.5"
"5622","Z24013",3654,682,27,655,"17.9"
"5623","Z24014",8616,632,59,573," 6.7"
"5624","Z24015",8073,832,92,740," 9.2"
"5625","Z24016",4719,812,9,803,"17.0"
"5626","Z24017",10250,1016,8,1008," 9.8"
"5627","Z24018",16895,754,129,625," 3.7"
"5628","Z24019",11498,649,68,581," 5.1"
"5629","Z24054",3150,523,51,472,"15.0"
"5630","Z24055",6460,1069,30,1039,"16.1"
"5631","Z24060",19972,2053,457,1596," 8.0"
"5632","Z24064",1785,128,0,128," 7.2"
"5633","Z24065",2843,115,5,110," 3.9"
"5634","Z24066",2421,440,119,321,"13.3"
"5635","Z24067",1306,322,115,207,"15.8"
"5636","Z24072",598,66,22,44," 7.4"
"5637","Z24073",13981,1110,125,985," 7.0"
"5638","Z24077",469,22,0,22," 4.7"
"5639","Z24078",3607,371,17,354," 9.8"
"5640","Z24079",1093,159,66,93," 8.5"
"5641","Z24082",114,32,0,32,"28.1"
"5642","Z24083",1144,115,30,85," 7.4"
"5643","Z24084",5157,564,241,323," 6.3"
"5644","Z24087",1851,164,0,164," 8.9"
"5645","Z24090",2141,358,41,317,"14.8"
"5646","Z24091",3580,822,213,609,"17.0"
"5647","Z24092",1434,211,145,66," 4.6"
"5648","Z24093",91,13,4,9," 9.9"
"5649","Z24095",2261,390,210,180," 8.0"
"5650","Z24101",2941,318,134,184," 6.3"
"5651","Z24102",917,172,161,11," 1.2"
"5652","Z24104",2717,1170,845,325,"12.0"
"5653","Z24112",16258,2678,217,2461,"15.1"
"5654","Z24120",1289,547,273,274,"21.3"
"5655","Z24121",7334,2946,2153,793,"10.8"
"5656","Z24122",944,183,48,135,"14.3"
"5657","Z24124",2039,182,64,118," 5.8"
"5658","Z24127",2292,496,335,161," 7.0"
"5659","Z24128",1044,262,41,221,"21.2"
"5660","Z24133",1389,180,58,122," 8.8"
"5661","Z24134",2583,355,125,230," 8.9"
"5662","Z24136",1757,261,150,111," 6.3"
"5663","Z24137",2148,937,800,137," 6.4"
"5664","Z24138",787,158,42,116,"14.7"
"5665","Z24141",10139,1579,227,1352,"13.3"
"5666","Z24147",605,62,0,62,"10.2"
"5667","Z24148",3801,400,15,385,"10.1"
"5668","Z24149",1571,182,63,119," 7.6"
"5669","Z24151",9154,924,139,785," 8.6"
"5670","Z24153",15950,1224,138,1086," 6.8"
"5671","Z24161",315,101,44,57,"18.1"
"5672","Z24162",1036,201,20,181,"17.5"
"5673","Z24171",4406,875,289,586,"13.3"
"5674","Z24174",1266,153,0,153,"12.1"
"5675","Z24175",3825,280,122,158," 4.1"
"5676","Z24176",1301,603,502,101," 7.8"
"5677","Z24179",8061,641,41,600," 7.4"
"5678","Z24184",2271,361,137,224," 9.9"
"5679","Z24185",420,93,93,0," 0.0"
"5680","Z24201",8533,1123,322,801," 9.4"
"5681","Z24202",5440,507,242,265," 4.9"
"5682","Z24210",8156,770,270,500," 6.1"
"5683","Z24211",4935,583,219,364," 7.4"
"5684","Z24216",1411,319,196,123," 8.7"
"5685","Z24219",4746,724,323,401," 8.4"
"5686","Z24220",264,73,20,53,"20.1"
"5687","Z24224",3117,643,215,428,"13.7"
"5688","Z24226",751,143,39,104,"13.8"
"5689","Z24228",3415,548,147,401,"11.7"
"5690","Z24230",4347,825,532,293," 6.7"
"5691","Z24243",939,77,66,11," 1.2"
"5692","Z24244",3152,706,512,194," 6.2"
"5693","Z24245",610,184,142,42," 6.9"
"5694","Z24248",1369,288,147,141,"10.3"
"5695","Z24251",4282,792,519,273," 6.4"
"5696","Z24256",1652,276,42,234,"14.2"
"5697","Z24258",940,130,92,38," 4.0"
"5698","Z24260",2676,368,94,274,"10.2"
"5699","Z24263",3106,600,344,256," 8.2"
"5700","Z24266",4227,634,136,498,"11.8"
"5701","Z24271",1444,389,206,183,"12.7"
"5702","Z24273",3009,148,70,78," 2.6"
"5703","Z24277",2742,511,398,113," 4.1"
"5704","Z24279",2072,263,206,57," 2.8"
"5705","Z24280",309,11,0,11," 3.6"
"5706","Z24281",1289,260,189,71," 5.5"
"5707","Z24282",368,103,97,6," 1.6"
"5708","Z24283",947,118,60,58," 6.1"
"5709","Z24290",976,119,53,66," 6.8"
"5710","Z24292",335,104,49,55,"16.4"
"5711","Z24293",4564,687,426,261," 5.7"
"5712","Z24301",7162,1237,100,1137,"15.9"
"5713","Z24311",901,121,0,121,"13.4"
"5714","Z24312",1117,190,80,110," 9.8"
"5715","Z24313",347,17,0,17," 4.9"
"5716","Z24314",798,149,137,12," 1.5"
"5717","Z24317",1995,406,144,262,"13.1"
"5718","Z24319",3253,548,82,466,"14.3"
"5719","Z24323",331,46,14,32," 9.7"
"5720","Z24324",989,162,81,81," 8.2"
"5721","Z24325",568,202,97,105,"18.5"
"5722","Z24328",1563,751,528,223,"14.3"
"5723","Z24330",1818,422,150,272,"15.0"
"5724","Z24333",9120,1722,472,1250,"13.7"
"5725","Z24340",2508,339,25,314,"12.5"
"5726","Z24343",5153,1282,538,744,"14.4"
"5727","Z24348",2386,567,233,334,"14.0"
"5728","Z24350",869,378,126,252,"29.0"
"5729","Z24352",514,130,72,58,"11.3"
"5730","Z24354",7334,1135,257,878,"12.0"
"5731","Z24360",2624,382,43,339,"12.9"
"5732","Z24361",2174,238,65,173," 8.0"
"5733","Z24363",919,345,236,109,"11.9"
"5734","Z24366",346,96,22,74,"21.4"
"5735","Z24368",2275,266,48,218," 9.6"
"5736","Z24370",3106,544,58,486,"15.6"
"5737","Z24374",396,118,9,109,"27.5"
"5738","Z24375",977,387,195,192,"19.7"
"5739","Z24380",1269,271,139,132,"10.4"
"5740","Z24381",2122,356,130,226,"10.7"
"5741","Z24382",7270,1076,164,912,"12.5"
"5742","Z24401",16903,1893,275,1618," 9.6"
"5743","Z24413",97,38,33,5," 5.2"
"5744","Z24416",3720,246,0,246," 6.6"
"5745","Z24421",1807,158,119,39," 2.2"
"5746","Z24422",3228,563,263,300," 9.3"
"5747","Z24426",7184,1164,426,738,"10.3"
"5748","Z24430",836,156,0,156,"18.7"
"5749","Z24431",1028,114,33,81," 7.9"
"5750","Z24437",499,43,0,43," 8.6"
"5751","Z24439",813,302,210,92,"11.3"
"5752","Z24441",2838,252,19,233," 8.2"
"5753","Z24442",200,142,110,32,"16.0"
"5754","Z24445",1749,589,328,261,"14.9"
"5755","Z24450",6635,955,273,682,"10.3"
"5756","Z24458",340,128,128,0," 0.0"
"5757","Z24459",357,92,71,21," 5.9"
"5758","Z24464",182,64,64,0," 0.0"
"5759","Z24465",1066,392,328,64," 6.0"
"5760","Z24471",599,80,32,48," 8.0"
"5761","Z24472",1133,280,50,230,"20.3"
"5762","Z24474",199,27,27,0," 0.0"
"5763","Z24477",4590,465,54,411," 9.0"
"5764","Z24479",628,144,56,88,"14.0"
"5765","Z24482",1922,172,0,172," 8.9"
"5766","Z24483",427,168,168,0," 0.0"
"5767","Z24484",663,182,175,7," 1.1"
"5768","Z24486",1517,27,0,27," 1.8"
"5769","Z24501",11931,1627,103,1524,"12.8"
"5770","Z24502",17678,1306,115,1191," 6.7"
"5771","Z24504",4657,801,56,745,"16.0"
"5772","Z24517",2749,540,159,381,"13.9"
"5773","Z24521",4788,626,253,373," 7.8"
"5774","Z24522",4390,530,102,428," 9.7"
"5775","Z24523",8809,854,152,702," 8.0"
"5776","Z24527",1456,249,38,211,"14.5"
"5777","Z24528",1676,360,63,297,"17.7"
"5778","Z24529",904,238,165,73," 8.1"
"5779","Z24531",4501,975,80,895,"19.9"
"5780","Z24534",967,292,46,246,"25.4"
"5781","Z24538",2196,391,66,325,"14.8"
"5782","Z24540",15772,2307,37,2270,"14.4"
"5783","Z24541",14740,2410,122,2288,"15.5"
"5784","Z24549",1921,163,0,163," 8.5"
"5785","Z24550",3292,319,0,319," 9.7"
"5786","Z24551",8811,297,8,289," 3.3"
"5787","Z24553",919,157,78,79," 8.6"
"5788","Z24555",1093,82,30,52," 4.8"
"5789","Z24556",1448,177,0,177,"12.2"
"5790","Z24557",4172,760,219,541,"13.0"
"5791","Z24558",3319,550,212,338,"10.2"
"5792","Z24562",241,108,47,61,"25.3"
"5793","Z24563",2714,240,17,223," 8.2"
"5794","Z24565",636,206,25,181,"28.5"
"5795","Z24566",515,54,0,54,"10.5"
"5796","Z24569",533,121,33,88,"16.5"
"5797","Z24571",980,158,86,72," 7.3"
"5798","Z24572",6913,597,56,541," 7.8"
"5799","Z24574",1938,272,156,116," 6.0"
"5800","Z24577",2800,772,219,553,"19.8"
"5801","Z24578",487,69,34,35," 7.2"
"5802","Z24579",770,69,51,18," 2.3"
"5803","Z24586",2629,412,18,394,"15.0"
"5804","Z24588",3965,704,51,653,"16.5"
"5805","Z24589",1043,186,23,163,"15.6"
"5806","Z24590",3659,391,112,279," 7.6"
"5807","Z24592",6860,1218,220,998,"14.5"
"5808","Z24593",1007,347,48,299,"29.7"
"5809","Z24594",850,247,81,166,"19.5"
"5810","Z24597",531,45,11,34," 6.4"
"5811","Z24598",919,218,100,118,"12.8"
"5812","Z24603",447,43,0,43," 9.6"
"5813","Z24605",4248,441,9,432,"10.2"
"5814","Z24607",189,31,21,10," 5.3"
"5815","Z24609",3578,477,113,364,"10.2"
"5816","Z24614",3888,744,51,693,"17.8"
"5817","Z24620",1524,220,0,220,"14.4"
"5818","Z24622",420,68,8,60,"14.3"
"5819","Z24630",3124,312,95,217," 6.9"
"5820","Z24631",1035,311,0,311,"30.0"
"5821","Z24637",1613,177,26,151," 9.4"
"5822","Z24639",1710,327,28,299,"17.5"
"5823","Z24641",3007,466,34,432,"14.4"
"5824","Z24646",311,64,11,53,"17.0"
"5825","Z24651",2858,452,109,343,"12.0"
"5826","Z24656",1643,281,24,257,"15.6"
"5827","Z24701",10480,1879,220,1659,"15.8"
"5828","Z24712",758,148,26,122,"16.1"
"5829","Z24715",312,136,31,105,"33.7"
"5830","Z24731",133,36,0,36,"27.1"
"5831","Z24733",414,79,30,49,"11.8"
"5832","Z24740",14445,1449,206,1243," 8.6"
"5833","Z24801",1840,307,27,280,"15.2"
"5834","Z24817",398,88,14,74,"18.6"
"5835","Z24818",541,134,13,121,"22.4"
"5836","Z24827",691,53,0,53," 7.7"
"5837","Z24828",449,112,4,108,"24.1"
"5838","Z24836",331,143,13,130,"39.3"
"5839","Z24839",713,48,10,38," 5.3"
"5840","Z24844",1025,171,16,155,"15.1"
"5841","Z24845",203,58,0,58,"28.6"
"5842","Z24849",204,61,21,40,"19.6"
"5843","Z24868",922,417,87,330,"35.8"
"5844","Z24870",1329,208,16,192,"14.4"
"5845","Z24874",1450,226,0,226,"15.6"
"5846","Z24892",856,246,8,238,"27.8"
"5847","Z24901",4671,480,129,351," 7.5"
"5848","Z24910",2522,615,263,352,"14.0"
"5849","Z24916",292,12,0,12," 4.1"
"5850","Z24918",814,255,73,182,"22.4"
"5851","Z24925",427,116,66,50,"11.7"
"5852","Z24931",566,70,11,59,"10.4"
"5853","Z24934",427,232,189,43,"10.1"
"5854","Z24938",770,70,18,52," 6.8"
"5855","Z24941",926,382,259,123,"13.3"
"5856","Z24944",406,230,215,15," 3.7"
"5857","Z24945",195,43,30,13," 6.7"
"5858","Z24946",1023,404,269,135,"13.2"
"5859","Z24951",701,124,29,95,"13.6"
"5860","Z24954",2711,1088,846,242," 8.9"
"5861","Z24957",188,25,25,0," 0.0"
"5862","Z24963",2057,267,63,204," 9.9"
"5863","Z24966",882,258,198,60," 6.8"
"5864","Z24970",2280,285,53,232,"10.2"
"5865","Z24976",491,36,10,26," 5.3"
"5866","Z24981",570,194,160,34," 6.0"
"5867","Z24983",1447,341,98,243,"16.8"
"5868","Z24986",3595,1259,891,368,"10.2"
"5869","Z25003",1330,152,0,152,"11.4"
"5870","Z25009",563,119,0,119,"21.1"
"5871","Z25015",1986,106,12,94," 4.7"
"5872","Z25031",409,46,0,46,"11.2"
"5873","Z25035",596,67,0,67,"11.2"
"5874","Z25039",459,69,0,69,"15.0"
"5875","Z25043",902,204,132,72," 8.0"
"5876","Z25045",2626,403,108,295,"11.2"
"5877","Z25053",1871,217,64,153," 8.2"
"5878","Z25064",5061,620,93,527,"10.4"
"5879","Z25070",864,98,0,98,"11.3"
"5880","Z25071",5388,474,73,401," 7.4"
"5881","Z25082",685,141,10,131,"19.1"
"5882","Z25085",461,111,10,101,"21.9"
"5883","Z25086",313,49,12,37,"11.8"
"5884","Z25113",486,150,82,68,"14.0"
"5885","Z25118",442,78,0,78,"17.6"
"5886","Z25123",1654,205,54,151," 9.1"
"5887","Z25136",960,236,0,236,"24.6"
"5888","Z25143",4053,495,0,495,"12.2"
"5889","Z25156",81,19,0,19,"23.5"
"5890","Z25159",2310,139,20,119," 5.2"
"5891","Z25165",275,32,0,32,"11.6"
"5892","Z25168",998,100,39,61," 6.1"
"5893","Z25177",11356,907,12,895," 7.9"
"5894","Z25181",777,143,0,143,"18.4"
"5895","Z25186",510,97,0,97,"19.0"
"5896","Z25208",448,56,15,41," 9.2"
"5897","Z25209",663,98,12,86,"13.0"
"5898","Z25213",2344,56,0,56," 2.4"
"5899","Z25214",219,42,20,22,"10.0"
"5900","Z25234",707,156,27,129,"18.2"
"5901","Z25248",1414,299,81,218,"15.4"
"5902","Z25252",753,276,145,131,"17.4"
"5903","Z25262",455,26,0,26," 5.7"
"5904","Z25267",434,133,76,57,"13.1"
"5905","Z25270",422,67,44,23," 5.5"
"5906","Z25271",4222,460,125,335," 7.9"
"5907","Z25275",853,182,51,131,"15.4"
"5908","Z25276",3862,707,181,526,"13.6"
"5909","Z25285",258,44,13,31,"12.0"
"5910","Z25286",876,251,104,147,"16.8"
"5911","Z25301",1716,222,40,182,"10.6"
"5912","Z25302",8084,1247,78,1169,"14.5"
"5913","Z25303",3513,251,18,233," 6.6"
"5914","Z25304",4266,442,9,433,"10.2"
"5915","Z25306",3210,486,8,478,"14.9"
"5916","Z25309",6160,477,29,448," 7.3"
"5917","Z25311",5747,844,106,738,"12.8"
"5918","Z25312",7227,939,44,895,"12.4"
"5919","Z25313",5843,616,65,551," 9.4"
"5920","Z25314",7041,411,0,411," 5.8"
"5921","Z25315",1676,261,9,252,"15.0"
"5922","Z25320",2832,241,73,168," 5.9"
"5923","Z25401",6726,984,47,937,"13.9"
"5924","Z25403",5136,228,121,107," 2.1"
"5925","Z25404",9153,873,206,667," 7.3"
"5926","Z25405",4893,194,69,125," 2.6"
"5927","Z25411",6741,1362,757,605," 9.0"
"5928","Z25413",3352,276,19,257," 7.7"
"5929","Z25414",7136,438,113,325," 4.6"
"5930","Z25419",4252,460,251,209," 4.9"
"5931","Z25425",5702,705,358,347," 6.1"
"5932","Z25427",6539,1610,1189,421," 6.4"
"5933","Z25428",4398,254,9,245," 5.6"
"5934","Z25430",3145,184,45,139," 4.4"
"5935","Z25431",219,61,55,6," 2.7"
"5936","Z25434",1741,609,439,170," 9.8"
"5937","Z25438",2875,270,23,247," 8.6"
"5938","Z25442",676,76,0,76,"11.2"
"5939","Z25443",2972,387,100,287," 9.7"
"5940","Z25444",267,107,50,57,"21.3"
"5941","Z25504",5551,478,0,478," 8.6"
"5942","Z25506",2106,315,45,270,"12.8"
"5943","Z25507",462,96,0,96,"20.8"
"5944","Z25508",4505,623,145,478,"10.6"
"5945","Z25510",2272,348,74,274,"12.1"
"5946","Z25514",1761,321,0,321,"18.2"
"5947","Z25515",1179,241,0,241,"20.4"
"5948","Z25520",643,119,20,99,"15.4"
"5949","Z25523",1320,212,48,164,"12.4"
"5950","Z25524",1641,497,108,389,"23.7"
"5951","Z25526",9227,713,30,683," 7.4"
"5952","Z25529",391,21,0,21," 5.4"
"5953","Z25530",2581,303,0,303,"11.7"
"5954","Z25535",1222,98,0,98," 8.0"
"5955","Z25537",867,90,40,50," 5.8"
"5956","Z25541",3862,346,46,300," 7.8"
"5957","Z25545",2054,136,0,136," 6.6"
"5958","Z25550",4385,585,41,544,"12.4"
"5959","Z25555",968,218,0,218,"22.5"
"5960","Z25559",851,177,0,177,"20.8"
"5961","Z25560",3430,290,13,277," 8.1"
"5962","Z25570",2961,338,79,259," 8.7"
"5963","Z25571",1012,229,9,220,"21.7"
"5964","Z25573",497,41,0,41," 8.2"
"5965","Z25601",2484,501,59,442,"17.8"
"5966","Z25617",377,87,24,63,"16.7"
"5967","Z25621",963,100,21,79," 8.2"
"5968","Z25625",562,98,23,75,"13.3"
"5969","Z25635",592,35,0,35," 5.9"
"5970","Z25637",434,95,12,83,"19.1"
"5971","Z25646",503,61,0,61,"12.1"
"5972","Z25652",546,88,0,88,"16.1"
"5973","Z25653",258,63,0,63,"24.4"
"5974","Z25661",3279,585,65,520,"15.9"
"5975","Z25670",2730,405,70,335,"12.3"
"5976","Z25671",611,85,34,51," 8.3"
"5977","Z25674",1315,165,25,140,"10.6"
"5978","Z25676",571,109,0,109,"19.1"
"5979","Z25701",12461,1951,61,1890,"15.2"
"5980","Z25702",3811,626,26,600,"15.7"
"5981","Z25703",2702,561,14,547,"20.2"
"5982","Z25704",8147,1100,18,1082,"13.3"
"5983","Z25705",10469,1283,99,1184,"11.3"
"5984","Z25801",16063,1676,246,1430," 8.9"
"5985","Z25812",974,235,13,222,"22.8"
"5986","Z25813",2964,533,105,428,"14.4"
"5987","Z25818",196,53,0,53,"27.0"
"5988","Z25825",1190,150,43,107," 9.0"
"5989","Z25827",1125,105,0,105," 9.3"
"5990","Z25832",1690,68,29,39," 2.3"
"5991","Z25839",230,18,0,18," 7.8"
"5992","Z25840",3803,563,68,495,"13.0"
"5993","Z25841",314,59,12,47,"15.0"
"5994","Z25843",592,231,192,39," 6.6"
"5995","Z25844",672,135,48,87,"12.9"
"5996","Z25854",580,164,87,77,"13.3"
"5997","Z25871",296,54,12,42,"14.2"
"5998","Z25878",471,39,0,39," 8.3"
"5999","Z25880",3019,447,24,423,"14.0"
"6000","Z25882",1206,216,9,207,"17.2"
"6001","Z25901",5422,649,56,593,"10.9"
"6002","Z25918",2088,278,100,178," 8.5"
"6003","Z25921",1003,124,26,98," 9.8"
"6004","Z25938",511,53,26,27," 5.3"
"6005","Z25951",3527,794,238,556,"15.8"
"6006","Z25958",468,151,21,130,"27.8"
"6007","Z25962",1925,379,24,355,"18.4"
"6008","Z25969",539,135,50,85,"15.8"
"6009","Z25971",694,257,200,57," 8.2"
"6010","Z25976",1440,408,121,287,"19.9"
"6011","Z25979",444,143,100,43," 9.7"
"6012","Z25984",900,199,43,156,"17.3"
"6013","Z26003",20709,2556,212,2344,"11.3"
"6014","Z26030",289,44,13,31,"10.7"
"6015","Z26031",916,144,0,144,"15.7"
"6016","Z26034",2400,379,14,365,"15.2"
"6017","Z26035",1124,101,0,101," 9.0"
"6018","Z26037",3016,238,26,212," 7.0"
"6019","Z26038",1399,148,0,148,"10.6"
"6020","Z26040",973,136,0,136,"14.0"
"6021","Z26041",7431,803,120,683," 9.2"
"6022","Z26047",2851,305,42,263," 9.2"
"6023","Z26050",765,126,0,126,"16.5"
"6024","Z26055",1011,213,25,188,"18.6"
"6025","Z26059",1246,220,0,220,"17.7"
"6026","Z26060",850,58,4,54," 6.4"
"6027","Z26062",10286,823,99,724," 7.0"
"6028","Z26070",4035,386,42,344," 8.5"
"6029","Z26074",241,13,0,13," 5.4"
"6030","Z26101",14543,2020,113,1907,"13.1"
"6031","Z26104",8086,740,50,690," 8.5"
"6032","Z26105",5534,292,15,277," 5.0"
"6033","Z26133",623,37,28,9," 1.4"
"6034","Z26134",427,27,0,27," 6.3"
"6035","Z26142",1038,49,0,49," 4.7"
"6036","Z26143",2449,580,350,230," 9.4"
"6037","Z26146",640,220,132,88,"13.8"
"6038","Z26147",1203,210,42,168,"14.0"
"6039","Z26149",1416,381,177,204,"14.4"
"6040","Z26150",2610,194,0,194," 7.4"
"6041","Z26155",4381,950,205,745,"17.0"
"6042","Z26159",1260,108,3,105," 8.3"
"6043","Z26160",521,82,12,70,"13.4"
"6044","Z26164",3771,605,66,539,"14.3"
"6045","Z26169",354,77,28,49,"13.8"
"6046","Z26170",2640,394,78,316,"12.0"
"6047","Z26175",1656,298,131,167,"10.1"
"6048","Z26178",312,104,79,25," 8.0"
"6049","Z26180",1121,112,26,86," 7.7"
"6050","Z26181",2677,208,72,136," 5.1"
"6051","Z26184",928,126,35,91," 9.8"
"6052","Z26187",2705,223,37,186," 6.9"
"6053","Z26201",8701,1190,621,569," 6.5"
"6054","Z26202",351,122,52,70,"19.9"
"6055","Z26205",1507,213,29,184,"12.2"
"6056","Z26206",1698,405,164,241,"14.2"
"6057","Z26209",2106,1988,1760,228,"10.8"
"6058","Z26215",98,35,0,35,"35.7"
"6059","Z26218",1242,219,159,60," 4.8"
"6060","Z26222",253,86,49,37,"14.6"
"6061","Z26237",261,73,50,23," 8.8"
"6062","Z26238",465,131,101,30," 6.5"
"6063","Z26241",6942,769,131,638," 9.2"
"6064","Z26250",2113,373,160,213,"10.1"
"6065","Z26253",1605,220,60,160,"10.0"
"6066","Z26254",233,72,60,12," 5.2"
"6067","Z26260",2104,1523,1243,280,"13.3"
"6068","Z26261",1687,542,211,331,"19.6"
"6069","Z26263",356,234,223,11," 3.1"
"6070","Z26264",442,176,156,20," 4.5"
"6071","Z26270",527,203,77,126,"23.9"
"6072","Z26275",328,78,33,45,"13.7"
"6073","Z26280",897,145,52,93,"10.4"
"6074","Z26283",955,309,226,83," 8.7"
"6075","Z26285",210,10,0,10," 4.8"
"6076","Z26287",1690,386,301,85," 5.0"
"6077","Z26288",2354,655,343,312,"13.3"
"6078","Z26291",81,56,56,0," 0.0"
"6079","Z26292",480,141,54,87,"18.1"
"6080","Z26293",272,30,11,19," 7.0"
"6081","Z26301",14012,1718,80,1638,"11.7"
"6082","Z26323",218,56,0,56,"25.7"
"6083","Z26330",6283,486,66,420," 6.7"
"6084","Z26338",317,40,27,13," 4.1"
"6085","Z26342",227,92,52,40,"17.6"
"6086","Z26351",1505,234,57,177,"11.8"
"6087","Z26354",4926,541,185,356," 7.2"
"6088","Z26362",1872,560,279,281,"15.0"
"6089","Z26372",467,99,59,40," 8.6"
"6090","Z26374",618,117,44,73,"11.8"
"6091","Z26378",1707,213,59,154," 9.0"
"6092","Z26384",374,10,0,10," 2.7"
"6093","Z26385",1706,255,91,164," 9.6"
"6094","Z26386",1050,152,0,152,"14.5"
"6095","Z26408",1295,193,19,174,"13.4"
"6096","Z26415",1900,477,149,328,"17.3"
"6097","Z26416",3677,750,400,350," 9.5"
"6098","Z26419",576,148,59,89,"15.5"
"6099","Z26425",667,152,56,96,"14.4"
"6100","Z26426",3174,517,103,414,"13.0"
"6101","Z26430",187,65,4,61,"32.6"
"6102","Z26431",2792,401,26,375,"13.4"
"6103","Z26436",66,23,0,23,"34.8"
"6104","Z26437",346,124,19,105,"30.3"
"6105","Z26440",502,75,11,64,"12.7"
"6106","Z26444",1614,168,87,81," 5.0"
"6107","Z26447",595,55,44,11," 1.8"
"6108","Z26448",572,135,22,113,"19.8"
"6109","Z26451",342,43,3,40,"11.7"
"6110","Z26452",4528,914,233,681,"15.0"
"6111","Z26456",1914,643,325,318,"16.6"
"6112","Z26501",8977,1228,182,1046,"11.7"
"6113","Z26505",17683,3601,872,2729,"15.4"
"6114","Z26508",13184,1569,397,1172," 8.9"
"6115","Z26520",378,40,0,40,"10.6"
"6116","Z26521",115,29,0,29,"25.2"
"6117","Z26525",2552,364,178,186," 7.3"
"6118","Z26534",1030,235,15,220,"21.4"
"6119","Z26537",2587,328,84,244," 9.4"
"6120","Z26541",1229,209,114,95," 7.7"
"6121","Z26542",1077,170,2,168,"15.6"
"6122","Z26547",1073,88,12,76," 7.1"
"6123","Z26554",19616,2794,409,2385,"12.2"
"6124","Z26562",277,71,22,49,"17.7"
"6125","Z26568",289,35,0,35,"12.1"
"6126","Z26571",877,83,21,62," 7.1"
"6127","Z26575",433,117,42,75,"17.3"
"6128","Z26587",229,49,26,23,"10.0"
"6129","Z26591",574,39,12,27," 4.7"
"6130","Z26601",2388,557,187,370,"15.5"
"6131","Z26621",397,51,49,2," 0.5"
"6132","Z26623",604,90,36,54," 8.9"
"6133","Z26624",1500,298,100,198,"13.2"
"6134","Z26651",4971,702,364,338," 6.8"
"6135","Z26676",290,40,0,40,"13.8"
"6136","Z26678",560,84,59,25," 4.5"
"6137","Z26679",1140,260,202,58," 5.1"
"6138","Z26681",663,72,60,12," 1.8"
"6139","Z26684",50,13,0,13,"26.0"
"6140","Z26704",2740,409,192,217," 7.9"
"6141","Z26710",1100,147,98,49," 4.5"
"6142","Z26711",1376,333,232,101," 7.3"
"6143","Z26719",1410,225,36,189,"13.4"
"6144","Z26726",6014,895,184,711,"11.8"
"6145","Z26739",640,387,330,57," 8.9"
"6146","Z26743",837,256,84,172,"20.5"
"6147","Z26750",424,82,2,80,"18.9"
"6148","Z26753",2861,255,47,208," 7.3"
"6149","Z26757",3409,919,378,541,"15.9"
"6150","Z26761",294,37,11,26," 8.8"
"6151","Z26763",1098,304,248,56," 5.1"
"6152","Z26764",2227,679,423,256,"11.5"
"6153","Z26767",295,61,13,48,"16.3"
"6154","Z26801",723,274,255,19," 2.6"
"6155","Z26802",855,330,315,15," 1.8"
"6156","Z26804",421,153,153,0," 0.0"
"6157","Z26807",1815,679,626,53," 2.9"
"6158","Z26812",1187,532,441,91," 7.7"
"6159","Z26814",263,84,77,7," 2.7"
"6160","Z26815",486,199,199,0," 0.0"
"6161","Z26818",328,54,0,54,"16.5"
"6162","Z26833",1002,298,216,82," 8.2"
"6163","Z26836",3478,1005,531,474,"13.6"
"6164","Z26845",338,139,69,70,"20.7"
"6165","Z26847",3357,931,484,447,"13.3"
"6166","Z26851",1340,555,399,156,"11.6"
"6167","Z26855",490,249,225,24," 4.9"
"6168","Z26865",220,104,104,0," 0.0"
"6169","Z26884",504,212,201,11," 2.2"
"6170","Z27006",6340,792,113,679,"10.7"
"6171","Z27007",855,28,0,28," 3.3"
"6172","Z27009",1156,153,0,153,"13.2"
"6173","Z27011",2524,270,29,241," 9.5"
"6174","Z27012",11051,1010,44,966," 8.7"
"6175","Z27013",2773,333,15,318,"11.5"
"6176","Z27016",889,225,64,161,"18.1"
"6177","Z27017",4104,558,144,414,"10.1"
"6178","Z27018",3450,375,19,356,"10.3"
"6179","Z27019",2055,341,83,258,"12.6"
"6180","Z27020",2840,252,74,178," 6.3"
"6181","Z27021",7701,626,54,572," 7.4"
"6182","Z27022",762,137,40,97,"12.7"
"6183","Z27023",5319,416,22,394," 7.4"
"6184","Z27024",1388,297,111,186,"13.4"
"6185","Z27025",4907,591,67,524,"10.7"
"6186","Z27027",2209,373,32,341,"15.4"
"6187","Z27028",11225,1412,222,1190,"10.6"
"6188","Z27030",17741,2201,203,1998,"11.3"
"6189","Z27040",4689,269,0,269," 5.7"
"6190","Z27041",3625,394,30,364,"10.0"
"6191","Z27043",3044,354,66,288," 9.5"
"6192","Z27045",3856,314,11,303," 7.9"
"6193","Z27046",1114,200,81,119,"10.7"
"6194","Z27048",3873,408,37,371," 9.6"
"6195","Z27050",1704,166,0,166," 9.7"
"6196","Z27051",3456,394,26,368,"10.6"
"6197","Z27052",4888,556,90,466," 9.5"
"6198","Z27053",1448,279,61,218,"15.1"
"6199","Z27054",999,221,0,221,"22.1"
"6200","Z27055",6304,772,40,732,"11.6"
"6201","Z27101",9868,1326,34,1292,"13.1"
"6202","Z27103",17386,1306,151,1155," 6.6"
"6203","Z27104",14186,1370,110,1260," 8.9"
"6204","Z27105",17383,2872,131,2741,"15.8"
"6205","Z27106",21415,2200,91,2109," 9.8"
"6206","Z27107",19153,2350,44,2306,"12.0"
"6207","Z27127",16102,1444,80,1364," 8.5"
"6208","Z27203",9764,1253,39,1214,"12.4"
"6209","Z27205",14222,1556,133,1423,"10.0"
"6210","Z27207",1449,62,8,54," 3.7"
"6211","Z27208",777,49,0,49," 6.3"
"6212","Z27209",1436,178,11,167,"11.6"
"6213","Z27212",570,51,9,42," 7.4"
"6214","Z27214",4724,567,44,523,"11.1"
"6215","Z27215",19119,1600,50,1550," 8.1"
"6216","Z27217",15539,1853,31,1822,"11.7"
"6217","Z27229",1533,263,97,166,"10.8"
"6218","Z27231",877,157,36,121,"13.8"
"6219","Z27233",1411,146,41,105," 7.4"
"6220","Z27235",1703,10,0,10," 0.6"
"6221","Z27239",4018,715,166,549,"13.7"
"6222","Z27242",836,155,0,155,"18.5"
"6223","Z27243",1914,172,42,130," 6.8"
"6224","Z27244",4826,457,74,383," 7.9"
"6225","Z27249",5482,362,94,268," 4.9"
"6226","Z27252",1122,145,0,145,"12.9"
"6227","Z27253",13056,1078,77,1001," 7.7"
"6228","Z27258",2794,222,16,206," 7.4"
"6229","Z27260",10625,1839,71,1768,"16.6"
"6230","Z27262",9933,1387,107,1280,"12.9"
"6231","Z27263",9280,665,34,631," 6.8"
"6232","Z27265",21287,1727,129,1598," 7.5"
"6233","Z27278",10191,773,64,709," 7.0"
"6234","Z27281",1437,240,162,78," 5.4"
"6235","Z27282",6829,378,0,378," 5.5"
"6236","Z27283",1390,151,0,151,"10.9"
"6237","Z27284",22653,1702,116,1586," 7.0"
"6238","Z27288",11715,1988,385,1603,"13.7"
"6239","Z27291",1067,449,345,104," 9.7"
"6240","Z27292",17790,2634,919,1715," 9.6"
"6241","Z27295",16448,1521,13,1508," 9.2"
"6242","Z27298",4586,550,0,550,"12.0"
"6243","Z27301",3517,229,9,220," 6.3"
"6244","Z27302",12668,1231,142,1089," 8.6"
"6245","Z27305",874,151,69,82," 9.4"
"6246","Z27306",4703,2063,1622,441," 9.4"
"6247","Z27310",2523,137,0,137," 5.4"
"6248","Z27311",1754,304,92,212,"12.1"
"6249","Z27312",8804,575,72,503," 5.7"
"6250","Z27313",2788,216,0,216," 7.7"
"6251","Z27314",568,57,0,57,"10.0"
"6252","Z27315",1020,128,0,128,"12.5"
"6253","Z27316",3057,553,28,525,"17.2"
"6254","Z27317",7177,861,101,760,"10.6"
"6255","Z27320",18179,2339,512,1827,"10.1"
"6256","Z27325",3041,638,28,610,"20.1"
"6257","Z27326",1600,252,76,176,"11.0"
"6258","Z27330",15891,1880,111,1769,"11.1"
"6259","Z27332",12692,1833,356,1477,"11.6"
"6260","Z27341",2559,312,52,260,"10.2"
"6261","Z27344",7604,1020,28,992,"13.0"
"6262","Z27349",2674,240,24,216," 8.1"
"6263","Z27350",2753,141,0,141," 5.1"
"6264","Z27355",1050,102,45,57," 5.4"
"6265","Z27356",1935,403,14,389,"20.1"
"6266","Z27357",3313,450,68,382,"11.5"
"6267","Z27358",5593,314,70,244," 4.4"
"6268","Z27360",20853,2493,115,2378,"11.4"
"6269","Z27371",3922,602,294,308," 7.9"
"6270","Z27376",4725,1062,644,418," 8.8"
"6271","Z27377",3688,481,67,414,"11.2"
"6272","Z27379",2278,301,74,227,"10.0"
"6273","Z27401",8927,1440,54,1386,"15.5"
"6274","Z27403",9146,1240,101,1139,"12.5"
"6275","Z27405",20997,2891,53,2838,"13.5"
"6276","Z27406",25607,2651,36,2615,"10.2"
"6277","Z27407",22307,2562,28,2534,"11.4"
"6278","Z27408",8896,690,0,690," 7.8"
"6279","Z27409",8793,825,54,771," 8.8"
"6280","Z27410",25176,1360,44,1316," 5.2"
"6281","Z27455",13074,1143,88,1055," 8.1"
"6282","Z27501",7304,742,295,447," 6.1"
"6283","Z27502",12250,555,7,548," 4.5"
"6284","Z27503",1288,94,0,94," 7.3"
"6285","Z27504",6302,1039,187,852,"13.5"
"6286","Z27505",2505,306,35,271,"10.8"
"6287","Z27507",894,321,188,133,"14.9"
"6288","Z27508",626,58,3,55," 8.8"
"6289","Z27510",7434,502,14,488," 6.6"
"6290","Z27511",14007,852,68,784," 5.6"
"6291","Z27513",17624,942,92,850," 4.8"
"6292","Z27514",11560,947,19,928," 8.0"
"6293","Z27516",15330,1266,122,1144," 7.5"
"6294","Z27517",11544,902,195,707," 6.1"
"6295","Z27518",8593,336,34,302," 3.5"
"6296","Z27519",16801,645,27,618," 3.7"
"6297","Z27520",15170,1041,254,787," 5.2"
"6298","Z27521",2561,277,42,235," 9.2"
"6299","Z27522",4930,561,51,510,"10.3"
"6300","Z27523",4277,175,0,175," 4.1"
"6301","Z27524",5048,728,86,642,"12.7"
"6302","Z27526",16154,1009,148,861," 5.3"
"6303","Z27527",6794,483,82,401," 5.9"
"6304","Z27529",17909,1262,301,961," 5.4"
"6305","Z27530",17620,2090,70,2020,"11.5"
"6306","Z27534",14211,1041,113,928," 6.5"
"6307","Z27536",7430,1291,295,996,"13.4"
"6308","Z27537",10966,1875,867,1008," 9.2"
"6309","Z27539",7961,475,15,460," 5.8"
"6310","Z27540",11625,599,19,580," 5.0"
"6311","Z27541",1734,153,9,144," 8.3"
"6312","Z27542",3960,647,154,493,"12.4"
"6313","Z27544",2004,184,34,150," 7.5"
"6314","Z27545",9411,503,35,468," 5.0"
"6315","Z27546",7387,930,129,801,"10.8"
"6316","Z27549",11400,1939,432,1507,"13.2"
"6317","Z27551",1533,692,543,149," 9.7"
"6318","Z27553",1050,448,208,240,"22.9"
"6319","Z27555",269,36,0,36,"13.4"
"6320","Z27557",2764,300,84,216," 7.8"
"6321","Z27559",1024,149,10,139,"13.6"
"6322","Z27560",11323,1054,4,1050," 9.3"
"6323","Z27562",816,149,0,149,"18.3"
"6324","Z27563",2412,310,161,149," 6.2"
"6325","Z27565",10836,1293,347,946," 8.7"
"6326","Z27568",301,41,0,41,"13.6"
"6327","Z27569",3150,308,80,228," 7.2"
"6328","Z27571",1939,230,6,224,"11.6"
"6329","Z27572",3298,290,42,248," 7.5"
"6330","Z27573",5046,713,118,595,"11.8"
"6331","Z27574",6509,842,240,602," 9.2"
"6332","Z27576",6988,1011,17,994,"14.2"
"6333","Z27577",9645,1251,177,1074,"11.1"
"6334","Z27582",93,26,6,20,"21.5"
"6335","Z27583",2814,307,0,307,"10.9"
"6336","Z27587",22085,1312,81,1231," 5.6"
"6337","Z27589",3863,861,473,388,"10.0"
"6338","Z27591",7783,697,109,588," 7.6"
"6339","Z27592",5826,470,18,452," 7.8"
"6340","Z27596",6403,470,47,423," 6.6"
"6341","Z27597",9342,979,194,785," 8.4"
"6342","Z27601",4094,653,15,638,"15.6"
"6343","Z27603",20607,1532,117,1415," 6.9"
"6344","Z27604",18410,1162,53,1109," 6.0"
"6345","Z27605",3121,382,74,308," 9.9"
"6346","Z27606",19161,1437,71,1366," 7.1"
"6347","Z27607",8937,562,0,562," 6.3"
"6348","Z27608",5290,475,0,475," 9.0"
"6349","Z27609",16658,2082,110,1972,"11.8"
"6350","Z27610",25731,1483,37,1446," 5.6"
"6351","Z27612",18858,2007,94,1913,"10.1"
"6352","Z27613",19613,1583,0,1583," 8.1"
"6353","Z27614",13171,929,69,860," 6.5"
"6354","Z27615",19345,1567,70,1497," 7.7"
"6355","Z27616",18236,815,0,815," 4.5"
"6356","Z27617",8874,952,168,784," 8.8"
"6357","Z27701",10494,1348,108,1240,"11.8"
"6358","Z27703",19088,1820,101,1719," 9.0"
"6359","Z27704",15402,1360,17,1343," 8.7"
"6360","Z27705",21107,1437,9,1428," 6.8"
"6361","Z27707",22001,1833,84,1749," 7.9"
"6362","Z27709",363,18,18,0," 0.0"
"6363","Z27712",8417,251,17,234," 2.8"
"6364","Z27713",22485,1070,99,971," 4.3"
"6365","Z27801",9995,1904,56,1848,"18.5"
"6366","Z27803",9097,1195,104,1091,"12.0"
"6367","Z27804",13408,1620,127,1493,"11.1"
"6368","Z27805",1812,428,118,310,"17.1"
"6369","Z27806",1536,613,298,315,"20.5"
"6370","Z27807",2749,252,0,252," 9.2"
"6371","Z27808",1620,683,482,201,"12.4"
"6372","Z27809",1991,254,0,254,"12.8"
"6373","Z27810",2920,1263,702,561,"19.2"
"6374","Z27812",1434,198,33,165,"11.5"
"6375","Z27813",290,22,0,22," 7.6"
"6376","Z27814",1493,733,519,214,"14.3"
"6377","Z27817",3385,848,386,462,"13.6"
"6378","Z27818",783,181,12,169,"21.6"
"6379","Z27820",1543,317,177,140," 9.1"
"6380","Z27822",3696,352,0,352," 9.5"
"6381","Z27823",3640,628,219,409,"11.2"
"6382","Z27826",450,95,95,0," 0.0"
"6383","Z27828",3881,651,97,554,"14.3"
"6384","Z27829",858,84,6,78," 9.1"
"6385","Z27830",2284,365,35,330,"14.4"
"6386","Z27831",1830,521,79,442,"24.2"
"6387","Z27832",1342,176,0,176,"13.1"
"6388","Z27834",25287,3189,205,2984,"11.8"
"6389","Z27837",2726,427,0,427,"15.7"
"6390","Z27839",1677,406,117,289,"17.2"
"6391","Z27840",249,61,9,52,"20.9"
"6392","Z27842",1962,1252,1122,130," 6.6"
"6393","Z27844",1389,207,66,141,"10.2"
"6394","Z27845",1037,57,14,43," 4.1"
"6395","Z27846",1475,255,28,227,"15.4"
"6396","Z27849",757,243,45,198,"26.2"
"6397","Z27850",5491,2250,1744,506," 9.2"
"6398","Z27851",2372,326,11,315,"13.3"
"6399","Z27852",1372,203,38,165,"12.0"
"6400","Z27853",209,52,0,52,"24.9"
"6401","Z27855",2595,363,93,270,"10.4"
"6402","Z27856",7391,996,3,993,"13.4"
"6403","Z27857",658,183,5,178,"27.1"
"6404","Z27858",24897,2847,212,2635,"10.6"
"6405","Z27860",1121,228,0,228,"20.3"
"6406","Z27862",376,59,36,23," 6.1"
"6407","Z27863",4710,289,36,253," 5.4"
"6408","Z27864",2091,236,11,225,"10.8"
"6409","Z27865",789,93,14,79,"10.0"
"6410","Z27866",321,47,0,47,"14.6"
"6411","Z27869",1231,319,89,230,"18.7"
"6412","Z27870",12205,1190,317,873," 7.2"
"6413","Z27871",2108,472,29,443,"21.0"
"6414","Z27872",174,12,2,10," 5.7"
"6415","Z27873",211,22,0,22,"10.4"
"6416","Z27874",2439,705,236,469,"19.2"
"6417","Z27876",858,159,38,121,"14.1"
"6418","Z27878",984,165,0,165,"16.8"
"6419","Z27879",144,35,4,31,"21.5"
"6420","Z27880",1380,64,0,64," 4.6"
"6421","Z27882",3385,655,46,609,"18.0"
"6422","Z27883",1581,248,25,223,"14.1"
"6423","Z27884",472,53,0,53,"11.2"
"6424","Z27885",666,215,96,119,"17.9"
"6425","Z27886",9301,1091,84,1007,"10.8"
"6426","Z27888",1061,159,59,100," 9.4"
"6427","Z27889",12874,2223,359,1864,"14.5"
"6428","Z27890",1266,234,23,211,"16.7"
"6429","Z27892",7050,1314,120,1194,"16.9"
"6430","Z27893",17558,2255,109,2146,"12.2"
"6431","Z27896",8553,324,11,313," 3.7"
"6432","Z27909",16883,2417,117,2300,"13.6"
"6433","Z27910",5359,922,103,819,"15.3"
"6434","Z27915",1973,1481,1146,335,"17.0"
"6435","Z27916",293,69,69,0," 0.0"
"6436","Z27917",359,34,0,34," 9.5"
"6437","Z27919",540,178,35,143,"26.5"
"6438","Z27920",759,240,205,35," 4.6"
"6439","Z27921",2037,226,0,226,"11.1"
"6440","Z27922",565,121,15,106,"18.8"
"6441","Z27923",384,177,0,177,"46.1"
"6442","Z27924",1554,533,68,465,"29.9"
"6443","Z27925",1954,552,261,291,"14.9"
"6444","Z27927",4472,4080,3723,357," 8.0"
"6445","Z27928",1126,285,60,225,"20.0"
"6446","Z27929",559,35,18,17," 3.0"
"6447","Z27932",6168,1104,330,774,"12.5"
"6448","Z27935",726,91,32,59," 8.1"
"6449","Z27937",1802,289,14,275,"15.3"
"6450","Z27938",617,65,2,63,"10.2"
"6451","Z27943",777,566,512,54," 6.9"
"6452","Z27944",6318,1331,485,846,"13.4"
"6453","Z27947",635,71,35,36," 5.7"
"6454","Z27948",8994,4253,3731,522," 5.8"
"6455","Z27949",8519,5356,4847,509," 6.0"
"6456","Z27953",663,182,96,86,"13.0"
"6457","Z27954",3664,1000,695,305," 8.3"
"6458","Z27956",138,37,0,37,"26.8"
"6459","Z27957",835,183,79,104,"12.5"
"6460","Z27958",4061,360,31,329," 8.1"
"6461","Z27959",5034,3810,3455,355," 7.1"
"6462","Z27960",795,570,413,157,"19.7"
"6463","Z27962",3692,622,0,622,"16.8"
"6464","Z27964",346,10,0,10," 2.9"
"6465","Z27965",382,95,26,69,"18.1"
"6466","Z27966",535,164,50,114,"21.3"
"6467","Z27970",1612,332,147,185,"11.5"
"6468","Z27973",513,37,0,37," 7.2"
"6469","Z27974",535,33,33,0," 0.0"
"6470","Z27979",821,153,20,133,"16.2"
"6471","Z27980",993,152,0,152,"15.3"
"6472","Z27981",743,144,69,75,"10.1"
"6473","Z27983",4352,896,164,732,"16.8"
"6474","Z27985",152,21,0,21,"13.8"
"6475","Z27986",622,123,23,100,"16.1"
"6476","Z28001",12392,1581,183,1398,"11.3"
"6477","Z28006",486,68,0,68,"14.0"
"6478","Z28009",619,91,9,82,"13.2"
"6479","Z28012",9167,939,189,750," 8.2"
"6480","Z28016",5696,772,54,718,"12.6"
"6481","Z28018",2826,516,157,359,"12.7"
"6482","Z28020",984,153,24,129,"13.1"
"6483","Z28021",6264,953,45,908,"14.5"
"6484","Z28023",6006,741,72,669,"11.1"
"6485","Z28025",20566,1893,137,1756," 8.5"
"6486","Z28027",23198,2353,212,2141," 9.2"
"6487","Z28031",11775,1083,560,523," 4.4"
"6488","Z28032",1386,93,7,86," 6.2"
"6489","Z28033",1400,255,60,195,"13.9"
"6490","Z28034",7326,834,40,794,"10.8"
"6491","Z28036",5668,393,135,258," 4.6"
"6492","Z28037",8545,1224,534,690," 8.1"
"6493","Z28040",3441,436,85,351,"10.2"
"6494","Z28043",9966,1732,279,1453,"14.6"
"6495","Z28052",14727,2679,164,2515,"17.1"
"6496","Z28054",16332,1851,80,1771,"10.8"
"6497","Z28056",12737,936,31,905," 7.1"
"6498","Z28071",1411,233,10,223,"15.8"
"6499","Z28073",2299,266,0,266,"11.6"
"6500","Z28075",5775,168,32,136," 2.4"
"6501","Z28077",235,64,0,64,"27.2"
"6502","Z28078",21423,1239,261,978," 4.6"
"6503","Z28079",11629,515,32,483," 4.2"
"6504","Z28081",11324,1536,95,1441,"12.7"
"6505","Z28083",10653,1497,16,1481,"13.9"
"6506","Z28086",11018,1104,146,958," 8.7"
"6507","Z28088",1381,172,0,172,"12.5"
"6508","Z28090",3715,562,22,540,"14.5"
"6509","Z28091",1094,192,64,128,"11.7"
"6510","Z28092",16276,1674,75,1599," 9.8"
"6511","Z28097",2309,172,15,157," 6.8"
"6512","Z28098",1528,175,34,141," 9.2"
"6513","Z28103",4249,318,21,297," 7.0"
"6514","Z28104",11086,579,74,505," 4.6"
"6515","Z28105",16975,896,133,763," 4.5"
"6516","Z28107",2724,176,43,133," 4.9"
"6517","Z28110",18737,1033,77,956," 5.1"
"6518","Z28112",10254,1113,89,1024,"10.0"
"6519","Z28114",3634,667,38,629,"17.3"
"6520","Z28115",13907,1533,53,1480,"10.6"
"6521","Z28117",16000,2202,1354,848," 5.3"
"6522","Z28120",8901,753,46,707," 7.9"
"6523","Z28124",2799,471,12,459,"16.4"
"6524","Z28125",982,142,21,121,"12.3"
"6525","Z28127",4908,2337,1829,508,"10.4"
"6526","Z28128",3744,776,497,279," 7.5"
"6527","Z28129",2428,194,54,140," 5.8"
"6528","Z28133",1200,166,28,138,"11.5"
"6529","Z28134",4551,298,22,276," 6.1"
"6530","Z28135",2104,283,10,273,"13.0"
"6531","Z28137",1599,336,216,120," 7.5"
"6532","Z28138",4296,758,81,677,"15.8"
"6533","Z28139",9299,1552,484,1068,"11.5"
"6534","Z28144",11363,1918,120,1798,"15.8"
"6535","Z28146",12311,1701,542,1159," 9.4"
"6536","Z28147",9774,884,44,840," 8.6"
"6537","Z28150",13362,2153,177,1976,"14.8"
"6538","Z28152",10544,1290,119,1171,"11.1"
"6539","Z28159",1499,214,0,214,"14.3"
"6540","Z28160",1964,431,61,370,"18.8"
"6541","Z28163",2162,140,0,140," 6.5"
"6542","Z28164",6044,560,63,497," 8.2"
"6543","Z28166",3944,527,230,297," 7.5"
"6544","Z28167",1136,193,182,11," 1.0"
"6545","Z28168",4369,495,0,495,"11.3"
"6546","Z28169",82,33,4,29,"35.4"
"6547","Z28170",5498,1119,80,1039,"18.9"
"6548","Z28173",16112,799,171,628," 3.9"
"6549","Z28174",2964,245,13,232," 7.8"
"6550","Z28202",7383,1148,81,1067,"14.5"
"6551","Z28203",8014,1027,60,967,"12.1"
"6552","Z28204",3046,196,0,196," 6.4"
"6553","Z28205",21016,1780,150,1630," 7.8"
"6554","Z28206",4990,604,9,595,"11.9"
"6555","Z28207",4189,380,82,298," 7.1"
"6556","Z28208",15261,2233,70,2163,"14.2"
"6557","Z28209",11161,770,51,719," 6.4"
"6558","Z28210",21747,1677,123,1554," 7.1"
"6559","Z28211",13470,1186,179,1007," 7.5"
"6560","Z28212",17125,1706,52,1654," 9.7"
"6561","Z28213",16227,1787,96,1691,"10.4"
"6562","Z28214",14192,1095,87,1008," 7.1"
"6563","Z28215",21933,2112,70,2042," 9.3"
"6564","Z28216",20241,1656,19,1637," 8.1"
"6565","Z28217",10938,1037,8,1029," 9.4"
"6566","Z28226",16873,989,58,931," 5.5"
"6567","Z28227",20457,1287,23,1264," 6.2"
"6568","Z28262",15798,1327,59,1268," 8.0"
"6569","Z28269",30210,2009,382,1627," 5.4"
"6570","Z28270",13349,507,9,498," 3.7"
"6571","Z28273",14127,850,84,766," 5.4"
"6572","Z28277",26184,1370,290,1080," 4.1"
"6573","Z28278",8609,436,141,295," 3.4"
"6574","Z28301",8266,1442,86,1356,"16.4"
"6575","Z28303",15029,2155,76,2079,"13.8"
"6576","Z28304",16740,2177,9,2168,"13.0"
"6577","Z28305",3412,599,51,548,"16.1"
"6578","Z28306",17102,1573,59,1514," 8.9"
"6579","Z28307",5426,441,0,441," 8.1"
"6580","Z28311",16477,2700,81,2619,"15.9"
"6581","Z28312",8492,1199,74,1125,"13.2"
"6582","Z28314",26047,4104,98,4006,"15.4"
"6583","Z28315",5418,697,335,362," 6.7"
"6584","Z28318",2107,274,10,264,"12.5"
"6585","Z28320",4419,621,47,574,"13.0"
"6586","Z28323",1406,216,3,213,"15.1"
"6587","Z28326",7139,707,27,680," 9.5"
"6588","Z28327",6398,776,179,597," 9.3"
"6589","Z28328",11559,1444,158,1286,"11.1"
"6590","Z28332",218,27,0,27,"12.4"
"6591","Z28333",4882,842,0,842,"17.2"
"6592","Z28334",11259,1524,312,1212,"10.8"
"6593","Z28337",5934,1618,937,681,"11.5"
"6594","Z28338",2332,354,56,298,"12.8"
"6595","Z28339",3190,508,55,453,"14.2"
"6596","Z28340",4711,706,99,607,"12.9"
"6597","Z28341",1759,335,44,291,"16.5"
"6598","Z28342",80,10,7,3," 3.8"
"6599","Z28343",766,236,2,234,"30.5"
"6600","Z28344",1468,299,25,274,"18.7"
"6601","Z28345",5390,498,97,401," 7.4"
"6602","Z28347",522,88,7,81,"15.5"
"6603","Z28348",13094,1275,0,1275," 9.7"
"6604","Z28349",1590,168,0,168,"10.6"
"6605","Z28351",1844,295,12,283,"15.3"
"6606","Z28352",10613,1305,85,1220,"11.5"
"6607","Z28356",2145,377,23,354,"16.5"
"6608","Z28358",15543,2097,71,2026,"13.0"
"6609","Z28360",5410,564,38,526," 9.7"
"6610","Z28364",5740,712,88,624,"10.9"
"6611","Z28365",7404,935,84,851,"11.5"
"6612","Z28366",2493,511,111,400,"16.0"
"6613","Z28371",2608,423,31,392,"15.0"
"6614","Z28372",5034,529,24,505,"10.0"
"6615","Z28373",1096,77,10,67," 6.1"
"6616","Z28374",9912,2021,1390,631," 6.4"
"6617","Z28376",16073,2195,88,2107,"13.1"
"6618","Z28377",5025,866,35,831,"16.5"
"6619","Z28379",12033,1446,48,1398,"11.6"
"6620","Z28382",3068,450,79,371,"12.1"
"6621","Z28383",3171,297,17,280," 8.8"
"6622","Z28384",4749,541,99,442," 9.3"
"6623","Z28385",1253,131,5,126,"10.1"
"6624","Z28386",2205,293,16,277,"12.6"
"6625","Z28387",7829,1311,380,931,"11.9"
"6626","Z28390",9793,1497,54,1443,"14.7"
"6627","Z28391",2270,287,0,287,"12.6"
"6628","Z28393",692,110,21,89,"12.9"
"6629","Z28394",2656,634,164,470,"17.7"
"6630","Z28395",1047,132,2,130,"12.4"
"6631","Z28396",1307,186,5,181,"13.8"
"6632","Z28398",3631,628,182,446,"12.3"
"6633","Z28399",978,127,22,105,"10.7"
"6634","Z28401",11949,1926,259,1667,"14.0"
"6635","Z28403",18899,2225,440,1785," 9.4"
"6636","Z28405",14519,1661,535,1126," 7.8"
"6637","Z28409",13522,1180,471,709," 5.2"
"6638","Z28411",14685,1215,603,612," 4.2"
"6639","Z28412",17871,1732,543,1189," 6.7"
"6640","Z28420",1644,362,136,226,"13.7"
"6641","Z28421",741,254,106,148,"20.0"
"6642","Z28422",3909,968,633,335," 8.6"
"6643","Z28423",1048,93,30,63," 6.0"
"6644","Z28425",4927,905,207,698,"14.2"
"6645","Z28428",5604,3036,2291,745,"13.3"
"6646","Z28429",3289,232,38,194," 5.9"
"6647","Z28430",756,101,45,56," 7.4"
"6648","Z28431",3166,495,50,445,"14.1"
"6649","Z28432",913,89,0,89," 9.7"
"6650","Z28433",2237,173,7,166," 7.4"
"6651","Z28436",799,68,14,54," 6.8"
"6652","Z28438",868,100,40,60," 6.9"
"6653","Z28439",906,151,19,132,"14.6"
"6654","Z28443",8547,1583,914,669," 7.8"
"6655","Z28444",969,222,106,116,"12.0"
"6656","Z28445",6729,3906,3220,686,"10.2"
"6657","Z28447",644,32,0,32," 5.0"
"6658","Z28448",549,66,22,44," 8.0"
"6659","Z28449",1895,1039,727,312,"16.5"
"6660","Z28450",1454,511,392,119," 8.2"
"6661","Z28451",13263,1265,369,896," 6.8"
"6662","Z28453",1517,265,66,199,"13.1"
"6663","Z28454",1027,255,48,207,"20.2"
"6664","Z28455",990,332,164,168,"17.0"
"6665","Z28456",1847,357,144,213,"11.5"
"6666","Z28457",4015,480,163,317," 7.9"
"6667","Z28458",2960,487,114,373,"12.6"
"6668","Z28460",6529,2976,1973,1003,"15.4"
"6669","Z28461",10855,3218,2459,759," 7.0"
"6670","Z28462",12081,6896,5526,1370,"11.3"
"6671","Z28463",3707,474,110,364," 9.8"
"6672","Z28464",898,112,3,109,"12.1"
"6673","Z28465",8827,5682,4425,1257,"14.2"
"6674","Z28466",5273,753,144,609,"11.5"
"6675","Z28467",7151,2390,1671,719,"10.1"
"6676","Z28468",5743,3569,2968,601,"10.5"
"6677","Z28469",7768,4995,4218,777,"10.0"
"6678","Z28470",6132,1534,913,621,"10.1"
"6679","Z28472",8783,1174,89,1085,"12.4"
"6680","Z28478",2025,353,68,285,"14.1"
"6681","Z28479",2559,286,177,109," 4.3"
"6682","Z28480",2690,1518,1266,252," 9.4"
"6683","Z28501",9995,1873,288,1585,"15.9"
"6684","Z28504",9599,1079,221,858," 8.9"
"6685","Z28510",1048,436,312,124,"11.8"
"6686","Z28512",7115,5522,4681,841,"11.8"
"6687","Z28513",4641,470,38,432," 9.3"
"6688","Z28515",1248,386,58,328,"26.3"
"6689","Z28516",6509,1486,977,509," 7.8"
"6690","Z28518",3666,442,55,387,"10.6"
"6691","Z28519",180,53,0,53,"29.4"
"6692","Z28521",1057,165,0,165,"15.6"
"6693","Z28523",1148,50,20,30," 2.6"
"6694","Z28524",208,77,52,25,"12.0"
"6695","Z28525",1197,141,85,56," 4.7"
"6696","Z28526",1277,197,70,127," 9.9"
"6697","Z28527",544,16,0,16," 2.9"
"6698","Z28528",467,160,108,52,"11.1"
"6699","Z28529",1270,316,135,181,"14.3"
"6700","Z28530",3280,599,68,531,"16.2"
"6701","Z28531",1190,583,483,100," 8.4"
"6702","Z28532",9904,1379,249,1130,"11.4"
"6703","Z28538",979,93,25,68," 6.9"
"6704","Z28539",6929,1114,217,897,"12.9"
"6705","Z28540",21004,3142,65,3077,"14.6"
"6706","Z28544",2281,215,15,200," 8.8"
"6707","Z28546",19233,2110,45,2065,"10.7"
"6708","Z28547",1953,68,0,68," 3.5"
"6709","Z28551",6273,497,131,366," 5.8"
"6710","Z28553",291,139,139,0," 0.0"
"6711","Z28554",100,20,0,20,"20.0"
"6712","Z28555",2115,293,8,285,"13.5"
"6713","Z28556",779,270,232,38," 4.9"
"6714","Z28557",7871,1397,788,609," 7.7"
"6715","Z28560",13205,2075,466,1609,"12.2"
"6716","Z28562",17395,1633,267,1366," 7.9"
"6717","Z28570",10662,1484,822,662," 6.2"
"6718","Z28571",1773,568,391,177,"10.0"
"6719","Z28572",2751,389,28,361,"13.1"
"6720","Z28573",1149,180,25,155,"13.5"
"6721","Z28574",6468,629,8,621," 9.6"
"6722","Z28575",1749,1490,1273,217,"12.4"
"6723","Z28578",2069,195,3,192," 9.3"
"6724","Z28579",311,78,0,78,"25.1"
"6725","Z28580",4564,502,227,275," 6.0"
"6726","Z28584",6396,1694,1199,495," 7.7"
"6727","Z28585",1752,182,34,148," 8.4"
"6728","Z28586",3289,389,12,377,"11.5"
"6729","Z28589",133,26,0,26,"19.5"
"6730","Z28590",9977,626,30,596," 6.0"
"6731","Z28594",6798,4981,4046,935,"13.8"
"6732","Z28601",22420,3202,388,2814,"12.6"
"6733","Z28602",12651,1505,109,1396,"11.0"
"6734","Z28604",9120,6361,4997,1364,"15.0"
"6735","Z28605",4332,2773,2279,494,"11.4"
"6736","Z28606",953,225,95,130,"13.6"
"6737","Z28607",17004,4566,2849,1717,"10.1"
"6738","Z28610",4129,571,99,472,"11.4"
"6739","Z28612",5490,901,61,840,"15.3"
"6740","Z28613",9647,893,68,825," 8.6"
"6741","Z28615",1209,408,266,142,"11.7"
"6742","Z28617",1667,451,358,93," 5.6"
"6743","Z28618",1398,522,421,101," 7.2"
"6744","Z28621",4832,779,55,724,"15.0"
"6745","Z28622",1503,625,425,200,"13.3"
"6746","Z28623",1077,265,132,133,"12.3"
"6747","Z28624",887,164,114,50," 5.6"
"6748","Z28625",15781,1736,150,1586,"10.1"
"6749","Z28628",151,12,0,12," 7.9"
"6750","Z28630",8396,910,60,850,"10.1"
"6751","Z28634",2334,402,54,348,"14.9"
"6752","Z28635",1965,309,57,252,"12.8"
"6753","Z28636",2302,399,63,336,"14.6"
"6754","Z28637",718,70,0,70," 9.7"
"6755","Z28638",5326,872,177,695,"13.0"
"6756","Z28640",2805,891,551,340,"12.1"
"6757","Z28642",2721,340,15,325,"11.9"
"6758","Z28644",1291,844,689,155,"12.0"
"6759","Z28645",22206,3904,949,2955,"13.3"
"6760","Z28646",1249,993,973,20," 1.6"
"6761","Z28647",123,74,74,0," 0.0"
"6762","Z28650",4722,591,32,559,"11.8"
"6763","Z28651",3600,920,448,472,"13.1"
"6764","Z28654",1768,282,70,212,"12.0"
"6765","Z28655",24722,3837,669,3168,"12.8"
"6766","Z28657",6558,2434,2034,400," 6.1"
"6767","Z28658",11252,1403,27,1376,"12.2"
"6768","Z28659",9549,1384,69,1315,"13.8"
"6769","Z28663",503,269,213,56,"11.1"
"6770","Z28667",243,69,21,48,"19.8"
"6771","Z28668",971,833,787,46," 4.7"
"6772","Z28670",1430,170,45,125," 8.7"
"6773","Z28673",3024,862,570,292," 9.7"
"6774","Z28675",3953,1099,589,510,"12.9"
"6775","Z28676",1670,140,26,114," 6.8"
"6776","Z28677",15085,2507,207,2300,"15.2"
"6777","Z28678",2156,126,41,85," 3.9"
"6778","Z28679",1146,329,171,158,"13.8"
"6779","Z28681",11413,1825,417,1408,"12.3"
"6780","Z28682",691,137,105,32," 4.6"
"6781","Z28683",993,253,29,224,"22.6"
"6782","Z28685",1040,335,85,250,"24.0"
"6783","Z28689",621,28,12,16," 2.6"
"6784","Z28690",4292,606,181,425," 9.9"
"6785","Z28692",2488,837,677,160," 6.4"
"6786","Z28693",820,206,90,116,"14.1"
"6787","Z28694",4805,1353,922,431," 9.0"
"6788","Z28697",5866,741,123,618,"10.5"
"6789","Z28698",1299,469,309,160,"12.3"
"6790","Z28701",1501,51,51,0," 0.0"
"6791","Z28702",538,315,293,22," 4.1"
"6792","Z28704",8999,845,322,523," 5.8"
"6793","Z28705",4048,1194,555,639,"15.8"
"6794","Z28708",354,75,46,29," 8.2"
"6795","Z28709",1038,104,0,104,"10.0"
"6796","Z28711",6970,1553,1090,463," 6.6"
"6797","Z28712",10761,2806,1796,1010," 9.4"
"6798","Z28713",5791,2345,1836,509," 8.8"
"6799","Z28714",10086,3155,1727,1428,"14.2"
"6800","Z28715",11317,1346,363,983," 8.7"
"6801","Z28716",8576,1455,537,918,"10.7"
"6802","Z28717",2858,2053,1925,128," 4.5"
"6803","Z28719",3952,1042,512,530,"13.4"
"6804","Z28721",5322,885,236,649,"12.2"
"6805","Z28722",3391,675,348,327," 9.6"
"6806","Z28723",5128,1823,1240,583,"11.4"
"6807","Z28729",1637,242,128,114," 7.0"
"6808","Z28730",4214,650,256,394," 9.3"
"6809","Z28731",4304,937,578,359," 8.3"
"6810","Z28732",7590,625,134,491," 6.5"
"6811","Z28734",17292,5299,3533,1766,"10.2"
"6812","Z28736",1149,725,657,68," 5.9"
"6813","Z28739",10957,1964,1065,899," 8.2"
"6814","Z28740",757,224,144,80,"10.6"
"6815","Z28741",5590,3696,3437,259," 4.6"
"6816","Z28742",1210,171,99,72," 6.0"
"6817","Z28743",1359,394,211,183,"13.5"
"6818","Z28745",610,326,211,115,"18.9"
"6819","Z28746",3126,2005,1880,125," 4.0"
"6820","Z28747",2071,1175,929,246,"11.9"
"6821","Z28748",5315,654,104,550,"10.3"
"6822","Z28751",4104,2506,2063,443,"10.8"
"6823","Z28752",14004,2043,776,1267," 9.0"
"6824","Z28753",5805,968,290,678,"11.7"
"6825","Z28754",4181,1187,764,423,"10.1"
"6826","Z28756",2389,484,374,110," 4.6"
"6827","Z28757",394,266,246,20," 5.1"
"6828","Z28759",3059,319,239,80," 2.6"
"6829","Z28761",3682,786,534,252," 6.8"
"6830","Z28762",3321,633,273,360,"10.8"
"6831","Z28763",1751,526,371,155," 8.9"
"6832","Z28768",3743,734,355,379,"10.1"
"6833","Z28771",5454,2394,1830,564,"10.3"
"6834","Z28773",2074,858,594,264,"12.7"
"6835","Z28774",2366,1657,1557,100," 4.2"
"6836","Z28775",267,112,112,0," 0.0"
"6837","Z28777",4863,1252,696,556,"11.4"
"6838","Z28778",4687,405,180,225," 4.8"
"6839","Z28779",9071,2085,1119,966,"10.6"
"6840","Z28781",925,532,417,115,"12.4"
"6841","Z28782",4021,965,474,491,"12.2"
"6842","Z28783",1116,470,383,87," 7.8"
"6843","Z28785",4497,1406,1020,386," 8.6"
"6844","Z28786",12087,2478,1567,911," 7.5"
"6845","Z28787",8916,1108,452,656," 7.4"
"6846","Z28789",3426,1253,828,425,"12.4"
"6847","Z28790",1706,364,217,147," 8.6"
"6848","Z28791",7326,775,269,506," 6.9"
"6849","Z28792",16363,2880,1154,1726,"10.5"
"6850","Z28801",7453,942,435,507," 6.8"
"6851","Z28803",15535,1673,719,954," 6.1"
"6852","Z28804",9524,1267,481,786," 8.3"
"6853","Z28805",9250,767,485,282," 3.0"
"6854","Z28806",18451,1881,356,1525," 8.3"
"6855","Z28901",2866,715,368,347,"12.1"
"6856","Z28902",860,275,154,121,"14.1"
"6857","Z28904",5973,2324,1813,511," 8.6"
"6858","Z28905",1596,472,303,169,"10.6"
"6859","Z28906",12931,5772,4278,1494,"11.6"
"6860","Z28909",576,131,53,78,"13.5"
"6861","Z29001",871,77,21,56," 6.4"
"6862","Z29003",3062,486,112,374,"12.2"
"6863","Z29006",4573,772,191,581,"12.7"
"6864","Z29009",1309,292,44,248,"18.9"
"6865","Z29010",5106,877,142,735,"14.4"
"6866","Z29016",7009,397,199,198," 2.8"
"6867","Z29018",1613,375,144,231,"14.3"
"6868","Z29020",11119,1929,580,1349,"12.1"
"6869","Z29030",1137,270,78,192,"16.9"
"6870","Z29031",668,175,52,123,"18.4"
"6871","Z29032",1964,203,0,203,"10.3"
"6872","Z29033",5662,372,6,366," 6.5"
"6873","Z29036",8582,919,452,467," 5.4"
"6874","Z29037",585,194,135,59,"10.1"
"6875","Z29039",1597,304,75,229,"14.3"
"6876","Z29040",3889,471,65,406,"10.4"
"6877","Z29042",2718,639,201,438,"16.1"
"6878","Z29044",2577,537,13,524,"20.3"
"6879","Z29045",9411,718,65,653," 6.9"
"6880","Z29047",2036,610,221,389,"19.1"
"6881","Z29048",2909,1037,540,497,"17.1"
"6882","Z29053",7670,955,67,888,"11.6"
"6883","Z29054",4139,517,216,301," 7.3"
"6884","Z29055",2024,406,30,376,"18.6"
"6885","Z29056",1018,235,53,182,"17.9"
"6886","Z29058",1976,257,79,178," 9.0"
"6887","Z29059",2814,597,298,299,"10.6"
"6888","Z29061",5936,567,145,422," 7.1"
"6889","Z29063",13602,949,49,900," 6.6"
"6890","Z29067",4122,554,27,527,"12.8"
"6891","Z29069",2151,218,71,147," 6.8"
"6892","Z29070",7440,1595,702,893,"12.0"
"6893","Z29072",21488,1372,295,1077," 5.0"
"6894","Z29073",17166,1301,87,1214," 7.1"
"6895","Z29074",300,274,274,0," 0.0"
"6896","Z29075",1300,76,7,69," 5.3"
"6897","Z29078",6403,665,89,576," 9.0"
"6898","Z29080",1476,330,82,248,"16.8"
"6899","Z29081",760,209,36,173,"22.8"
"6900","Z29101",1376,261,27,234,"17.0"
"6901","Z29102",8984,2062,1031,1031,"11.5"
"6902","Z29105",515,60,8,52,"10.1"
"6903","Z29107",1568,237,12,225,"14.3"
"6904","Z29108",8157,1216,185,1031,"12.6"
"6905","Z29111",675,70,0,70,"10.4"
"6906","Z29112",2273,591,36,555,"24.4"
"6907","Z29113",793,168,79,89,"11.2"
"6908","Z29114",884,171,0,171,"19.3"
"6909","Z29115",13742,2948,505,2443,"17.8"
"6910","Z29118",7000,668,227,441," 6.3"
"6911","Z29123",3329,407,57,350,"10.5"
"6912","Z29125",1278,272,122,150,"11.7"
"6913","Z29126",1174,215,87,128,"10.9"
"6914","Z29127",5043,1501,1053,448," 8.9"
"6915","Z29128",2231,445,91,354,"15.9"
"6916","Z29129",1379,339,25,314,"22.8"
"6917","Z29130",3396,733,442,291," 8.6"
"6918","Z29133",546,115,4,111,"20.3"
"6919","Z29135",4003,653,120,533,"13.3"
"6920","Z29137",1137,210,65,145,"12.8"
"6921","Z29138",4625,770,158,612,"13.2"
"6922","Z29142",2553,630,333,297,"11.6"
"6923","Z29145",480,125,0,125,"26.0"
"6924","Z29148",4680,1628,1126,502,"10.7"
"6925","Z29150",18963,2515,288,2227,"11.7"
"6926","Z29153",6727,916,183,733,"10.9"
"6927","Z29154",11801,1094,160,934," 7.9"
"6928","Z29160",3659,523,78,445,"12.2"
"6929","Z29161",4748,612,144,468," 9.9"
"6930","Z29162",1197,144,24,120,"10.0"
"6931","Z29163",778,42,38,4," 0.5"
"6932","Z29166",467,141,3,138,"29.6"
"6933","Z29169",11996,1336,15,1321,"11.0"
"6934","Z29170",8753,637,21,616," 7.0"
"6935","Z29172",3819,246,0,246," 6.4"
"6936","Z29178",1812,477,81,396,"21.9"
"6937","Z29180",6847,1441,341,1100,"16.1"
"6938","Z29201",9808,2082,293,1789,"18.2"
"6939","Z29203",17104,2516,92,2424,"14.2"
"6940","Z29204",9088,1051,17,1034,"11.4"
"6941","Z29205",12810,1969,66,1903,"14.9"
"6942","Z29206",9100,1196,78,1118,"12.3"
"6943","Z29209",14830,1902,77,1825,"12.3"
"6944","Z29210",18475,2281,90,2191,"11.9"
"6945","Z29212",12855,1187,87,1100," 8.6"
"6946","Z29223",23062,2358,254,2104," 9.1"
"6947","Z29229",17423,1843,143,1700," 9.8"
"6948","Z29301",14605,1801,108,1693,"11.6"
"6949","Z29302",7709,869,17,852,"11.1"
"6950","Z29303",10119,1289,33,1256,"12.4"
"6951","Z29306",7505,1254,55,1199,"16.0"
"6952","Z29307",9152,935,43,892," 9.7"
"6953","Z29316",9539,679,54,625," 6.6"
"6954","Z29321",1324,194,0,194,"14.7"
"6955","Z29322",3563,532,61,471,"13.2"
"6956","Z29323",6089,724,67,657,"10.8"
"6957","Z29325",6140,815,94,721,"11.7"
"6958","Z29330",3630,555,21,534,"14.7"
"6959","Z29334",5236,356,0,356," 6.8"
"6960","Z29335",1998,350,132,218,"10.9"
"6961","Z29340",9164,1325,109,1216,"13.3"
"6962","Z29341",8384,1053,60,993,"11.8"
"6963","Z29349",12505,1521,222,1299,"10.4"
"6964","Z29351",768,248,0,248,"32.3"
"6965","Z29353",2169,451,43,408,"18.8"
"6966","Z29356",4123,761,253,508,"12.3"
"6967","Z29360",9442,1440,201,1239,"13.1"
"6968","Z29365",4122,443,36,407," 9.9"
"6969","Z29369",5296,162,7,155," 2.9"
"6970","Z29372",2014,379,31,348,"17.3"
"6971","Z29374",1494,240,92,148," 9.9"
"6972","Z29375",34,9,0,9,"26.5"
"6973","Z29376",3211,351,51,300," 9.3"
"6974","Z29379",9090,1368,240,1128,"12.4"
"6975","Z29384",2896,1023,671,352,"12.2"
"6976","Z29385",3107,286,42,244," 7.9"
"6977","Z29388",5936,805,144,661,"11.1"
"6978","Z29401",5326,1224,628,596,"11.2"
"6979","Z29403",10320,1713,233,1480,"14.3"
"6980","Z29404",390,42,0,42,"10.8"
"6981","Z29405",11668,1875,40,1835,"15.7"
"6982","Z29406",13447,1897,210,1687,"12.5"
"6983","Z29407",17338,2137,125,2012,"11.6"
"6984","Z29412",18063,1633,305,1328," 7.4"
"6985","Z29414",16876,1068,97,971," 5.8"
"6986","Z29418",10988,1316,36,1280,"11.6"
"6987","Z29420",8643,812,76,736," 8.5"
"6988","Z29426",681,135,23,112,"16.4"
"6989","Z29429",1311,311,34,277,"21.1"
"6990","Z29431",2953,637,343,294,"10.0"
"6991","Z29432",1499,389,168,221,"14.7"
"6992","Z29435",1777,218,12,206,"11.6"
"6993","Z29436",2290,630,409,221," 9.7"
"6994","Z29437",1078,176,71,105," 9.7"
"6995","Z29438",3573,2394,1594,800,"22.4"
"6996","Z29439",2373,1335,991,344,"14.5"
"6997","Z29440",13100,3155,2010,1145," 8.7"
"6998","Z29445",21371,1266,127,1139," 5.3"
"6999","Z29446",525,205,116,89,"17.0"
"7000","Z29448",968,81,9,72," 7.4"
"7001","Z29450",1515,252,45,207,"13.7"
"7002","Z29451",4602,2684,1342,1342,"29.2"
"7003","Z29453",674,173,91,82,"12.2"
"7004","Z29455",13569,5000,3934,1066," 7.9"
"7005","Z29456",11474,916,9,907," 7.9"
"7006","Z29458",1417,534,203,331,"23.4"
"7007","Z29461",13432,989,238,751," 5.6"
"7008","Z29464",21772,1860,617,1243," 5.7"
"7009","Z29466",12459,681,353,328," 2.6"
"7010","Z29468",1127,356,159,197,"17.5"
"7011","Z29469",474,19,19,0," 0.0"
"7012","Z29470",1978,229,34,195," 9.9"
"7013","Z29471",740,194,57,137,"18.5"
"7014","Z29472",3282,453,127,326," 9.9"
"7015","Z29475",1350,370,32,338,"25.0"
"7016","Z29477",3094,680,186,494,"16.0"
"7017","Z29479",3032,569,89,480,"15.8"
"7018","Z29482",1131,323,231,92," 8.1"
"7019","Z29483",28108,2289,331,1958," 7.0"
"7020","Z29485",19600,1571,72,1499," 7.6"
"7021","Z29487",1337,252,138,114," 8.5"
"7022","Z29488",9839,1397,215,1182,"12.0"
"7023","Z29492",5037,540,202,338," 6.7"
"7024","Z29493",52,6,2,4," 7.7"
"7025","Z29501",20013,2166,239,1927," 9.6"
"7026","Z29505",10752,799,83,716," 6.7"
"7027","Z29506",8707,1438,139,1299,"14.9"
"7028","Z29510",4873,908,299,609,"12.5"
"7029","Z29511",2302,319,151,168," 7.3"
"7030","Z29512",7603,1287,292,995,"13.1"
"7031","Z29516",419,61,12,49,"11.7"
"7032","Z29518",560,166,11,155,"27.7"
"7033","Z29520",6819,922,219,703,"10.3"
"7034","Z29525",868,108,23,85," 9.8"
"7035","Z29526",17744,2369,578,1791,"10.1"
"7036","Z29527",10344,1151,287,864," 8.4"
"7037","Z29530",1235,207,32,175,"14.2"
"7038","Z29532",9039,1080,151,929,"10.3"
"7039","Z29536",7229,1162,206,956,"13.2"
"7040","Z29540",2258,208,54,154," 6.8"
"7041","Z29541",3577,350,58,292," 8.2"
"7042","Z29545",724,131,8,123,"17.0"
"7043","Z29546",1361,287,100,187,"13.7"
"7044","Z29547",1158,224,72,152,"13.1"
"7045","Z29550",14284,1941,240,1701,"11.9"
"7046","Z29554",4207,758,301,457,"10.9"
"7047","Z29555",2499,415,63,352,"14.1"
"7048","Z29556",5746,1141,240,901,"15.7"
"7049","Z29560",5779,879,109,770,"13.3"
"7050","Z29563",1355,240,27,213,"15.7"
"7051","Z29565",3007,366,131,235," 7.8"
"7052","Z29566",10699,3122,2439,683," 6.4"
"7053","Z29568",6653,1378,950,428," 6.4"
"7054","Z29569",6913,949,239,710,"10.3"
"7055","Z29571",6453,969,142,827,"12.8"
"7056","Z29572",15237,10959,5051,5908,"38.8"
"7057","Z29574",5879,1334,422,912,"15.5"
"7058","Z29575",17151,9273,7591,1682," 9.8"
"7059","Z29576",19508,7018,6053,965," 4.9"
"7060","Z29577",21070,8893,4267,4626,"22.0"
"7061","Z29579",18112,4802,2655,2147,"11.9"
"7062","Z29581",2304,499,148,351,"15.2"
"7063","Z29582",28550,20544,11650,8894,"31.2"
"7064","Z29583",2377,294,15,279,"11.7"
"7065","Z29584",1130,125,0,125,"11.1"
"7066","Z29585",10787,4651,3671,980," 9.1"
"7067","Z29588",18237,2666,1537,1129," 6.2"
"7068","Z29590",1301,435,143,292,"22.4"
"7069","Z29591",2234,274,57,217," 9.7"
"7070","Z29593",978,212,80,132,"13.5"
"7071","Z29596",1278,319,33,286,"22.4"
"7072","Z29601",5723,866,222,644,"11.3"
"7073","Z29605",15578,1778,66,1712,"11.0"
"7074","Z29607",17389,1617,105,1512," 8.7"
"7075","Z29609",13197,1469,104,1365,"10.3"
"7076","Z29611",12953,2103,22,2081,"16.1"
"7077","Z29615",17531,1508,199,1309," 7.5"
"7078","Z29617",11329,1219,9,1210,"10.7"
"7079","Z29620",6088,992,312,680,"11.2"
"7080","Z29621",17720,1794,289,1505," 8.5"
"7081","Z29624",7116,1353,84,1269,"17.8"
"7082","Z29625",13347,1673,683,990," 7.4"
"7083","Z29626",5933,946,372,574," 9.7"
"7084","Z29627",7550,1176,70,1106,"14.6"
"7085","Z29628",1220,299,96,203,"16.6"
"7086","Z29630",6667,941,191,750,"11.2"
"7087","Z29631",6249,1045,393,652,"10.4"
"7088","Z29635",961,363,297,66," 6.9"
"7089","Z29638",1481,267,91,176,"11.9"
"7090","Z29639",513,120,36,84,"16.4"
"7091","Z29640",13150,1494,130,1364,"10.4"
"7092","Z29642",12457,994,95,899," 7.2"
"7093","Z29643",1747,729,495,234,"13.4"
"7094","Z29644",8046,761,21,740," 9.2"
"7095","Z29645",3851,346,20,326," 8.5"
"7096","Z29646",12382,1848,180,1668,"13.5"
"7097","Z29649",11280,1295,296,999," 8.9"
"7098","Z29650",13782,781,201,580," 4.2"
"7099","Z29651",18017,1174,51,1123," 6.2"
"7100","Z29653",2084,300,77,223,"10.7"
"7101","Z29654",4770,704,109,595,"12.5"
"7102","Z29655",3920,1096,492,604,"15.4"
"7103","Z29657",6435,613,46,567," 8.8"
"7104","Z29658",156,28,13,15," 9.6"
"7105","Z29661",2808,561,186,375,"13.4"
"7106","Z29662",6481,565,54,511," 7.9"
"7107","Z29664",1269,401,229,172,"13.6"
"7108","Z29666",3381,613,245,368,"10.9"
"7109","Z29669",5261,865,92,773,"14.7"
"7110","Z29670",4361,623,251,372," 8.5"
"7111","Z29671",7843,970,153,817,"10.4"
"7112","Z29672",6312,1239,717,522," 8.3"
"7113","Z29673",11115,971,85,886," 8.0"
"7114","Z29676",3852,1258,668,590,"15.3"
"7115","Z29678",10869,1874,653,1221,"11.2"
"7116","Z29680",10875,577,135,442," 4.1"
"7117","Z29681",19386,1254,112,1142," 5.9"
"7118","Z29682",1883,527,315,212,"11.3"
"7119","Z29684",1756,70,19,51," 2.9"
"7120","Z29685",1181,648,520,128,"10.8"
"7121","Z29686",561,281,230,51," 9.1"
"7122","Z29687",17211,1153,94,1059," 6.2"
"7123","Z29689",2588,832,613,219," 8.5"
"7124","Z29690",8314,1027,123,904,"10.9"
"7125","Z29691",4838,589,31,558,"11.5"
"7126","Z29692",2421,472,44,428,"17.7"
"7127","Z29693",7450,1858,871,987,"13.2"
"7128","Z29697",5426,456,0,456," 8.4"
"7129","Z29702",4346,856,86,770,"17.7"
"7130","Z29704",1707,113,0,113," 6.6"
"7131","Z29706",9043,1524,95,1429,"15.8"
"7132","Z29707",9416,481,103,378," 4.0"
"7133","Z29708",10592,343,90,253," 2.4"
"7134","Z29709",2936,584,45,539,"18.4"
"7135","Z29710",13331,1480,402,1078," 8.1"
"7136","Z29714",1289,162,50,112," 8.7"
"7137","Z29715",10671,439,13,426," 4.0"
"7138","Z29717",565,99,18,81,"14.3"
"7139","Z29718",1710,228,16,212,"12.4"
"7140","Z29720",19167,2852,277,2575,"13.4"
"7141","Z29726",845,93,3,90,"10.7"
"7142","Z29727",723,153,0,153,"21.2"
"7143","Z29728",4874,862,82,780,"16.0"
"7144","Z29729",893,40,0,40," 4.5"
"7145","Z29730",23070,2018,49,1969," 8.5"
"7146","Z29732",23950,1817,181,1636," 6.8"
"7147","Z29742",1030,86,0,86," 8.3"
"7148","Z29743",488,72,0,72,"14.8"
"7149","Z29745",11569,893,116,777," 6.7"
"7150","Z29801",12422,2210,571,1639,"13.2"
"7151","Z29803",17184,1916,271,1645," 9.6"
"7152","Z29805",2628,316,123,193," 7.3"
"7153","Z29810",2444,596,117,479,"19.6"
"7154","Z29812",5313,1053,102,951,"17.9"
"7155","Z29816",609,132,13,119,"19.5"
"7156","Z29817",2406,632,182,450,"18.7"
"7157","Z29819",777,195,57,138,"17.8"
"7158","Z29821",601,95,7,88,"14.6"
"7159","Z29824",3015,430,26,404,"13.4"
"7160","Z29826",76,35,4,31,"40.8"
"7161","Z29827",1595,370,85,285,"17.9"
"7162","Z29828",538,47,0,47," 8.7"
"7163","Z29829",4049,435,12,423,"10.4"
"7164","Z29831",1814,314,40,274,"15.1"
"7165","Z29832",2336,341,61,280,"12.0"
"7166","Z29834",875,151,0,151,"17.3"
"7167","Z29835",3917,762,325,437,"11.2"
"7168","Z29838",495,255,125,130,"26.3"
"7169","Z29841",14421,1457,125,1332," 9.2"
"7170","Z29842",3677,435,0,435,"11.8"
"7171","Z29847",2089,429,78,351,"16.8"
"7172","Z29848",295,26,10,16," 5.4"
"7173","Z29851",3215,449,140,309," 9.6"
"7174","Z29853",3170,632,169,463,"14.6"
"7175","Z29856",1301,222,128,94," 7.2"
"7176","Z29860",6262,722,9,713,"11.4"
"7177","Z29902",6742,1224,494,730,"10.8"
"7178","Z29906",8879,1432,273,1159,"13.1"
"7179","Z29909",10334,1320,1118,202," 2.0"
"7180","Z29910",15310,1943,1147,796," 5.2"
"7181","Z29911",899,157,55,102,"11.3"
"7182","Z29918",1881,350,38,312,"16.6"
"7183","Z29920",7004,3003,2126,877,"12.5"
"7184","Z29924",1765,272,85,187,"10.6"
"7185","Z29926",12643,2406,1808,598," 4.7"
"7186","Z29927",3328,496,96,400,"12.0"
"7187","Z29928",22725,14664,11998,2666,"11.7"
"7188","Z29929",562,132,39,93,"16.5"
"7189","Z29932",184,72,4,68,"37.0"
"7190","Z29935",1623,144,0,144," 8.9"
"7191","Z29936",5612,770,206,564,"10.0"
"7192","Z29940",1816,294,26,268,"14.8"
"7193","Z29943",181,19,19,0," 0.0"
"7194","Z29944",2300,307,69,238,"10.3"
"7195","Z29945",2041,285,151,134," 6.6"
"7196","Z30002",3074,392,37,355,"11.5"
"7197","Z30004",21751,1061,162,899," 4.1"
"7198","Z30005",12910,626,0,626," 4.8"
"7199","Z30008",11594,1222,23,1199,"10.3"
"7200","Z30009",6327,198,0,198," 3.1"
"7201","Z30011",5203,451,50,401," 7.7"
"7202","Z30012",10324,1508,37,1471,"14.2"
"7203","Z30013",10075,1152,120,1032,"10.2"
"7204","Z30014",14501,1392,257,1135," 7.8"
"7205","Z30016",18763,1757,51,1706," 9.1"
"7206","Z30017",7667,392,18,374," 4.9"
"7207","Z30019",13756,822,132,690," 5.0"
"7208","Z30021",8441,1069,0,1069,"12.7"
"7209","Z30022",24767,1239,230,1009," 4.1"
"7210","Z30024",22365,959,76,883," 3.9"
"7211","Z30025",3778,518,31,487,"12.9"
"7212","Z30028",8055,934,12,922,"11.4"
"7213","Z30030",12295,1124,104,1020," 8.3"
"7214","Z30032",20706,4065,110,3955,"19.1"
"7215","Z30033",14204,1288,187,1101," 7.8"
"7216","Z30034",18146,2732,33,2699,"14.9"
"7217","Z30035",8447,1192,58,1134,"13.4"
"7218","Z30038",16677,1837,0,1837,"11.0"
"7219","Z30039",15297,1343,0,1343," 8.8"
"7220","Z30040",21462,2127,113,2014," 9.4"
"7221","Z30041",21093,2008,462,1546," 7.3"
"7222","Z30043",28531,2049,92,1957," 6.9"
"7223","Z30044",29379,1784,33,1751," 6.0"
"7224","Z30045",10904,1040,52,988," 9.1"
"7225","Z30046",13232,1250,0,1250," 9.4"
"7226","Z30047",20563,1062,20,1042," 5.1"
"7227","Z30052",20857,1511,80,1431," 6.9"
"7228","Z30054",4439,463,71,392," 8.8"
"7229","Z30055",1033,163,85,78," 7.6"
"7230","Z30056",900,84,5,79," 8.8"
"7231","Z30058",22127,3074,101,2973,"13.4"
"7232","Z30060",14166,1966,50,1916,"13.5"
"7233","Z30062",24434,1029,66,963," 3.9"
"7234","Z30064",18678,1099,53,1046," 5.6"
"7235","Z30066",20843,898,240,658," 3.2"
"7236","Z30067",22653,2594,76,2518,"11.1"
"7237","Z30068",12520,470,64,406," 3.2"
"7238","Z30070",208,69,0,69,"33.2"
"7239","Z30071",7872,757,145,612," 7.8"
"7240","Z30072",372,33,0,33," 8.9"
"7241","Z30075",21095,1098,26,1072," 5.1"
"7242","Z30076",17389,1135,128,1007," 5.8"
"7243","Z30078",12000,883,0,883," 7.4"
"7244","Z30079",1415,374,30,344,"24.3"
"7245","Z30080",27335,2281,320,1961," 7.2"
"7246","Z30082",11511,958,82,876," 7.6"
"7247","Z30083",22189,3340,81,3259,"14.7"
"7248","Z30084",14795,1532,67,1465," 9.9"
"7249","Z30087",14266,1072,40,1032," 7.2"
"7250","Z30088",10651,1467,34,1433,"13.5"
"7251","Z30092",14402,1234,155,1079," 7.5"
"7252","Z30093",20472,2357,107,2250,"11.0"
"7253","Z30094",12442,1085,70,1015," 8.2"
"7254","Z30096",26814,1553,77,1476," 5.5"
"7255","Z30097",15751,1110,123,987," 6.3"
"7256","Z30101",20867,1421,38,1383," 6.6"
"7257","Z30102",14214,1156,15,1141," 8.0"
"7258","Z30103",6019,570,125,445," 7.4"
"7259","Z30104",1656,228,0,228,"13.8"
"7260","Z30105",980,166,9,157,"16.0"
"7261","Z30106",8814,1025,12,1013,"11.5"
"7262","Z30107",5363,500,63,437," 8.1"
"7263","Z30108",3296,279,0,279," 8.5"
"7264","Z30110",5296,459,70,389," 7.3"
"7265","Z30113",2781,455,95,360,"12.9"
"7266","Z30114",19560,1340,0,1340," 6.9"
"7267","Z30115",13324,566,16,550," 4.1"
"7268","Z30116",8653,858,14,844," 9.8"
"7269","Z30117",15362,1795,148,1647,"10.7"
"7270","Z30120",15344,1304,115,1189," 7.7"
"7271","Z30121",8673,924,0,924,"10.7"
"7272","Z30122",9708,808,78,730," 7.5"
"7273","Z30124",1342,245,35,210,"15.6"
"7274","Z30125",9549,1293,27,1266,"13.3"
"7275","Z30126",15589,1117,53,1064," 6.8"
"7276","Z30127",21905,1166,77,1089," 5.0"
"7277","Z30132",13072,1077,71,1006," 7.7"
"7278","Z30134",16684,1913,0,1913,"11.5"
"7279","Z30135",22717,1933,208,1725," 7.6"
"7280","Z30139",1715,117,39,78," 4.5"
"7281","Z30141",8148,518,14,504," 6.2"
"7282","Z30143",10602,2305,1335,970," 9.1"
"7283","Z30144",20870,1528,232,1296," 6.2"
"7284","Z30145",3019,433,14,419,"13.9"
"7285","Z30147",2127,360,0,360,"16.9"
"7286","Z30152",15854,960,0,960," 6.1"
"7287","Z30153",7510,800,0,800,"10.7"
"7288","Z30157",17208,1105,5,1100," 6.4"
"7289","Z30161",15825,2654,43,2611,"16.5"
"7290","Z30165",16489,1689,26,1663,"10.1"
"7291","Z30168",10826,1514,0,1514,"14.0"
"7292","Z30170",1213,136,72,64," 5.3"
"7293","Z30171",1401,218,0,218,"15.6"
"7294","Z30173",2369,299,0,299,"12.6"
"7295","Z30176",3018,413,167,246," 8.2"
"7296","Z30177",486,47,0,47," 9.7"
"7297","Z30178",1390,178,0,178,"12.8"
"7298","Z30179",6623,475,28,447," 6.7"
"7299","Z30180",13752,1265,155,1110," 8.1"
"7300","Z30182",1098,171,0,171,"15.6"
"7301","Z30184",2849,196,68,128," 4.5"
"7302","Z30185",1559,207,62,145," 9.3"
"7303","Z30187",3204,218,0,218," 6.8"
"7304","Z30188",21788,1269,91,1178," 5.4"
"7305","Z30189",13828,671,54,617," 4.5"
"7306","Z30204",5303,777,26,751,"14.2"
"7307","Z30205",1155,34,0,34," 2.9"
"7308","Z30206",1094,175,18,157,"14.4"
"7309","Z30213",12381,1293,48,1245,"10.1"
"7310","Z30214",11780,1101,94,1007," 8.5"
"7311","Z30215",12225,426,0,426," 3.5"
"7312","Z30216",955,207,0,207,"21.7"
"7313","Z30218",789,101,25,76," 9.6"
"7314","Z30220",1877,162,28,134," 7.1"
"7315","Z30222",2008,369,7,362,"18.0"
"7316","Z30223",15609,2981,0,2981,"19.1"
"7317","Z30224",10222,1097,38,1059,"10.4"
"7318","Z30228",13943,1459,85,1374," 9.9"
"7319","Z30230",3931,816,75,741,"18.9"
"7320","Z30233",9082,1562,454,1108,"12.2"
"7321","Z30234",761,75,0,75," 9.9"
"7322","Z30236",18873,3043,146,2897,"15.3"
"7323","Z30238",13440,1868,0,1868,"13.9"
"7324","Z30240",12047,1586,379,1207,"10.0"
"7325","Z30241",9761,1154,85,1069,"11.0"
"7326","Z30248",8088,582,35,547," 6.8"
"7327","Z30251",1123,109,0,109," 9.7"
"7328","Z30252",14282,813,24,789," 5.5"
"7329","Z30253",21074,2474,261,2213,"10.5"
"7330","Z30256",993,126,0,126,"12.7"
"7331","Z30257",1872,225,0,225,"12.0"
"7332","Z30258",1098,105,11,94," 8.6"
"7333","Z30259",1200,162,75,87," 7.2"
"7334","Z30260",10069,1419,35,1384,"13.7"
"7335","Z30263",21864,1257,65,1192," 5.5"
"7336","Z30265",12925,667,95,572," 4.4"
"7337","Z30268",3808,632,27,605,"15.9"
"7338","Z30269",13671,963,129,834," 6.1"
"7339","Z30273",5327,520,0,520," 9.8"
"7340","Z30274",13818,1776,7,1769,"12.8"
"7341","Z30276",5455,284,110,174," 3.2"
"7342","Z30277",8066,203,0,203," 2.5"
"7343","Z30281",25907,2535,123,2412," 9.3"
"7344","Z30286",10667,1743,133,1610,"15.1"
"7345","Z30288",3389,470,31,439,"13.0"
"7346","Z30290",3117,96,9,87," 2.8"
"7347","Z30291",9405,1647,133,1514,"16.1"
"7348","Z30292",2389,392,21,371,"15.5"
"7349","Z30293",1416,350,58,292,"20.6"
"7350","Z30294",14905,1521,171,1350," 9.1"
"7351","Z30295",1744,179,13,166," 9.5"
"7352","Z30296",9855,1133,53,1080,"11.0"
"7353","Z30297",10240,2153,49,2104,"20.5"
"7354","Z30303",1460,365,38,327,"22.4"
"7355","Z30305",13699,2876,998,1878,"13.7"
"7356","Z30306",12096,1219,162,1057," 8.7"
"7357","Z30307",9537,813,125,688," 7.2"
"7358","Z30308",11866,1847,465,1382,"11.6"
"7359","Z30309",15873,2977,1219,1758,"11.1"
"7360","Z30310",14798,4402,67,4335,"29.3"
"7361","Z30311",16407,3117,50,3067,"18.7"
"7362","Z30312",12612,1349,178,1171," 9.3"
"7363","Z30313",2431,360,30,330,"13.6"
"7364","Z30314",11256,3992,145,3847,"34.2"
"7365","Z30315",15267,3970,37,3933,"25.8"
"7366","Z30316",15259,2878,156,2722,"17.8"
"7367","Z30317",6127,1040,16,1024,"16.7"
"7368","Z30318",25440,5218,199,5019,"19.7"
"7369","Z30319",19920,1448,275,1173," 5.9"
"7370","Z30324",15796,1582,179,1403," 8.9"
"7371","Z30326",4192,1188,432,756,"18.0"
"7372","Z30327",10306,991,226,765," 7.4"
"7373","Z30328",16514,1519,113,1406," 8.5"
"7374","Z30329",13482,1769,38,1731,"12.8"
"7375","Z30331",26564,4443,138,4305,"16.2"
"7376","Z30336",305,88,0,88,"28.9"
"7377","Z30337",6610,1462,31,1431,"21.6"
"7378","Z30338",14530,1078,140,938," 6.5"
"7379","Z30339",12731,1555,46,1509,"11.9"
"7380","Z30340",10977,1094,24,1070," 9.7"
"7381","Z30341",14926,1895,18,1877,"12.6"
"7382","Z30342",13829,1351,125,1226," 8.9"
"7383","Z30344",16058,3562,101,3461,"21.6"
"7384","Z30345",11045,1394,97,1297,"11.7"
"7385","Z30346",3975,752,0,752,"18.9"
"7386","Z30349",29771,5690,177,5513,"18.5"
"7387","Z30350",17526,1377,51,1326," 7.6"
"7388","Z30354",7499,1494,41,1453,"19.4"
"7389","Z30360",5758,611,12,599,"10.4"
"7390","Z30363",2722,1042,254,788,"28.9"
"7391","Z30401",5738,850,245,605,"10.5"
"7392","Z30410",777,123,24,99,"12.7"
"7393","Z30411",1118,301,59,242,"21.6"
"7394","Z30415",2532,233,140,93," 3.7"
"7395","Z30417",4624,692,123,569,"12.3"
"7396","Z30420",656,152,52,100,"15.2"
"7397","Z30421",1821,261,79,182,"10.0"
"7398","Z30425",730,169,27,142,"19.5"
"7399","Z30427",4762,964,284,680,"14.3"
"7400","Z30428",1321,264,91,173,"13.1"
"7401","Z30429",110,32,0,32,"29.1"
"7402","Z30434",2392,446,114,332,"13.9"
"7403","Z30436",5187,739,151,588,"11.3"
"7404","Z30439",4708,800,283,517,"11.0"
"7405","Z30441",921,184,36,148,"16.1"
"7406","Z30442",3993,1006,360,646,"16.2"
"7407","Z30445",1438,309,101,208,"14.5"
"7408","Z30446",642,78,20,58," 9.0"
"7409","Z30450",1073,147,46,101," 9.4"
"7410","Z30452",690,137,57,80,"11.6"
"7411","Z30453",3132,664,141,523,"16.7"
"7412","Z30456",965,286,62,224,"23.2"
"7413","Z30457",3008,574,95,479,"15.9"
"7414","Z30458",17824,1997,283,1714," 9.6"
"7415","Z30461",5626,714,177,537," 9.5"
"7416","Z30467",5735,1183,397,786,"13.7"
"7417","Z30471",2146,405,86,319,"14.9"
"7418","Z30473",1347,325,66,259,"19.2"
"7419","Z30474",7474,764,222,542," 7.3"
"7420","Z30477",1344,241,41,200,"14.9"
"7421","Z30501",10555,1267,200,1067,"10.1"
"7422","Z30504",8455,700,86,614," 7.3"
"7423","Z30506",17933,2592,1132,1460," 8.1"
"7424","Z30507",9069,810,0,810," 8.9"
"7425","Z30510",2868,571,62,509,"17.7"
"7426","Z30511",1434,112,30,82," 5.7"
"7427","Z30512",12993,5376,4100,1276," 9.8"
"7428","Z30513",7850,3444,2529,915,"11.7"
"7429","Z30516",815,111,4,107,"13.1"
"7430","Z30517",4567,498,97,401," 8.8"
"7431","Z30518",17442,1773,205,1568," 9.0"
"7432","Z30519",13880,927,62,865," 6.2"
"7433","Z30520",2046,356,6,350,"17.1"
"7434","Z30521",2108,291,2,289,"13.7"
"7435","Z30523",6689,1807,1130,677,"10.1"
"7436","Z30525",5064,2138,1434,704,"13.9"
"7437","Z30527",1737,179,23,156," 9.0"
"7438","Z30528",11916,2785,1365,1420,"11.9"
"7439","Z30529",4069,616,44,572,"14.1"
"7440","Z30531",4510,797,17,780,"17.3"
"7441","Z30533",11094,1655,709,946," 8.5"
"7442","Z30534",12086,2138,1134,1004," 8.3"
"7443","Z30535",2890,484,24,460,"15.9"
"7444","Z30536",4655,1417,1025,392," 8.4"
"7445","Z30537",1702,1025,771,254,"14.9"
"7446","Z30538",1141,171,0,171,"15.0"
"7447","Z30540",10241,3432,1664,1768,"17.3"
"7448","Z30541",773,133,91,42," 5.4"
"7449","Z30542",12594,1018,100,918," 7.3"
"7450","Z30543",1688,249,0,249,"14.8"
"7451","Z30545",1126,795,489,306,"27.2"
"7452","Z30546",5638,2778,1915,863,"15.3"
"7453","Z30547",1263,109,34,75," 5.9"
"7454","Z30548",6598,420,111,309," 4.7"
"7455","Z30549",8847,779,150,629," 7.1"
"7456","Z30553",4216,1397,823,574,"13.6"
"7457","Z30554",3280,520,0,520,"15.9"
"7458","Z30555",1377,471,309,162,"11.8"
"7459","Z30557",2477,786,351,435,"17.6"
"7460","Z30558",2374,242,10,232," 9.8"
"7461","Z30559",2995,1142,777,365,"12.2"
"7462","Z30560",3321,1669,1118,551,"16.6"
"7463","Z30562",673,243,39,204,"30.3"
"7464","Z30563",2393,292,52,240,"10.0"
"7465","Z30564",1562,297,191,106," 6.8"
"7466","Z30565",1764,266,56,210,"11.9"
"7467","Z30566",3290,374,122,252," 7.7"
"7468","Z30567",1326,169,31,138,"10.4"
"7469","Z30568",1082,184,140,44," 4.1"
"7470","Z30571",3054,1188,818,370,"12.1"
"7471","Z30572",990,515,442,73," 7.4"
"7472","Z30573",99,25,20,5," 5.1"
"7473","Z30575",322,15,0,15," 4.7"
"7474","Z30576",1443,483,327,156,"10.8"
"7475","Z30577",10752,2681,462,2219,"20.6"
"7476","Z30582",2605,939,676,263,"10.1"
"7477","Z30601",9939,1639,242,1397,"14.1"
"7478","Z30605",17527,2885,452,2433,"13.9"
"7479","Z30606",19177,2727,183,2544,"13.3"
"7480","Z30607",4458,1024,36,988,"22.2"
"7481","Z30619",505,30,9,21," 4.2"
"7482","Z30620",4455,438,7,431," 9.7"
"7483","Z30621",1807,149,0,149," 8.2"
"7484","Z30622",4377,497,131,366," 8.4"
"7485","Z30625",1294,313,232,81," 6.3"
"7486","Z30627",1175,298,73,225,"19.1"
"7487","Z30628",2640,205,8,197," 7.5"
"7488","Z30629",1992,282,23,259,"13.0"
"7489","Z30630",927,61,17,44," 4.7"
"7490","Z30631",1055,329,181,148,"14.0"
"7491","Z30633",3680,573,48,525,"14.3"
"7492","Z30634",865,196,15,181,"20.9"
"7493","Z30635",7649,1503,334,1169,"15.3"
"7494","Z30641",744,53,12,41," 5.5"
"7495","Z30642",6371,1677,1203,474," 7.4"
"7496","Z30643",8592,2046,1073,973,"11.3"
"7497","Z30646",2838,366,0,366,"12.9"
"7498","Z30648",1433,168,52,116," 8.1"
"7499","Z30650",4757,678,142,536,"11.3"
"7500","Z30655",9623,1326,162,1164,"12.1"
"7501","Z30656",5941,362,0,362," 6.1"
"7502","Z30660",650,219,78,141,"21.7"
"7503","Z30662",3889,505,31,474,"12.2"
"7504","Z30663",1300,147,46,101," 7.8"
"7505","Z30666",3472,430,0,430,"12.4"
"7506","Z30667",443,80,43,37," 8.4"
"7507","Z30669",1625,361,85,276,"17.0"
"7508","Z30673",3797,695,323,372," 9.8"
"7509","Z30677",6653,506,40,466," 7.0"
"7510","Z30680",14719,1667,58,1609,"10.9"
"7511","Z30683",3003,398,16,382,"12.7"
"7512","Z30701",15777,2121,48,2073,"13.1"
"7513","Z30705",13439,1225,49,1176," 8.8"
"7514","Z30710",2693,337,73,264," 9.8"
"7515","Z30711",1545,224,8,216,"14.0"
"7516","Z30720",11344,1626,76,1550,"13.7"
"7517","Z30721",19681,2575,12,2563,"13.0"
"7518","Z30725",2040,427,0,427,"20.9"
"7519","Z30728",8844,1333,59,1274,"14.4"
"7520","Z30730",793,86,8,78," 9.8"
"7521","Z30734",1378,242,63,179,"13.0"
"7522","Z30735",2292,298,0,298,"13.0"
"7523","Z30736",16475,1735,347,1388," 8.4"
"7524","Z30738",2003,387,142,245,"12.2"
"7525","Z30739",1893,191,50,141," 7.4"
"7526","Z30740",3370,331,51,280," 8.3"
"7527","Z30741",13855,1758,105,1653,"11.9"
"7528","Z30742",3383,372,49,323," 9.5"
"7529","Z30747",6753,873,26,847,"12.5"
"7530","Z30750",1492,173,56,117," 7.8"
"7531","Z30752",4085,528,47,481,"11.8"
"7532","Z30753",2863,342,8,334,"11.7"
"7533","Z30755",3558,408,108,300," 8.4"
"7534","Z30756",80,11,0,11,"13.8"
"7535","Z30757",920,165,15,150,"16.3"
"7536","Z30802",2480,509,284,225," 9.1"
"7537","Z30803",384,95,45,50,"13.0"
"7538","Z30805",1104,147,26,121,"11.0"
"7539","Z30808",1771,191,50,141," 8.0"
"7540","Z30809",15617,1611,374,1237," 7.9"
"7541","Z30810",938,188,62,126,"13.4"
"7542","Z30813",13496,2111,253,1858,"13.8"
"7543","Z30814",3463,504,198,306," 8.8"
"7544","Z30815",14985,1579,133,1446," 9.6"
"7545","Z30816",983,238,167,71," 7.2"
"7546","Z30817",4209,966,731,235," 5.6"
"7547","Z30820",721,244,133,111,"15.4"
"7548","Z30823",769,141,4,137,"17.8"
"7549","Z30824",7439,949,303,646," 8.7"
"7550","Z30828",2132,542,232,310,"14.5"
"7551","Z30830",5903,854,158,696,"11.8"
"7552","Z30833",1622,285,106,179,"11.0"
"7553","Z30901",8686,2285,32,2253,"25.9"
"7554","Z30903",297,36,0,36,"12.1"
"7555","Z30904",12934,2985,268,2717,"21.0"
"7556","Z30905",1202,75,0,75," 6.2"
"7557","Z30906",23184,3218,55,3163,"13.6"
"7558","Z30907",21656,2881,508,2373,"11.0"
"7559","Z30909",21344,4208,563,3645,"17.1"
"7560","Z31001",1363,313,98,215,"15.8"
"7561","Z31002",1230,190,15,175,"14.2"
"7562","Z31005",6381,204,29,175," 2.7"
"7563","Z31006",2409,589,44,545,"22.6"
"7564","Z31008",7534,537,68,469," 6.2"
"7565","Z31009",705,134,16,118,"16.7"
"7566","Z31012",803,216,66,150,"18.7"
"7567","Z31014",5500,1103,226,877,"15.9"
"7568","Z31015",10092,1942,575,1367,"13.5"
"7569","Z31017",854,191,78,113,"13.2"
"7570","Z31018",621,134,67,67,"10.8"
"7571","Z31019",1042,210,26,184,"17.7"
"7572","Z31021",12188,1882,334,1548,"12.7"
"7573","Z31022",627,94,40,54," 8.6"
"7574","Z31023",7009,1149,156,993,"14.2"
"7575","Z31024",12046,3957,2440,1517,"12.6"
"7576","Z31025",645,106,29,77,"11.9"
"7577","Z31027",4559,886,189,697,"15.3"
"7578","Z31028",2402,440,49,391,"16.3"
"7579","Z31029",6544,710,89,621," 9.5"
"7580","Z31030",7281,1057,77,980,"13.5"
"7581","Z31031",2772,590,109,481,"17.4"
"7582","Z31032",5476,448,93,355," 6.5"
"7583","Z31033",1304,386,0,386,"29.6"
"7584","Z31035",573,99,5,94,"16.4"
"7585","Z31036",5214,865,106,759,"14.6"
"7586","Z31037",1575,353,74,279,"17.7"
"7587","Z31042",772,191,70,121,"15.7"
"7588","Z31044",1499,401,85,316,"21.1"
"7589","Z31046",1367,201,65,136," 9.9"
"7590","Z31047",4452,360,129,231," 5.2"
"7591","Z31049",844,194,119,75," 8.9"
"7592","Z31052",3689,505,50,455,"12.3"
"7593","Z31054",865,252,76,176,"20.3"
"7594","Z31055",3208,739,9,730,"22.8"
"7595","Z31057",1034,260,79,181,"17.5"
"7596","Z31058",936,322,84,238,"25.4"
"7597","Z31060",1286,323,73,250,"19.4"
"7598","Z31061",19638,4169,1103,3066,"15.6"
"7599","Z31063",2418,491,71,420,"17.4"
"7600","Z31064",4248,694,208,486,"11.4"
"7601","Z31065",505,184,62,122,"24.2"
"7602","Z31068",1815,423,138,285,"15.7"
"7603","Z31069",8012,1101,89,1012,"12.6"
"7604","Z31070",445,73,6,67,"15.1"
"7605","Z31072",687,149,44,105,"15.3"
"7606","Z31075",1198,208,65,143,"11.9"
"7607","Z31076",1644,268,20,248,"15.1"
"7608","Z31077",744,183,33,150,"20.2"
"7609","Z31078",1416,226,4,222,"15.7"
"7610","Z31079",1093,211,28,183,"16.7"
"7611","Z31082",4675,876,85,791,"16.9"
"7612","Z31085",469,76,0,76,"16.2"
"7613","Z31087",5407,2557,1812,745,"13.8"
"7614","Z31088",21488,1893,145,1748," 8.1"
"7615","Z31089",2198,501,96,405,"18.4"
"7616","Z31090",493,249,46,203,"41.2"
"7617","Z31091",1672,292,52,240,"14.4"
"7618","Z31092",3438,717,143,574,"16.7"
"7619","Z31093",13295,1871,98,1773,"13.3"
"7620","Z31094",566,116,27,89,"15.7"
"7621","Z31096",2981,663,226,437,"14.7"
"7622","Z31097",589,119,42,77,"13.1"
"7623","Z31098",976,32,0,32," 3.3"
"7624","Z31201",4506,1098,13,1085,"24.1"
"7625","Z31204",15473,3519,206,3313,"21.4"
"7626","Z31206",12642,3091,84,3007,"23.8"
"7627","Z31210",14292,1399,176,1223," 8.6"
"7628","Z31211",7764,1475,50,1425,"18.4"
"7629","Z31216",6196,555,57,498," 8.0"
"7630","Z31217",7889,1617,161,1456,"18.5"
"7631","Z31220",5867,738,61,677,"11.5"
"7632","Z31301",2148,474,22,452,"21.0"
"7633","Z31302",3268,169,20,149," 4.6"
"7634","Z31303",1002,201,58,143,"14.3"
"7635","Z31305",3206,685,324,361,"11.3"
"7636","Z31307",459,76,15,61,"13.3"
"7637","Z31312",6232,686,80,606," 9.7"
"7638","Z31313",18358,2845,0,2845,"15.5"
"7639","Z31315",2743,312,0,312,"11.4"
"7640","Z31316",4224,763,45,718,"17.0"
"7641","Z31320",4097,634,363,271," 6.6"
"7642","Z31321",2831,258,107,151," 5.3"
"7643","Z31322",9506,652,0,652," 6.9"
"7644","Z31323",676,128,11,117,"17.3"
"7645","Z31324",8401,773,272,501," 6.0"
"7646","Z31326",7320,528,106,422," 5.8"
"7647","Z31328",3487,2131,926,1205,"34.6"
"7648","Z31329",3328,321,35,286," 8.6"
"7649","Z31331",5566,2973,1745,1228,"22.1"
"7650","Z31401",10696,2424,406,2018,"18.9"
"7651","Z31404",13110,1817,126,1691,"12.9"
"7652","Z31405",15977,2197,242,1955,"12.2"
"7653","Z31406",15042,1617,127,1490," 9.9"
"7654","Z31408",3864,505,41,464,"12.0"
"7655","Z31410",10631,722,213,509," 4.8"
"7656","Z31411",4311,686,155,531,"12.3"
"7657","Z31415",5481,1039,5,1034,"18.9"
"7658","Z31419",23571,2509,302,2207," 9.4"
"7659","Z31501",7033,1139,134,1005,"14.3"
"7660","Z31503",9193,1219,138,1081,"11.8"
"7661","Z31510",4246,709,169,540,"12.7"
"7662","Z31512",1171,209,31,178,"15.2"
"7663","Z31513",7289,1272,405,867,"11.9"
"7664","Z31516",6250,836,206,630,"10.1"
"7665","Z31518",296,72,41,31,"10.5"
"7666","Z31519",1618,270,36,234,"14.5"
"7667","Z31520",10331,1550,79,1471,"14.2"
"7668","Z31522",11357,4057,2905,1152,"10.1"
"7669","Z31523",5625,563,94,469," 8.3"
"7670","Z31525",12549,1900,406,1494,"11.9"
"7671","Z31532",364,41,0,41,"11.3"
"7672","Z31533",7279,1361,48,1313,"18.0"
"7673","Z31535",4338,281,8,273," 6.3"
"7674","Z31537",3610,669,361,308," 8.5"
"7675","Z31539",6096,960,82,878,"14.4"
"7676","Z31542",1203,92,57,35," 2.9"
"7677","Z31543",1947,329,121,208,"10.7"
"7678","Z31544",541,256,69,187,"34.6"
"7679","Z31545",6774,1087,179,908,"13.4"
"7680","Z31546",2802,488,35,453,"16.2"
"7681","Z31548",8396,728,88,640," 7.6"
"7682","Z31549",1380,383,120,263,"19.1"
"7683","Z31550",464,159,0,159,"34.3"
"7684","Z31551",427,27,18,9," 2.1"
"7685","Z31553",2235,439,123,316,"14.1"
"7686","Z31554",2322,521,98,423,"18.2"
"7687","Z31555",1196,271,13,258,"21.6"
"7688","Z31557",1243,208,44,164,"13.2"
"7689","Z31558",8736,1134,230,904,"10.3"
"7690","Z31560",1234,166,63,103," 8.3"
"7691","Z31562",939,243,47,196,"20.9"
"7692","Z31563",851,270,82,188,"22.1"
"7693","Z31566",1828,471,276,195,"10.7"
"7694","Z31567",325,70,13,57,"17.5"
"7695","Z31568",552,183,138,45," 8.2"
"7696","Z31569",2365,335,95,240,"10.1"
"7697","Z31601",13742,2002,185,1817,"13.2"
"7698","Z31602",15144,1936,202,1734,"11.5"
"7699","Z31605",8568,910,68,842," 9.8"
"7700","Z31606",1524,253,17,236,"15.5"
"7701","Z31620",4394,596,21,575,"13.1"
"7702","Z31631",284,70,32,38,"13.4"
"7703","Z31632",4270,433,51,382," 8.9"
"7704","Z31634",2472,274,15,259,"10.5"
"7705","Z31635",2596,456,30,426,"16.4"
"7706","Z31636",4215,674,108,566,"13.4"
"7707","Z31637",1423,209,57,152,"10.7"
"7708","Z31638",541,116,52,64,"11.8"
"7709","Z31639",4764,909,18,891,"18.7"
"7710","Z31641",710,81,0,81,"11.4"
"7711","Z31642",1990,384,81,303,"15.2"
"7712","Z31643",4230,766,183,583,"13.8"
"7713","Z31645",2451,305,10,295,"12.0"
"7714","Z31647",1555,294,18,276,"17.7"
"7715","Z31649",477,34,5,29," 6.1"
"7716","Z31650",1505,297,62,235,"15.6"
"7717","Z31701",9509,1645,119,1526,"16.0"
"7718","Z31705",13215,1941,135,1806,"13.7"
"7719","Z31707",12475,1485,126,1359,"10.9"
"7720","Z31709",6839,929,131,798,"11.7"
"7721","Z31714",2995,716,116,600,"20.0"
"7722","Z31716",1093,123,33,90," 8.2"
"7723","Z31719",4059,630,185,445,"11.0"
"7724","Z31721",8122,471,44,427," 5.3"
"7725","Z31730",4005,396,124,272," 6.8"
"7726","Z31733",741,88,0,88,"11.9"
"7727","Z31735",766,371,255,116,"15.1"
"7728","Z31738",915,85,14,71," 7.8"
"7729","Z31744",1241,225,35,190,"15.3"
"7730","Z31749",982,150,0,150,"15.3"
"7731","Z31750",8375,1565,153,1412,"16.9"
"7732","Z31757",4375,392,28,364," 8.3"
"7733","Z31763",8675,404,0,404," 4.7"
"7734","Z31764",641,138,5,133,"20.7"
"7735","Z31765",1305,99,6,93," 7.1"
"7736","Z31768",9538,1435,258,1177,"12.3"
"7737","Z31771",2151,215,29,186," 8.6"
"7738","Z31773",1570,261,92,169,"10.8"
"7739","Z31774",2729,522,55,467,"17.1"
"7740","Z31775",1244,175,4,171,"13.7"
"7741","Z31778",1272,206,53,153,"12.0"
"7742","Z31779",3394,284,170,114," 3.4"
"7743","Z31780",957,165,32,133,"13.9"
"7744","Z31781",774,84,7,77," 9.9"
"7745","Z31788",4223,618,71,547,"13.0"
"7746","Z31789",503,33,4,29," 5.8"
"7747","Z31790",678,78,12,66," 9.7"
"7748","Z31791",5250,637,87,550,"10.5"
"7749","Z31792",11314,1722,246,1476,"13.0"
"7750","Z31793",3605,480,0,480,"13.3"
"7751","Z31794",10962,1653,63,1590,"14.5"
"7752","Z31795",959,107,4,103,"10.7"
"7753","Z31796",623,168,129,39," 6.3"
"7754","Z31798",414,69,13,56,"13.5"
"7755","Z31803",2972,714,178,536,"18.0"
"7756","Z31804",2132,154,37,117," 5.5"
"7757","Z31805",1318,268,0,268,"20.3"
"7758","Z31806",2125,274,95,179," 8.4"
"7759","Z31807",1033,17,17,0," 0.0"
"7760","Z31808",2662,207,127,80," 3.0"
"7761","Z31811",2329,415,219,196," 8.4"
"7762","Z31812",271,80,10,70,"25.8"
"7763","Z31816",2613,599,64,535,"20.5"
"7764","Z31820",3478,247,19,228," 6.6"
"7765","Z31822",2677,521,261,260," 9.7"
"7766","Z31824",963,227,81,146,"15.2"
"7767","Z31825",1221,247,95,152,"12.4"
"7768","Z31826",1070,139,0,139,"13.0"
"7769","Z31827",1209,253,6,247,"20.4"
"7770","Z31829",545,183,0,183,"33.6"
"7771","Z31830",1041,234,61,173,"16.6"
"7772","Z31831",1635,455,73,382,"23.4"
"7773","Z31833",3490,445,132,313," 9.0"
"7774","Z31836",517,107,12,95,"18.4"
"7775","Z31901",4069,730,47,683,"16.8"
"7776","Z31903",9469,1799,57,1742,"18.4"
"7777","Z31904",15252,1979,284,1695,"11.1"
"7778","Z31905",4233,900,87,813,"19.2"
"7779","Z31906",10628,1801,387,1414,"13.3"
"7780","Z31907",22563,2631,261,2370,"10.5"
"7781","Z31909",15735,1029,222,807," 5.1"
"7782","Z32008",2938,811,522,289," 9.8"
"7783","Z32009",1224,110,24,86," 7.0"
"7784","Z32011",5443,582,92,490," 9.0"
"7785","Z32024",7769,1235,185,1050,"13.5"
"7786","Z32025",8796,1330,181,1149,"13.1"
"7787","Z32033",1854,160,20,140," 7.6"
"7788","Z32034",19102,5617,4297,1320," 6.9"
"7789","Z32038",4219,866,349,517,"12.3"
"7790","Z32040",2857,478,188,290,"10.2"
"7791","Z32043",9832,1136,97,1039,"10.6"
"7792","Z32046",3562,332,8,324," 9.1"
"7793","Z32052",3012,514,69,445,"14.8"
"7794","Z32053",1853,343,70,273,"14.7"
"7795","Z32054",3821,483,10,473,"12.4"
"7796","Z32055",7097,1145,159,986,"13.9"
"7797","Z32058",1514,249,11,238,"15.7"
"7798","Z32059",1145,274,41,233,"20.3"
"7799","Z32060",9824,1526,604,922," 9.4"
"7800","Z32062",1105,148,21,127,"11.5"
"7801","Z32063",5014,708,0,708,"14.1"
"7802","Z32064",3015,551,74,477,"15.8"
"7803","Z32065",12945,1061,41,1020," 7.9"
"7804","Z32066",2388,405,122,283,"11.9"
"7805","Z32068",19111,1992,394,1598," 8.4"
"7806","Z32073",16206,1438,385,1053," 6.5"
"7807","Z32079",236,46,0,46,"19.5"
"7808","Z32080",15744,5825,4636,1189," 7.6"
"7809","Z32081",2560,239,76,163," 6.4"
"7810","Z32082",15565,2521,1909,612," 3.9"
"7811","Z32084",14730,2273,868,1405," 9.5"
"7812","Z32086",12214,1184,562,622," 5.1"
"7813","Z32087",1545,198,54,144," 9.3"
"7814","Z32091",6975,1418,296,1122,"16.1"
"7815","Z32092",12048,1640,882,758," 6.3"
"7816","Z32095",3296,454,188,266," 8.1"
"7817","Z32096",1306,274,69,205,"15.7"
"7818","Z32097",6307,719,160,559," 8.9"
"7819","Z32102",1864,821,683,138," 7.4"
"7820","Z32110",3717,901,360,541,"14.6"
"7821","Z32112",4042,1239,657,582,"14.4"
"7822","Z32113",2717,645,214,431,"15.9"
"7823","Z32114",16481,3530,1448,2082,"12.6"
"7824","Z32117",12529,3029,1246,1783,"14.2"
"7825","Z32118",15985,7459,5469,1990,"12.4"
"7826","Z32119",11953,2488,1277,1211,"10.1"
"7827","Z32124",1537,304,200,104," 6.8"
"7828","Z32127",16307,3685,2436,1249," 7.7"
"7829","Z32128",8390,1102,715,387," 4.6"
"7830","Z32129",10790,1674,689,985," 9.1"
"7831","Z32130",2285,474,162,312,"13.7"
"7832","Z32131",2110,415,97,318,"15.1"
"7833","Z32132",3697,814,356,458,"12.4"
"7834","Z32134",5914,2844,1934,910,"15.4"
"7835","Z32136",5255,2088,1762,326," 6.2"
"7836","Z32137",21078,6183,4519,1664," 7.9"
"7837","Z32139",819,341,240,101,"12.3"
"7838","Z32140",768,388,195,193,"25.1"
"7839","Z32141",8822,1507,709,798," 9.0"
"7840","Z32145",2213,436,59,377,"17.0"
"7841","Z32147",121,42,21,21,"17.4"
"7842","Z32148",5382,1314,581,733,"13.6"
"7843","Z32159",18614,3585,2490,1095," 5.9"
"7844","Z32162",35694,6113,5184,929," 2.6"
"7845","Z32164",18196,2968,1981,987," 5.4"
"7846","Z32168",12961,2198,1401,797," 6.1"
"7847","Z32169",11180,6236,4930,1306,"11.7"
"7848","Z32174",24028,4190,2189,2001," 8.3"
"7849","Z32176",10558,3794,2974,820," 7.8"
"7850","Z32177",11647,1885,150,1735,"14.9"
"7851","Z32179",4527,1632,766,866,"19.1"
"7852","Z32180",1547,255,135,120," 7.8"
"7853","Z32181",1110,404,186,218,"19.6"
"7854","Z32187",743,28,28,0," 0.0"
"7855","Z32190",437,161,59,102,"23.3"
"7856","Z32193",755,317,192,125,"16.6"
"7857","Z32195",1425,176,85,91," 6.4"
"7858","Z32202",2124,441,73,368,"17.3"
"7859","Z32204",4385,809,31,778,"17.7"
"7860","Z32205",14719,2009,195,1814,"12.3"
"7861","Z32206",9141,2486,54,2432,"26.6"
"7862","Z32207",16620,2360,272,2088,"12.6"
"7863","Z32208",14649,2709,135,2574,"17.6"
"7864","Z32209",17095,4707,267,4440,"26.0"
"7865","Z32210",26644,3678,474,3204,"12.0"
"7866","Z32211",14831,2795,73,2722,"18.4"
"7867","Z32216",17329,2047,112,1935,"11.2"
"7868","Z32217",9554,1505,120,1385,"14.5"
"7869","Z32218",22346,2376,74,2302,"10.3"
"7870","Z32219",4598,639,0,639,"13.9"
"7871","Z32220",5227,841,0,841,"16.1"
"7872","Z32221",10546,1013,80,933," 8.8"
"7873","Z32222",3651,413,0,413,"11.3"
"7874","Z32223",10101,618,212,406," 4.0"
"7875","Z32224",16811,2325,413,1912,"11.4"
"7876","Z32225",21576,2124,224,1900," 8.8"
"7877","Z32226",6328,521,75,446," 7.0"
"7878","Z32233",10606,1648,427,1221,"11.5"
"7879","Z32234",2715,389,101,288,"10.6"
"7880","Z32244",24141,2890,243,2647,"11.0"
"7881","Z32246",21450,2430,428,2002," 9.3"
"7882","Z32250",14199,2266,1089,1177," 8.3"
"7883","Z32254",5995,1438,71,1367,"22.8"
"7884","Z32256",20844,2238,199,2039," 9.8"
"7885","Z32257",16860,2014,70,1944,"11.5"
"7886","Z32258",11696,949,61,888," 7.6"
"7887","Z32259",14589,852,197,655," 4.5"
"7888","Z32266",3616,668,179,489,"13.5"
"7889","Z32277",13238,2232,181,2051,"15.5"
"7890","Z32301",14666,1907,116,1791,"12.2"
"7891","Z32303",22620,3194,161,3033,"13.4"
"7892","Z32304",20335,3336,46,3290,"16.2"
"7893","Z32305",9131,1473,86,1387,"15.2"
"7894","Z32308",11027,800,96,704," 6.4"
"7895","Z32309",12788,869,43,826," 6.5"
"7896","Z32310",8152,1609,143,1466,"18.0"
"7897","Z32311",8721,841,80,761," 8.7"
"7898","Z32312",12976,764,73,691," 5.3"
"7899","Z32317",5490,288,12,276," 5.0"
"7900","Z32320",1929,549,123,426,"22.1"
"7901","Z32321",2406,742,323,419,"17.4"
"7902","Z32322",2243,937,640,297,"13.2"
"7903","Z32324",1829,298,53,245,"13.4"
"7904","Z32327",10427,1251,438,813," 7.8"
"7905","Z32328",2964,1691,1416,275," 9.3"
"7906","Z32330",250,25,6,19," 7.6"
"7907","Z32331",2133,435,89,346,"16.2"
"7908","Z32333",5089,605,113,492," 9.7"
"7909","Z32334",1003,234,38,196,"19.5"
"7910","Z32336",915,232,129,103,"11.3"
"7911","Z32340",4640,919,240,679,"14.6"
"7912","Z32343",1400,168,36,132," 9.4"
"7913","Z32344",5835,1099,241,858,"14.7"
"7914","Z32346",1735,1012,712,300,"17.3"
"7915","Z32347",3714,686,105,581,"15.6"
"7916","Z32348",4693,1157,510,647,"13.8"
"7917","Z32350",734,151,51,100,"13.6"
"7918","Z32351",7552,866,136,730," 9.7"
"7919","Z32352",2539,360,0,360,"14.2"
"7920","Z32355",192,72,55,17," 8.9"
"7921","Z32358",1503,594,444,150,"10.0"
"7922","Z32359",2254,1469,965,504,"22.4"
"7923","Z32401",11676,2247,229,2018,"17.3"
"7924","Z32403",970,159,0,159,"16.4"
"7925","Z32404",16514,2917,484,2433,"14.7"
"7926","Z32405",14387,1976,353,1623,"11.3"
"7927","Z32407",7745,3697,1874,1823,"23.5"
"7928","Z32408",16615,9574,5458,4116,"24.8"
"7929","Z32409",3727,375,152,223," 6.0"
"7930","Z32410",1545,1023,729,294,"19.0"
"7931","Z32413",16275,10196,7486,2710,"16.7"
"7932","Z32421",2069,292,65,227,"11.0"
"7933","Z32423",605,207,34,173,"28.6"
"7934","Z32424",2633,489,68,421,"16.0"
"7935","Z32425",5844,1261,192,1069,"18.3"
"7936","Z32426",431,101,23,78,"18.1"
"7937","Z32428",6875,1358,375,983,"14.3"
"7938","Z32431",2113,449,68,381,"18.0"
"7939","Z32433",7144,1391,343,1048,"14.7"
"7940","Z32435",3679,897,102,795,"21.6"
"7941","Z32437",497,223,30,193,"38.8"
"7942","Z32438",2086,714,227,487,"23.3"
"7943","Z32439",4188,1002,479,523,"12.5"
"7944","Z32440",2553,476,56,420,"16.5"
"7945","Z32442",1768,350,36,314,"17.8"
"7946","Z32443",1490,492,113,379,"25.4"
"7947","Z32444",8473,706,54,652," 7.7"
"7948","Z32446",4750,1045,249,796,"16.8"
"7949","Z32448",4760,817,202,615,"12.9"
"7950","Z32449",380,80,45,35," 9.2"
"7951","Z32455",2239,530,176,354,"15.8"
"7952","Z32456",5893,2790,2048,742,"12.6"
"7953","Z32459",12701,7220,6097,1123," 8.8"
"7954","Z32460",1655,287,33,254,"15.3"
"7955","Z32462",2004,816,348,468,"23.4"
"7956","Z32465",3646,1268,696,572,"15.7"
"7957","Z32466",2734,610,226,384,"14.0"
"7958","Z32501",5492,1076,139,937,"17.1"
"7959","Z32502",1714,436,65,371,"21.6"
"7960","Z32503",13321,1433,394,1039," 7.8"
"7961","Z32504",10700,1257,192,1065,"10.0"
"7962","Z32505",12766,2653,37,2616,"20.5"
"7963","Z32506",16282,2651,257,2394,"14.7"
"7964","Z32507",17047,5471,2887,2584,"15.2"
"7965","Z32508",500,50,0,50,"10.0"
"7966","Z32514",18241,2156,131,2025,"11.1"
"7967","Z32526",15521,1920,199,1721,"11.1"
"7968","Z32531",2544,564,0,564,"22.2"
"7969","Z32533",10927,1144,166,978," 9.0"
"7970","Z32534",6653,939,0,939,"14.1"
"7971","Z32535",2157,420,61,359,"16.6"
"7972","Z32536",9242,1087,143,944,"10.2"
"7973","Z32539",10422,1535,163,1372,"13.2"
"7974","Z32541",15438,8084,6528,1556,"10.1"
"7975","Z32542",853,223,0,223,"26.1"
"7976","Z32547",15847,1413,63,1350," 8.5"
"7977","Z32548",12427,3734,1990,1744,"14.0"
"7978","Z32550",13006,9614,9250,364," 2.8"
"7979","Z32561",6288,2715,1717,998,"15.9"
"7980","Z32563",10431,1030,218,812," 7.8"
"7981","Z32564",1315,296,12,284,"21.6"
"7982","Z32565",2462,315,18,297,"12.1"
"7983","Z32566",16402,3143,990,2153,"13.1"
"7984","Z32567",1712,367,94,273,"15.9"
"7985","Z32568",1264,193,43,150,"11.9"
"7986","Z32569",5442,722,69,653,"12.0"
"7987","Z32570",12616,1241,167,1074," 8.5"
"7988","Z32571",12112,973,177,796," 6.6"
"7989","Z32577",1863,196,56,140," 7.5"
"7990","Z32578",13539,1213,365,848," 6.3"
"7991","Z32579",4886,363,24,339," 6.9"
"7992","Z32580",1794,220,0,220,"12.3"
"7993","Z32583",9949,1188,360,828," 8.3"
"7994","Z32601",9182,1463,47,1416,"15.4"
"7995","Z32603",2422,358,0,358,"14.8"
"7996","Z32605",10459,939,0,939," 9.0"
"7997","Z32606",10600,1193,48,1145,"10.8"
"7998","Z32607",14802,2919,45,2874,"19.4"
"7999","Z32608",23245,3890,165,3725,"16.0"
"8000","Z32609",7999,1488,47,1441,"18.0"
"8001","Z32615",6916,895,0,895,"12.9"
"8002","Z32616",464,69,0,69,"14.9"
"8003","Z32617",1717,175,61,114," 6.6"
"8004","Z32618",3336,310,84,226," 6.8"
"8005","Z32621",2513,477,89,388,"15.4"
"8006","Z32622",576,136,21,115,"20.0"
"8007","Z32625",1115,462,254,208,"18.7"
"8008","Z32626",4213,784,279,505,"12.0"
"8009","Z32628",1749,310,43,267,"15.3"
"8010","Z32640",5866,1382,550,832,"14.2"
"8011","Z32641",5290,781,36,745,"14.1"
"8012","Z32643",4941,909,17,892,"18.1"
"8013","Z32648",553,364,324,40," 7.2"
"8014","Z32653",6142,419,21,398," 6.5"
"8015","Z32656",6638,1352,319,1033,"15.6"
"8016","Z32666",3211,794,483,311," 9.7"
"8017","Z32667",1751,133,38,95," 5.4"
"8018","Z32669",5073,835,0,835,"16.5"
"8019","Z32680",5685,1669,758,911,"16.0"
"8020","Z32686",2638,646,262,384,"14.6"
"8021","Z32692",789,593,532,61," 7.7"
"8022","Z32693",5102,737,168,569,"11.2"
"8023","Z32694",998,159,53,106,"10.6"
"8024","Z32696",5184,969,324,645,"12.4"
"8025","Z32697",167,51,5,46,"27.5"
"8026","Z32701",11534,2950,511,2439,"21.1"
"8027","Z32702",1405,257,90,167,"11.9"
"8028","Z32703",18713,2574,528,2046,"10.9"
"8029","Z32707",16683,2547,73,2474,"14.8"
"8030","Z32708",16902,1923,281,1642," 9.7"
"8031","Z32712",17117,1825,751,1074," 6.3"
"8032","Z32713",9054,1040,507,533," 5.9"
"8033","Z32714",17231,4359,540,3819,"22.2"
"8034","Z32720",13660,2265,511,1754,"12.8"
"8035","Z32724",14570,2359,859,1500,"10.3"
"8036","Z32725",18433,2492,853,1639," 8.9"
"8037","Z32726",9677,1768,910,858," 8.9"
"8038","Z32730",2492,205,19,186," 7.5"
"8039","Z32732",2109,585,121,464,"22.0"
"8040","Z32736",4022,684,302,382," 9.5"
"8041","Z32738",16769,1877,608,1269," 7.6"
"8042","Z32744",1732,301,123,178,"10.3"
"8043","Z32746",18441,3586,481,3105,"16.8"
"8044","Z32750",8803,939,279,660," 7.5"
"8045","Z32751",10023,1536,105,1431,"14.3"
"8046","Z32754",5034,1071,511,560,"11.1"
"8047","Z32757",12918,2567,1032,1535,"11.9"
"8048","Z32759",1424,362,211,151,"10.6"
"8049","Z32763",10282,1581,583,998," 9.7"
"8050","Z32764",1564,269,92,177,"11.3"
"8051","Z32765",21045,2040,188,1852," 8.8"
"8052","Z32766",5129,451,98,353," 6.9"
"8053","Z32771",22436,5261,371,4890,"21.8"
"8054","Z32773",13371,3530,265,3265,"24.4"
"8055","Z32776",4041,397,94,303," 7.5"
"8056","Z32778",10574,2277,1491,786," 7.4"
"8057","Z32779",11475,1212,230,982," 8.6"
"8058","Z32780",19125,4254,1592,2662,"13.9"
"8059","Z32784",4977,975,398,577,"11.6"
"8060","Z32789",11963,1829,501,1328,"11.1"
"8061","Z32792",23481,3310,426,2884,"12.3"
"8062","Z32796",10106,1853,478,1375,"13.6"
"8063","Z32798",1789,434,218,216,"12.1"
"8064","Z32801",8304,1323,122,1201,"14.5"
"8065","Z32803",10319,1182,83,1099,"10.7"
"8066","Z32804",9125,948,222,726," 8.0"
"8067","Z32805",9383,1382,47,1335,"14.2"
"8068","Z32806",12440,1199,125,1074," 8.6"
"8069","Z32807",12811,1448,112,1336,"10.4"
"8070","Z32808",19539,2995,82,2913,"14.9"
"8071","Z32809",10946,1692,815,877," 8.0"
"8072","Z32810",14283,1799,165,1634,"11.4"
"8073","Z32811",16929,2319,387,1932,"11.4"
"8074","Z32812",15500,1167,90,1077," 6.9"
"8075","Z32814",3579,556,31,525,"14.7"
"8076","Z32817",13012,1200,183,1017," 7.8"
"8077","Z32818",17120,1561,152,1409," 8.2"
"8078","Z32819",14140,4349,3271,1078," 7.6"
"8079","Z32820",3039,352,43,309,"10.2"
"8080","Z32821",10921,3440,2545,895," 8.2"
"8081","Z32822",25086,3372,942,2430," 9.7"
"8082","Z32824",13912,2077,830,1247," 9.0"
"8083","Z32825",21684,1718,274,1444," 6.7"
"8084","Z32826",8800,1253,576,677," 7.7"
"8085","Z32827",3152,492,254,238," 7.6"
"8086","Z32828",23018,2729,472,2257," 9.8"
"8087","Z32829",7502,1073,668,405," 5.4"
"8088","Z32832",6724,667,73,594," 8.8"
"8089","Z32833",3776,420,157,263," 7.0"
"8090","Z32835",18833,2878,1260,1618," 8.6"
"8091","Z32836",7634,1316,904,412," 5.4"
"8092","Z32837",20071,2335,952,1383," 6.9"
"8093","Z32839",21810,3889,428,3461,"15.9"
"8094","Z32901",13566,2469,804,1665,"12.3"
"8095","Z32903",6919,928,644,284," 4.1"
"8096","Z32904",12385,1768,687,1081," 8.7"
"8097","Z32905",11959,2254,768,1486,"12.4"
"8098","Z32907",17341,2506,867,1639," 9.5"
"8099","Z32908",3917,436,92,344," 8.8"
"8100","Z32909",12292,1700,658,1042," 8.5"
"8101","Z32920",8881,3342,2179,1163,"13.1"
"8102","Z32922",7452,1488,107,1381,"18.5"
"8103","Z32926",9659,1439,687,752," 7.8"
"8104","Z32927",10602,1717,591,1126,"10.6"
"8105","Z32931",10875,3805,2783,1022," 9.4"
"8106","Z32934",7859,665,73,592," 7.5"
"8107","Z32935",20621,3362,456,2906,"14.1"
"8108","Z32937",13642,2868,1596,1272," 9.3"
"8109","Z32940",15971,2143,725,1418," 8.9"
"8110","Z32948",2402,378,33,345,"14.4"
"8111","Z32949",1142,197,125,72," 6.3"
"8112","Z32950",1750,225,69,156," 8.9"
"8113","Z32951",6912,1758,1287,471," 6.8"
"8114","Z32952",9424,1226,481,745," 7.9"
"8115","Z32953",10976,1348,385,963," 8.8"
"8116","Z32955",16515,1781,692,1089," 6.6"
"8117","Z32958",12912,2236,1200,1036," 8.0"
"8118","Z32960",11224,2355,733,1622,"14.5"
"8119","Z32962",12454,3268,1544,1724,"13.8"
"8120","Z32963",11927,4727,3311,1416,"11.9"
"8121","Z32966",10416,2772,1502,1270,"12.2"
"8122","Z32967",10115,2903,1133,1770,"17.5"
"8123","Z32968",5469,569,261,308," 5.6"
"8124","Z32976",6415,2172,1532,640,"10.0"
"8125","Z33001",633,510,474,36," 5.7"
"8126","Z33004",8836,2081,1315,766," 8.7"
"8127","Z33009",30883,11686,9315,2371," 7.7"
"8128","Z33010",15395,603,93,510," 3.3"
"8129","Z33012",24203,1349,253,1096," 4.5"
"8130","Z33013",9858,374,35,339," 3.4"
"8131","Z33014",14543,1005,93,912," 6.3"
"8132","Z33015",22158,1527,122,1405," 6.3"
"8133","Z33016",14649,686,61,625," 4.3"
"8134","Z33018",13184,428,26,402," 3.0"
"8135","Z33019",12589,5500,4356,1144," 9.1"
"8136","Z33020",21610,3753,1100,2653,"12.3"
"8137","Z33021",22076,3764,1659,2105," 9.5"
"8138","Z33023",21619,1660,431,1229," 5.7"
"8139","Z33024",25410,2572,625,1947," 7.7"
"8140","Z33025",25822,4052,1336,2716,"10.5"
"8141","Z33026",12254,1095,602,493," 4.0"
"8142","Z33027",24423,3011,1105,1906," 7.8"
"8143","Z33029",14155,1291,940,351," 2.5"
"8144","Z33030",10351,799,66,733," 7.1"
"8145","Z33031",2262,141,0,141," 6.2"
"8146","Z33032",11888,1052,0,1052," 8.8"
"8147","Z33033",16783,1772,95,1677,"10.0"
"8148","Z33034",5757,840,147,693,"12.0"
"8149","Z33035",6173,1418,138,1280,"20.7"
"8150","Z33036",3819,2349,1861,488,"12.8"
"8151","Z33037",10556,5956,5236,720," 6.8"
"8152","Z33040",18103,5929,3143,2786,"15.4"
"8153","Z33042",4770,1945,1546,399," 8.4"
"8154","Z33043",3066,1117,754,363,"11.8"
"8155","Z33050",6373,3068,2050,1018,"16.0"
"8156","Z33051",1499,1108,848,260,"17.3"
"8157","Z33054",10451,1589,24,1565,"15.0"
"8158","Z33055",12459,699,89,610," 4.9"
"8159","Z33060",14745,2091,783,1308," 8.9"
"8160","Z33062",21773,9444,8109,1335," 6.1"
"8161","Z33063",24800,3762,1803,1959," 7.9"
"8162","Z33064",24051,4280,2103,2177," 9.1"
"8163","Z33065",19381,1805,149,1656," 8.5"
"8164","Z33066",10772,2349,1463,886," 8.2"
"8165","Z33067",9941,1017,348,669," 6.7"
"8166","Z33068",16576,2098,605,1493," 9.0"
"8167","Z33069",14851,3920,2287,1633,"11.0"
"8168","Z33070",4090,2021,1638,383," 9.4"
"8169","Z33071",13248,733,31,702," 5.3"
"8170","Z33073",11487,1266,423,843," 7.3"
"8171","Z33076",10470,674,258,416," 4.0"
"8172","Z33125",21198,2008,353,1655," 7.8"
"8173","Z33126",19175,1856,238,1618," 8.4"
"8174","Z33127",10628,1516,152,1364,"12.8"
"8175","Z33128",3306,445,55,390,"11.8"
"8176","Z33129",9128,2627,1321,1306,"14.3"
"8177","Z33130",14024,3363,1763,1600,"11.4"
"8178","Z33131",14057,5719,4370,1349," 9.6"
"8179","Z33132",8947,3712,2749,963,"10.8"
"8180","Z33133",16656,3152,1060,2092,"12.6"
"8181","Z33134",18458,1965,449,1516," 8.2"
"8182","Z33135",15083,1264,74,1190," 7.9"
"8183","Z33136",6314,1342,202,1140,"18.1"
"8184","Z33137",11402,2265,880,1385,"12.1"
"8185","Z33138",13913,2145,493,1652,"11.9"
"8186","Z33139",32795,12646,8452,4194,"12.8"
"8187","Z33140",17143,7334,5686,1648," 9.6"
"8188","Z33141",22693,6073,3362,2711,"11.9"
"8189","Z33142",20422,2796,461,2335,"11.4"
"8190","Z33143",14149,2027,317,1710,"12.1"
"8191","Z33144",8832,313,0,313," 3.5"
"8192","Z33145",12926,1630,362,1268," 9.8"
"8193","Z33146",4779,1023,238,785,"16.4"
"8194","Z33147",15256,2243,273,1970,"12.9"
"8195","Z33149",7509,2939,2181,758,"10.1"
"8196","Z33150",10126,1505,247,1258,"12.4"
"8197","Z33154",10347,3980,3115,865," 8.4"
"8198","Z33155",15237,997,123,874," 5.7"
"8199","Z33156",12807,1578,285,1293,"10.1"
"8200","Z33157",21520,1714,200,1514," 7.0"
"8201","Z33158",2396,205,91,114," 4.8"
"8202","Z33160",36781,17594,14833,2761," 7.5"
"8203","Z33161",18081,2241,373,1868,"10.3"
"8204","Z33162",15187,1938,681,1257," 8.3"
"8205","Z33165",17442,868,46,822," 4.7"
"8206","Z33166",8369,774,204,570," 6.8"
"8207","Z33167",5849,352,9,343," 5.9"
"8208","Z33168",7125,561,0,561," 7.9"
"8209","Z33169",13962,1744,180,1564,"11.2"
"8210","Z33170",3667,314,29,285," 7.8"
"8211","Z33172",14474,1616,409,1207," 8.3"
"8212","Z33173",12391,862,79,783," 6.3"
"8213","Z33174",9805,686,65,621," 6.3"
"8214","Z33175",16168,806,160,646," 4.0"
"8215","Z33176",19258,2202,292,1910," 9.9"
"8216","Z33177",15144,935,72,863," 5.7"
"8217","Z33178",16165,3146,1625,1521," 9.4"
"8218","Z33179",17970,2634,600,2034,"11.3"
"8219","Z33180",25024,9633,8410,1223," 4.9"
"8220","Z33181",9417,1974,748,1226,"13.0"
"8221","Z33182",3917,124,0,124," 3.2"
"8222","Z33183",12497,615,173,442," 3.5"
"8223","Z33184",6715,304,31,273," 4.1"
"8224","Z33185",7996,288,57,231," 2.9"
"8225","Z33186",23924,2102,372,1730," 7.2"
"8226","Z33187",4832,298,0,298," 6.2"
"8227","Z33189",8335,596,75,521," 6.3"
"8228","Z33193",14863,1036,155,881," 5.9"
"8229","Z33196",14124,1209,286,923," 6.5"
"8230","Z33301",9788,2567,1523,1044,"10.7"
"8231","Z33304",12684,2983,1420,1563,"12.3"
"8232","Z33305",8248,1687,936,751," 9.1"
"8233","Z33306",2054,371,190,181," 8.8"
"8234","Z33308",23776,7641,5995,1646," 6.9"
"8235","Z33309",14115,1572,483,1089," 7.7"
"8236","Z33311",25480,4548,1005,3543,"13.9"
"8237","Z33312",21136,2739,1094,1645," 7.8"
"8238","Z33313",24149,4406,2036,2370," 9.8"
"8239","Z33314",9272,1242,207,1035,"11.2"
"8240","Z33315",6733,944,329,615," 9.1"
"8241","Z33316",8102,2791,2003,788," 9.7"
"8242","Z33317",13301,1219,347,872," 6.6"
"8243","Z33319",23334,5124,2458,2666,"11.4"
"8244","Z33321",22874,2685,1129,1556," 6.8"
"8245","Z33322",19983,3808,2143,1665," 8.3"
"8246","Z33323",7397,909,440,469," 6.3"
"8247","Z33324",22065,3619,1592,2027," 9.2"
"8248","Z33325",10828,1231,490,741," 6.8"
"8249","Z33326",13912,2823,2116,707," 5.1"
"8250","Z33327",7479,710,326,384," 5.1"
"8251","Z33328",10485,511,117,394," 3.8"
"8252","Z33330",4657,329,193,136," 2.9"
"8253","Z33331",7859,696,263,433," 5.5"
"8254","Z33332",3282,420,330,90," 2.7"
"8255","Z33334",13966,1638,453,1185," 8.5"
"8256","Z33351",12677,1339,326,1013," 8.0"
"8257","Z33401",16287,5217,2780,2437,"15.0"
"8258","Z33403",5379,743,132,611,"11.4"
"8259","Z33404",15759,5652,2842,2810,"17.8"
"8260","Z33405",8571,1230,693,537," 6.3"
"8261","Z33406",9569,931,344,587," 6.1"
"8262","Z33407",13514,2736,473,2263,"16.7"
"8263","Z33408",12497,3705,2985,720," 5.8"
"8264","Z33409",13399,2591,1080,1511,"11.3"
"8265","Z33410",17147,2364,1328,1036," 6.0"
"8266","Z33411",27937,4357,2006,2351," 8.4"
"8267","Z33412",6150,1305,665,640,"10.4"
"8268","Z33413",5499,728,268,460," 8.4"
"8269","Z33415",18973,3041,1293,1748," 9.2"
"8270","Z33417",18782,4798,2832,1966,"10.5"
"8271","Z33418",20441,4385,3273,1112," 5.4"
"8272","Z33426",11217,2215,1107,1108," 9.9"
"8273","Z33428",15490,1843,864,979," 6.3"
"8274","Z33430",7762,1341,141,1200,"15.5"
"8275","Z33431",8738,1987,1304,683," 7.8"
"8276","Z33432",13735,3919,2836,1083," 7.9"
"8277","Z33433",23376,3791,2138,1653," 7.1"
"8278","Z33434",13694,3817,3204,613," 4.5"
"8279","Z33435",18151,4956,3080,1876,"10.3"
"8280","Z33436",22194,3932,2416,1516," 6.8"
"8281","Z33437",21191,2977,2186,791," 3.7"
"8282","Z33440",7646,1547,514,1033,"13.5"
"8283","Z33441",14180,2991,1729,1262," 8.9"
"8284","Z33442",19738,5893,4637,1256," 6.4"
"8285","Z33444",9831,1560,552,1008,"10.3"
"8286","Z33445",17177,3737,2241,1496," 8.7"
"8287","Z33446",16340,4229,3196,1033," 6.3"
"8288","Z33449",4540,623,361,262," 5.8"
"8289","Z33455",12170,2655,2174,481," 4.0"
"8290","Z33458",22314,2363,1392,971," 4.4"
"8291","Z33460",13873,2876,649,2227,"16.1"
"8292","Z33461",17099,2910,1390,1520," 8.9"
"8293","Z33462",14804,2940,1787,1153," 7.8"
"8294","Z33463",20125,3081,1437,1644," 8.2"
"8295","Z33467",23153,3688,2448,1240," 5.4"
"8296","Z33469",8556,2119,1507,612," 7.2"
"8297","Z33470",8651,843,70,773," 8.9"
"8298","Z33471",3265,1260,815,445,"13.6"
"8299","Z33472",9193,1065,596,469," 5.1"
"8300","Z33473",3091,400,346,54," 1.7"
"8301","Z33476",2882,359,20,339,"11.8"
"8302","Z33477",11819,4544,4080,464," 3.9"
"8303","Z33478",4627,437,199,238," 5.1"
"8304","Z33480",11552,5992,5260,732," 6.3"
"8305","Z33483",9408,3245,2208,1037,"11.0"
"8306","Z33484",18639,4899,3157,1742," 9.3"
"8307","Z33486",9487,750,292,458," 4.8"
"8308","Z33487",11440,3368,2734,634," 5.5"
"8309","Z33493",872,265,17,248,"28.4"
"8310","Z33496",11441,2020,1691,329," 2.9"
"8311","Z33498",5565,633,375,258," 4.6"
"8312","Z33510",11056,699,28,671," 6.1"
"8313","Z33511",22852,2415,64,2351,"10.3"
"8314","Z33513",5263,1460,530,930,"17.7"
"8315","Z33514",756,126,7,119,"15.7"
"8316","Z33521",293,96,10,86,"29.4"
"8317","Z33523",7733,1205,303,902,"11.7"
"8318","Z33525",8373,1221,471,750," 9.0"
"8319","Z33527",4962,550,57,493," 9.9"
"8320","Z33534",5271,649,92,557,"10.6"
"8321","Z33538",3074,1152,489,663,"21.6"
"8322","Z33540",5202,1499,1017,482," 9.3"
"8323","Z33541",12621,3963,2545,1418,"11.2"
"8324","Z33542",13996,4176,2557,1619,"11.6"
"8325","Z33543",9235,1302,520,782," 8.5"
"8326","Z33544",9066,701,98,603," 6.7"
"8327","Z33545",5540,794,67,727,"13.1"
"8328","Z33547",7860,727,121,606," 7.7"
"8329","Z33548",2561,192,22,170," 6.6"
"8330","Z33549",6877,634,46,588," 8.6"
"8331","Z33556",8517,1141,304,837," 9.8"
"8332","Z33558",8842,1263,537,726," 8.2"
"8333","Z33559",7346,759,61,698," 9.5"
"8334","Z33563",10573,1219,406,813," 7.7"
"8335","Z33565",6932,676,265,411," 5.9"
"8336","Z33566",7163,707,49,658," 9.2"
"8337","Z33567",3713,274,51,223," 6.0"
"8338","Z33569",9861,1417,392,1025,"10.4"
"8339","Z33570",10655,2496,1116,1380,"13.0"
"8340","Z33572",7173,935,244,691," 9.6"
"8341","Z33573",14026,2387,1305,1082," 7.7"
"8342","Z33576",2109,471,227,244,"11.6"
"8343","Z33578",18281,1604,52,1552," 8.5"
"8344","Z33579",9865,1490,189,1301,"13.2"
"8345","Z33584",9878,868,37,831," 8.4"
"8346","Z33585",535,86,9,77,"14.4"
"8347","Z33592",4404,435,106,329," 7.5"
"8348","Z33594",12918,950,88,862," 6.7"
"8349","Z33596",10533,452,32,420," 4.0"
"8350","Z33597",3882,965,458,507,"13.1"
"8351","Z33598",5014,671,195,476," 9.5"
"8352","Z33602",8147,1136,409,727," 8.9"
"8353","Z33603",9214,1069,44,1025,"11.1"
"8354","Z33604",16862,2482,252,2230,"13.2"
"8355","Z33605",8080,1275,18,1257,"15.6"
"8356","Z33606",8830,1081,192,889,"10.1"
"8357","Z33607",11859,1415,184,1231,"10.4"
"8358","Z33609",8979,800,42,758," 8.4"
"8359","Z33610",17175,1878,0,1878,"10.9"
"8360","Z33611",16498,1714,359,1355," 8.2"
"8361","Z33612",20875,2985,100,2885,"13.8"
"8362","Z33613",16140,3325,98,3227,"20.0"
"8363","Z33614",20055,2254,133,2121,"10.6"
"8364","Z33615",19834,2564,308,2256,"11.4"
"8365","Z33616",6772,755,128,627," 9.3"
"8366","Z33617",19384,2603,9,2594,"13.4"
"8367","Z33618",12009,1176,110,1066," 8.9"
"8368","Z33619",12968,1108,17,1091," 8.4"
"8369","Z33621",594,43,0,43," 7.2"
"8370","Z33624",16424,1425,194,1231," 7.5"
"8371","Z33625",10058,676,33,643," 6.4"
"8372","Z33626",11650,1090,295,795," 6.8"
"8373","Z33629",11472,898,147,751," 6.5"
"8374","Z33634",7663,541,24,517," 6.7"
"8375","Z33635",7306,741,73,668," 9.1"
"8376","Z33637",7311,1147,31,1116,"15.3"
"8377","Z33647",24654,2315,387,1928," 7.8"
"8378","Z33701",11104,2734,820,1914,"17.2"
"8379","Z33702",15229,2196,999,1197," 7.9"
"8380","Z33703",11786,1747,734,1013," 8.6"
"8381","Z33704",8451,1236,245,991,"11.7"
"8382","Z33705",13657,3189,708,2481,"18.2"
"8383","Z33706",14126,5587,4125,1462,"10.3"
"8384","Z33707",15883,3517,1785,1732,"10.9"
"8385","Z33708",13515,5123,3962,1161," 8.6"
"8386","Z33709",14627,3014,1904,1110," 7.6"
"8387","Z33710",15410,2026,509,1517," 9.8"
"8388","Z33711",9075,2117,906,1211,"13.3"
"8389","Z33712",11199,1627,182,1445,"12.9"
"8390","Z33713",14499,2147,335,1812,"12.5"
"8391","Z33714",9710,1835,507,1328,"13.7"
"8392","Z33715",6756,2981,2541,440," 6.5"
"8393","Z33716",9796,1281,182,1099,"11.2"
"8394","Z33755",11600,2911,975,1936,"16.7"
"8395","Z33756",15861,3284,1377,1907,"12.0"
"8396","Z33759",9263,1754,642,1112,"12.0"
"8397","Z33760",7491,1121,484,637," 8.5"
"8398","Z33761",10375,1441,994,447," 4.3"
"8399","Z33762",3245,472,274,198," 6.1"
"8400","Z33763",11367,2429,1702,727," 6.4"
"8401","Z33764",14433,3069,1561,1508,"10.4"
"8402","Z33765",6717,978,462,516," 7.7"
"8403","Z33767",8403,3843,2886,957,"11.4"
"8404","Z33770",14202,2803,1071,1732,"12.2"
"8405","Z33771",17164,3797,2167,1630," 9.5"
"8406","Z33772",12369,2438,1236,1202," 9.7"
"8407","Z33773",8563,1254,595,659," 7.7"
"8408","Z33774",10104,1788,1132,656," 6.5"
"8409","Z33776",5738,691,373,318," 5.5"
"8410","Z33777",8116,1364,805,559," 6.9"
"8411","Z33778",7638,1431,827,604," 7.9"
"8412","Z33781",12031,1619,518,1101," 9.2"
"8413","Z33782",10600,1159,459,700," 6.6"
"8414","Z33785",6091,3116,2102,1014,"16.6"
"8415","Z33786",1180,427,299,128,"10.8"
"8416","Z33801",14422,2358,619,1739,"12.1"
"8417","Z33803",14549,2700,1061,1639,"11.3"
"8418","Z33805",10188,1664,264,1400,"13.7"
"8419","Z33809",12899,2150,718,1432,"11.1"
"8420","Z33810",19529,2753,1073,1680," 8.6"
"8421","Z33811",8821,1304,570,734," 8.3"
"8422","Z33812",5077,672,397,275," 5.4"
"8423","Z33813",13151,1425,441,984," 7.5"
"8424","Z33815",7514,2352,964,1388,"18.5"
"8425","Z33823",12336,2196,811,1385,"11.2"
"8426","Z33825",11672,2792,1376,1416,"12.1"
"8427","Z33827",1149,284,173,111," 9.7"
"8428","Z33830",11060,2059,371,1688,"15.3"
"8429","Z33834",2300,534,225,309,"13.4"
"8430","Z33837",10779,3142,2066,1076,"10.0"
"8431","Z33838",1765,456,311,145," 8.2"
"8432","Z33841",3602,857,335,522,"14.5"
"8433","Z33843",5206,1753,1138,615,"11.8"
"8434","Z33844",16779,5102,3267,1835,"10.9"
"8435","Z33847",60,13,13,0," 0.0"
"8436","Z33848",602,129,103,26," 4.3"
"8437","Z33850",3582,504,229,275," 7.7"
"8438","Z33851",400,89,26,63,"15.8"
"8439","Z33852",12067,3839,2117,1722,"14.3"
"8440","Z33853",4931,850,105,745,"15.1"
"8441","Z33859",4941,1050,584,466," 9.4"
"8442","Z33860",9190,1401,502,899," 9.8"
"8443","Z33868",4413,608,219,389," 8.8"
"8444","Z33870",12009,3349,1877,1472,"12.3"
"8445","Z33872",9287,2235,1567,668," 7.2"
"8446","Z33873",5420,1095,256,839,"15.5"
"8447","Z33875",5194,781,625,156," 3.0"
"8448","Z33876",2960,942,541,401,"13.5"
"8449","Z33877",232,31,0,31,"13.4"
"8450","Z33880",15686,2975,798,2177,"13.9"
"8451","Z33881",15188,2872,1382,1490," 9.8"
"8452","Z33884",14301,2814,1547,1267," 8.9"
"8453","Z33890",1762,360,146,214,"12.1"
"8454","Z33896",5236,2250,1769,481," 9.2"
"8455","Z33897",11736,5799,4797,1002," 8.5"
"8456","Z33898",8867,2434,1592,842," 9.5"
"8457","Z33901",10956,3063,1131,1932,"17.6"
"8458","Z33903",15128,4885,3423,1462," 9.7"
"8459","Z33904",19204,6158,3852,2306,"12.0"
"8460","Z33905",14364,3932,1871,2061,"14.3"
"8461","Z33907",12562,3658,1539,2119,"16.9"
"8462","Z33908",29951,13198,10581,2617," 8.7"
"8463","Z33909",10156,2071,1254,817," 8.0"
"8464","Z33912",10430,3566,2931,635," 6.1"
"8465","Z33913",10244,3543,2587,956," 9.3"
"8466","Z33914",18819,4822,3364,1458," 7.7"
"8467","Z33916",10424,2975,1117,1858,"17.8"
"8468","Z33917",17498,4832,2824,2008,"11.5"
"8469","Z33919",18738,5351,3692,1659," 8.9"
"8470","Z33920",2417,684,345,339,"14.0"
"8471","Z33921",2011,1499,1290,209,"10.4"
"8472","Z33922",2761,1269,833,436,"15.8"
"8473","Z33924",1809,1772,1405,367,"20.3"
"8474","Z33928",16828,6532,5456,1076," 6.4"
"8475","Z33931",14582,9031,8277,754," 5.2"
"8476","Z33935",7885,2145,969,1176,"14.9"
"8477","Z33936",10204,2199,889,1310,"12.8"
"8478","Z33946",2524,1547,1086,461,"18.3"
"8479","Z33947",5673,1754,1013,741,"13.1"
"8480","Z33948",9099,2183,1214,969,"10.6"
"8481","Z33950",14387,4447,2962,1485,"10.3"
"8482","Z33952",15999,3483,1693,1790,"11.2"
"8483","Z33953",3792,1250,928,322," 8.5"
"8484","Z33954",3952,477,153,324," 8.2"
"8485","Z33955",6327,2244,1685,559," 8.8"
"8486","Z33956",3303,1469,1207,262," 7.9"
"8487","Z33957",8545,5058,4091,967,"11.3"
"8488","Z33960",578,196,84,112,"19.4"
"8489","Z33966",5359,1683,1387,296," 5.5"
"8490","Z33967",9678,1783,939,844," 8.7"
"8491","Z33971",8233,1622,648,974,"11.8"
"8492","Z33972",4840,650,357,293," 6.1"
"8493","Z33981",5952,1677,1130,547," 9.2"
"8494","Z33982",5256,1416,931,485," 9.2"
"8495","Z33983",7896,1769,1148,621," 7.9"
"8496","Z33990",13253,2238,1223,1015," 7.7"
"8497","Z33991",8219,1714,908,806," 9.8"
"8498","Z33993",9483,2049,987,1062,"11.2"
"8499","Z34102",9654,4123,3311,812," 8.4"
"8500","Z34103",10986,5081,4517,564," 5.1"
"8501","Z34104",14768,4695,3738,957," 6.5"
"8502","Z34105",9921,2966,2424,542," 5.5"
"8503","Z34108",14567,6647,5394,1253," 8.6"
"8504","Z34109",14076,3354,2421,933," 6.6"
"8505","Z34110",15621,5597,4423,1174," 7.5"
"8506","Z34112",18851,7529,6237,1292," 6.9"
"8507","Z34113",11242,4375,3207,1168,"10.4"
"8508","Z34114",11479,5515,4972,543," 4.7"
"8509","Z34116",10282,1257,563,694," 6.7"
"8510","Z34117",4947,600,148,452," 9.1"
"8511","Z34119",14941,3545,2474,1071," 7.2"
"8512","Z34120",11590,3066,1516,1550,"13.4"
"8513","Z34134",13715,6737,6077,660," 4.8"
"8514","Z34135",25649,9454,8339,1115," 4.3"
"8515","Z34142",7207,1659,290,1369,"19.0"
"8516","Z34145",18650,10396,9052,1344," 7.2"
"8517","Z34201",2565,734,516,218," 8.5"
"8518","Z34202",9952,1442,1004,438," 4.4"
"8519","Z34203",17982,4264,2731,1533," 8.5"
"8520","Z34205",15483,3270,1299,1971,"12.7"
"8521","Z34207",18514,4610,2796,1814," 9.8"
"8522","Z34208",13442,1650,606,1044," 7.8"
"8523","Z34209",17863,3820,2446,1374," 7.7"
"8524","Z34210",11402,4192,3251,941," 8.3"
"8525","Z34211",2390,523,260,263,"11.0"
"8526","Z34212",7062,1391,821,570," 8.1"
"8527","Z34215",425,195,171,24," 5.6"
"8528","Z34216",1530,943,550,393,"25.7"
"8529","Z34217",6340,3674,2448,1226,"19.3"
"8530","Z34219",8209,1128,393,735," 9.0"
"8531","Z34221",19686,4765,3104,1661," 8.4"
"8532","Z34222",6881,1613,1124,489," 7.1"
"8533","Z34223",13379,4966,3839,1127," 8.4"
"8534","Z34224",10719,3398,2296,1102,"10.3"
"8535","Z34228",9409,5542,4661,881," 9.4"
"8536","Z34229",4146,744,595,149," 3.6"
"8537","Z34231",18139,4143,2423,1720," 9.5"
"8538","Z34232",15068,1621,830,791," 5.2"
"8539","Z34233",8913,1050,730,320," 3.6"
"8540","Z34234",10414,1520,655,865," 8.3"
"8541","Z34235",8322,2209,1704,505," 6.1"
"8542","Z34236",9641,3272,2580,692," 7.2"
"8543","Z34237",8170,1275,499,776," 9.5"
"8544","Z34238",11909,2430,2115,315," 2.6"
"8545","Z34239",8521,1562,855,707," 8.3"
"8546","Z34240",5233,798,571,227," 4.3"
"8547","Z34241",6382,836,617,219," 3.4"
"8548","Z34242",10863,6905,4919,1986,"18.3"
"8549","Z34243",14370,2359,1445,914," 6.4"
"8550","Z34251",1989,252,65,187," 9.4"
"8551","Z34266",12114,2572,1210,1362,"11.2"
"8552","Z34275",10633,2320,1728,592," 5.6"
"8553","Z34285",15292,5346,4162,1184," 7.7"
"8554","Z34286",7478,413,201,212," 2.8"
"8555","Z34287",14584,3784,2817,967," 6.6"
"8556","Z34288",4774,732,477,255," 5.3"
"8557","Z34289",1091,92,92,0," 0.0"
"8558","Z34292",9049,1694,1273,421," 4.7"
"8559","Z34293",20218,4525,2840,1685," 8.3"
"8560","Z34420",7521,1763,435,1328,"17.7"
"8561","Z34428",5292,1304,735,569,"10.8"
"8562","Z34429",4689,1325,827,498,"10.6"
"8563","Z34431",4446,1120,398,722,"16.2"
"8564","Z34432",6402,1152,383,769,"12.0"
"8565","Z34433",2976,699,374,325,"10.9"
"8566","Z34434",3942,732,285,447,"11.3"
"8567","Z34436",4590,1215,530,685,"14.9"
"8568","Z34442",8703,2066,852,1214,"13.9"
"8569","Z34446",9209,1496,806,690," 7.5"
"8570","Z34448",6411,1987,1221,766,"11.9"
"8571","Z34449",1728,522,317,205,"11.9"
"8572","Z34450",6135,1244,631,613,"10.0"
"8573","Z34452",5898,1039,321,718,"12.2"
"8574","Z34453",5404,1190,634,556,"10.3"
"8575","Z34461",5235,1009,451,558,"10.7"
"8576","Z34465",9164,1414,413,1001,"10.9"
"8577","Z34470",9273,1335,230,1105,"11.9"
"8578","Z34471",11646,1910,543,1367,"11.7"
"8579","Z34472",11768,1505,417,1088," 9.2"
"8580","Z34473",7608,1232,551,681," 9.0"
"8581","Z34474",8278,1654,357,1297,"15.7"
"8582","Z34475",5126,1150,243,907,"17.7"
"8583","Z34476",10630,1525,514,1011," 9.5"
"8584","Z34479",5536,601,58,543," 9.8"
"8585","Z34480",8064,1374,220,1154,"14.3"
"8586","Z34481",10864,2154,1198,956," 8.8"
"8587","Z34482",8873,1825,519,1306,"14.7"
"8588","Z34484",1625,256,141,115," 7.1"
"8589","Z34488",5695,1320,549,771,"13.5"
"8590","Z34491",14841,2901,1502,1399," 9.4"
"8591","Z34601",10606,2077,730,1347,"12.7"
"8592","Z34604",4263,596,234,362," 8.5"
"8593","Z34606",14031,2472,880,1592,"11.3"
"8594","Z34607",5046,1198,579,619,"12.3"
"8595","Z34608",14294,1825,508,1317," 9.2"
"8596","Z34609",16868,2217,636,1581," 9.4"
"8597","Z34610",5400,951,203,748,"13.9"
"8598","Z34613",10256,2158,1186,972," 9.5"
"8599","Z34614",2985,531,83,448,"15.0"
"8600","Z34637",2364,117,117,0," 0.0"
"8601","Z34638",8239,686,153,533," 6.5"
"8602","Z34639",9509,561,142,419," 4.4"
"8603","Z34652",14636,4070,2030,2040,"13.9"
"8604","Z34653",16633,3164,1200,1964,"11.8"
"8605","Z34654",10254,1795,832,963," 9.4"
"8606","Z34655",18156,2352,1350,1002," 5.5"
"8607","Z34667",19051,4699,2220,2479,"13.0"
"8608","Z34668",22507,4561,1630,2931,"13.0"
"8609","Z34669",5849,1204,313,891,"15.2"
"8610","Z34677",9721,1532,779,753," 7.7"
"8611","Z34681",427,44,44,0," 0.0"
"8612","Z34683",15518,2717,1371,1346," 8.7"
"8613","Z34684",14895,1457,633,824," 5.5"
"8614","Z34685",7804,654,233,421," 5.4"
"8615","Z34688",3773,706,360,346," 9.2"
"8616","Z34689",13929,3017,1621,1396,"10.0"
"8617","Z34690",6757,1370,772,598," 8.9"
"8618","Z34691",11332,3519,1524,1995,"17.6"
"8619","Z34695",8532,1136,506,630," 7.4"
"8620","Z34698",21685,4196,2591,1605," 7.4"
"8621","Z34711",21712,2644,1179,1465," 6.7"
"8622","Z34714",8365,2456,1800,656," 7.8"
"8623","Z34715",5970,904,486,418," 7.0"
"8624","Z34731",5443,1179,509,670,"12.3"
"8625","Z34734",1485,16,0,16," 1.1"
"8626","Z34736",5593,608,218,390," 7.0"
"8627","Z34741",18844,3803,1859,1944,"10.3"
"8628","Z34743",12224,1417,741,676," 5.5"
"8629","Z34744",17122,2797,1262,1535," 9.0"
"8630","Z34746",20280,8372,6785,1587," 7.8"
"8631","Z34747",21422,15732,14475,1257," 5.9"
"8632","Z34748",21638,3965,1660,2305,"10.7"
"8633","Z34753",1754,176,42,134," 7.6"
"8634","Z34756",1438,209,163,46," 3.2"
"8635","Z34759",13805,3389,2298,1091," 7.9"
"8636","Z34760",275,11,0,11," 4.0"
"8637","Z34761",14933,1101,191,910," 6.1"
"8638","Z34762",200,16,0,16," 8.0"
"8639","Z34769",9305,1530,549,981,"10.5"
"8640","Z34771",5678,1231,923,308," 5.4"
"8641","Z34772",9905,1587,707,880," 8.9"
"8642","Z34773",1208,214,166,48," 4.0"
"8643","Z34785",9321,2330,1074,1256,"13.5"
"8644","Z34786",12551,1238,687,551," 4.4"
"8645","Z34787",19690,2183,839,1344," 6.8"
"8646","Z34788",10057,2503,1474,1029,"10.2"
"8647","Z34945",1908,224,91,133," 7.0"
"8648","Z34946",2931,765,330,435,"14.8"
"8649","Z34947",4874,821,25,796,"16.3"
"8650","Z34949",7784,3966,3233,733," 9.4"
"8651","Z34950",7481,1643,212,1431,"19.1"
"8652","Z34951",8509,1873,965,908,"10.7"
"8653","Z34952",21288,4444,2176,2268,"10.7"
"8654","Z34953",22415,2440,1045,1395," 6.2"
"8655","Z34956",2586,381,223,158," 6.1"
"8656","Z34957",17360,6924,5158,1766,"10.2"
"8657","Z34972",7068,1446,665,781,"11.0"
"8658","Z34974",13652,4835,3440,1395,"10.2"
"8659","Z34981",2138,385,44,341,"15.9"
"8660","Z34982",11578,1610,516,1094," 9.4"
"8661","Z34983",15450,1732,983,749," 4.8"
"8662","Z34984",5726,743,385,358," 6.3"
"8663","Z34986",13185,2877,2164,713," 5.4"
"8664","Z34987",3142,803,378,425,"13.5"
"8665","Z34990",13061,1967,1482,485," 3.7"
"8666","Z34994",9217,1940,1321,619," 6.7"
"8667","Z34996",8616,3264,2607,657," 7.6"
"8668","Z34997",20845,3707,2289,1418," 6.8"
"8669","Z35004",4216,95,0,95," 2.3"
"8670","Z35005",3371,462,83,379,"11.2"
"8671","Z35007",9567,821,0,821," 8.6"
"8672","Z35010",9795,1769,1125,644," 6.6"
"8673","Z35014",1863,334,189,145," 7.8"
"8674","Z35016",7246,795,65,730,"10.1"
"8675","Z35019",910,169,5,164,"18.0"
"8676","Z35020",12231,2438,93,2345,"19.2"
"8677","Z35022",8702,653,89,564," 6.5"
"8678","Z35023",9941,1099,235,864," 8.7"
"8679","Z35031",3555,729,36,693,"19.5"
"8680","Z35034",1429,402,22,380,"26.6"
"8681","Z35035",706,292,57,235,"33.3"
"8682","Z35040",6475,548,0,548," 8.5"
"8683","Z35042",2635,525,46,479,"18.2"
"8684","Z35043",3542,236,38,198," 5.6"
"8685","Z35044",3635,461,50,411,"11.3"
"8686","Z35045",6229,762,17,745,"12.0"
"8687","Z35046",2751,691,484,207," 7.5"
"8688","Z35049",1602,115,2,113," 7.1"
"8689","Z35051",3442,396,15,381,"11.1"
"8690","Z35053",2579,1457,1155,302,"11.7"
"8691","Z35054",2138,421,358,63," 2.9"
"8692","Z35055",8984,865,68,797," 8.9"
"8693","Z35057",5756,1044,398,646,"11.2"
"8694","Z35058",4313,495,0,495,"11.5"
"8695","Z35061",575,113,0,113,"19.7"
"8696","Z35062",3334,514,116,398,"11.9"
"8697","Z35063",1732,290,83,207,"12.0"
"8698","Z35064",5309,981,40,941,"17.7"
"8699","Z35068",3709,352,45,307," 8.3"
"8700","Z35071",6690,420,8,412," 6.2"
"8701","Z35072",2515,535,108,427,"17.0"
"8702","Z35073",1176,224,5,219,"18.6"
"8703","Z35077",5690,1012,42,970,"17.0"
"8704","Z35078",889,134,31,103,"11.6"
"8705","Z35079",3576,374,43,331," 9.3"
"8706","Z35080",5930,249,14,235," 4.0"
"8707","Z35083",1432,77,5,72," 5.0"
"8708","Z35085",3589,371,56,315," 8.8"
"8709","Z35087",856,115,38,77," 9.0"
"8710","Z35089",1047,317,135,182,"17.4"
"8711","Z35091",1117,141,0,141,"12.6"
"8712","Z35094",6105,595,70,525," 8.6"
"8713","Z35096",4143,1017,436,581,"14.0"
"8714","Z35097",725,19,2,17," 2.3"
"8715","Z35098",684,114,29,85,"12.4"
"8716","Z35111",6496,608,70,538," 8.3"
"8717","Z35112",146,53,0,53,"36.3"
"8718","Z35115",5838,894,15,879,"15.1"
"8719","Z35116",1765,168,10,158," 9.0"
"8720","Z35117",2135,142,0,142," 6.7"
"8721","Z35118",1356,130,17,113," 8.3"
"8722","Z35120",5522,350,45,305," 5.5"
"8723","Z35121",6445,749,124,625," 9.7"
"8724","Z35124",9811,464,100,364," 3.7"
"8725","Z35125",4292,577,41,536,"12.5"
"8726","Z35126",8742,887,17,870,"10.0"
"8727","Z35127",3914,284,0,284," 7.3"
"8728","Z35128",4994,740,392,348," 7.0"
"8729","Z35130",1703,432,218,214,"12.6"
"8730","Z35131",1963,324,62,262,"13.3"
"8731","Z35133",1436,207,0,207,"14.4"
"8732","Z35135",806,100,26,74," 9.2"
"8733","Z35136",1227,432,263,169,"13.8"
"8734","Z35143",2267,960,800,160," 7.1"
"8735","Z35146",4333,368,137,231," 5.3"
"8736","Z35147",2282,241,0,241,"10.6"
"8737","Z35148",1323,221,64,157,"11.9"
"8738","Z35150",8585,1259,190,1069,"12.5"
"8739","Z35151",3577,607,317,290," 8.1"
"8740","Z35160",11948,2140,877,1263,"10.6"
"8741","Z35171",1617,208,13,195,"12.1"
"8742","Z35172",1228,190,45,145,"11.8"
"8743","Z35173",10126,503,36,467," 4.6"
"8744","Z35175",2248,272,14,258,"11.5"
"8745","Z35178",1674,185,42,143," 8.5"
"8746","Z35179",3792,361,0,361," 9.5"
"8747","Z35180",5888,647,27,620,"10.5"
"8748","Z35184",2551,519,0,519,"20.3"
"8749","Z35188",1152,146,0,146,"12.7"
"8750","Z35203",1855,319,29,290,"15.6"
"8751","Z35204",6240,1583,134,1449,"23.2"
"8752","Z35205",12486,2488,213,2275,"18.2"
"8753","Z35206",8590,1817,52,1765,"20.5"
"8754","Z35207",4328,945,31,914,"21.1"
"8755","Z35208",7126,1788,52,1736,"24.4"
"8756","Z35209",14504,2350,198,2152,"14.8"
"8757","Z35210",6646,469,0,469," 7.1"
"8758","Z35211",14706,3458,160,3298,"22.4"
"8759","Z35212",6559,1240,18,1222,"18.6"
"8760","Z35213",5963,450,0,450," 7.5"
"8761","Z35214",8445,1422,117,1305,"15.5"
"8762","Z35215",21137,3124,172,2952,"14.0"
"8763","Z35216",16437,1664,49,1615," 9.8"
"8764","Z35217",6634,1353,0,1353,"20.4"
"8765","Z35218",3753,723,14,709,"18.9"
"8766","Z35221",2584,562,49,513,"19.9"
"8767","Z35222",4595,668,35,633,"13.8"
"8768","Z35223",4249,239,16,223," 5.2"
"8769","Z35224",2839,424,0,424,"14.9"
"8770","Z35226",13836,838,55,783," 5.7"
"8771","Z35228",4910,935,11,924,"18.8"
"8772","Z35233",891,185,21,164,"18.4"
"8773","Z35234",2726,836,50,786,"28.8"
"8774","Z35235",8853,867,0,867," 9.8"
"8775","Z35242",22718,1810,262,1548," 6.8"
"8776","Z35243",8454,710,132,578," 6.8"
"8777","Z35244",13527,597,92,505," 3.7"
"8778","Z35401",17235,6699,4949,1750,"10.2"
"8779","Z35404",10279,3028,2185,843," 8.2"
"8780","Z35405",19014,3077,1240,1837," 9.7"
"8781","Z35406",7057,954,535,419," 5.9"
"8782","Z35441",784,354,233,121,"15.4"
"8783","Z35442",2463,581,202,379,"15.4"
"8784","Z35443",1175,509,381,128,"10.9"
"8785","Z35444",1582,201,46,155," 9.8"
"8786","Z35447",1615,352,145,207,"12.8"
"8787","Z35452",1345,68,0,68," 5.1"
"8788","Z35453",4642,582,52,530,"11.4"
"8789","Z35456",1394,276,0,276,"19.8"
"8790","Z35461",1048,272,110,162,"15.5"
"8791","Z35462",2625,842,326,516,"19.7"
"8792","Z35463",678,128,53,75,"11.1"
"8793","Z35466",2555,418,240,178," 7.0"
"8794","Z35470",2469,759,381,378,"15.3"
"8795","Z35473",6666,732,250,482," 7.2"
"8796","Z35474",2736,413,126,287,"10.5"
"8797","Z35475",6260,927,251,676,"10.8"
"8798","Z35476",3092,309,102,207," 6.7"
"8799","Z35480",485,63,17,46," 9.5"
"8800","Z35481",1863,323,51,272,"14.6"
"8801","Z35501",4642,728,31,697,"15.0"
"8802","Z35503",3871,527,186,341," 8.8"
"8803","Z35504",6116,1003,503,500," 8.2"
"8804","Z35541",2556,1304,1003,301,"11.8"
"8805","Z35542",617,87,50,37," 6.0"
"8806","Z35543",710,48,7,41," 5.8"
"8807","Z35546",1630,161,61,100," 6.1"
"8808","Z35548",904,144,50,94,"10.4"
"8809","Z35549",1989,291,35,256,"12.9"
"8810","Z35550",2602,433,126,307,"11.8"
"8811","Z35552",413,39,34,5," 1.2"
"8812","Z35553",2350,645,252,393,"16.7"
"8813","Z35554",510,81,4,77,"15.1"
"8814","Z35555",4887,859,343,516,"10.6"
"8815","Z35563",2284,298,54,244,"10.7"
"8816","Z35564",1013,120,40,80," 7.9"
"8817","Z35565",6281,1096,170,926,"14.7"
"8818","Z35570",5266,786,213,573,"10.9"
"8819","Z35571",499,42,0,42," 8.4"
"8820","Z35572",752,389,284,105,"14.0"
"8821","Z35574",755,126,9,117,"15.5"
"8822","Z35576",1535,184,69,115," 7.5"
"8823","Z35578",2559,286,15,271,"10.6"
"8824","Z35579",1551,317,96,221,"14.2"
"8825","Z35581",2259,271,38,233,"10.3"
"8826","Z35584",225,39,8,31,"13.8"
"8827","Z35585",709,166,66,100,"14.1"
"8828","Z35587",580,88,0,88,"15.2"
"8829","Z35592",2470,400,22,378,"15.3"
"8830","Z35593",1070,148,16,132,"12.3"
"8831","Z35594",3827,666,115,551,"14.4"
"8832","Z35601",14695,1638,107,1531,"10.4"
"8833","Z35603",13608,1086,177,909," 6.7"
"8834","Z35610",867,49,0,49," 5.7"
"8835","Z35611",11962,1421,186,1235,"10.3"
"8836","Z35613",7596,551,93,458," 6.0"
"8837","Z35614",3368,314,40,274," 8.1"
"8838","Z35616",2305,578,141,437,"19.0"
"8839","Z35618",1118,239,14,225,"20.1"
"8840","Z35619",2152,337,74,263,"12.2"
"8841","Z35620",3390,179,13,166," 4.9"
"8842","Z35621",1198,61,28,33," 2.8"
"8843","Z35622",3426,520,56,464,"13.5"
"8844","Z35630",17157,2430,233,2197,"12.8"
"8845","Z35633",9376,785,142,643," 6.9"
"8846","Z35634",4345,473,51,422," 9.7"
"8847","Z35640",10039,811,33,778," 7.7"
"8848","Z35643",1384,183,21,162,"11.7"
"8849","Z35645",6051,599,177,422," 7.0"
"8850","Z35646",2238,523,55,468,"20.9"
"8851","Z35647",467,47,0,47,"10.1"
"8852","Z35648",1364,158,44,114," 8.4"
"8853","Z35650",6167,472,107,365," 5.9"
"8854","Z35651",634,43,0,43," 6.8"
"8855","Z35652",4321,745,300,445,"10.3"
"8856","Z35654",3714,675,0,675,"18.2"
"8857","Z35660",4740,779,60,719,"15.2"
"8858","Z35661",7619,625,103,522," 6.9"
"8859","Z35671",961,95,46,49," 5.1"
"8860","Z35672",2872,287,28,259," 9.0"
"8861","Z35673",3046,264,46,218," 7.2"
"8862","Z35674",8400,1130,97,1033,"12.3"
"8863","Z35739",2373,232,21,211," 8.9"
"8864","Z35740",1667,329,0,329,"19.7"
"8865","Z35741",1369,162,0,162,"11.8"
"8866","Z35744",1199,248,0,248,"20.7"
"8867","Z35747",2546,446,83,363,"14.3"
"8868","Z35748",2721,252,2,250," 9.2"
"8869","Z35749",8119,705,24,681," 8.4"
"8870","Z35750",5144,404,0,404," 7.9"
"8871","Z35752",1183,217,0,217,"18.3"
"8872","Z35754",2338,522,0,522,"22.3"
"8873","Z35755",437,201,155,46,"10.5"
"8874","Z35756",4386,100,0,100," 2.3"
"8875","Z35757",5527,425,0,425," 7.7"
"8876","Z35758",18554,1428,148,1280," 6.9"
"8877","Z35759",2905,211,0,211," 7.3"
"8878","Z35760",2205,345,6,339,"15.4"
"8879","Z35761",4863,518,26,492,"10.1"
"8880","Z35763",6046,289,9,280," 4.6"
"8881","Z35764",322,51,11,40,"12.4"
"8882","Z35765",1815,431,67,364,"20.1"
"8883","Z35768",5546,908,82,826,"14.9"
"8884","Z35769",4928,903,431,472," 9.6"
"8885","Z35771",1576,217,48,169,"10.7"
"8886","Z35772",2273,479,16,463,"20.4"
"8887","Z35773",4897,490,15,475," 9.7"
"8888","Z35776",1543,217,25,192,"12.4"
"8889","Z35801",10996,1238,30,1208,"11.0"
"8890","Z35802",11297,1303,50,1253,"11.1"
"8891","Z35803",11850,695,49,646," 5.5"
"8892","Z35805",10957,1736,47,1689,"15.4"
"8893","Z35806",9869,903,186,717," 7.3"
"8894","Z35808",349,49,9,40,"11.5"
"8895","Z35810",12782,1314,68,1246," 9.7"
"8896","Z35811",11404,1017,5,1012," 8.9"
"8897","Z35816",7985,1346,92,1254,"15.7"
"8898","Z35824",3334,206,0,206," 6.2"
"8899","Z35901",9262,1853,105,1748,"18.9"
"8900","Z35903",8717,1468,153,1315,"15.1"
"8901","Z35904",6554,1064,60,1004,"15.3"
"8902","Z35905",2869,264,0,264," 9.2"
"8903","Z35906",4461,358,52,306," 6.9"
"8904","Z35907",3403,298,114,184," 5.4"
"8905","Z35950",8138,1036,115,921,"11.3"
"8906","Z35951",5204,742,124,618,"11.9"
"8907","Z35952",3193,509,69,440,"13.8"
"8908","Z35953",3083,508,74,434,"14.1"
"8909","Z35954",5853,1246,24,1222,"20.9"
"8910","Z35956",3506,469,15,454,"12.9"
"8911","Z35957",6396,967,65,902,"14.1"
"8912","Z35959",3401,1303,1072,231," 6.8"
"8913","Z35960",6275,1891,1144,747,"11.9"
"8914","Z35961",2991,599,25,574,"19.2"
"8915","Z35962",3425,526,0,526,"15.4"
"8916","Z35963",828,161,18,143,"17.3"
"8917","Z35966",1665,155,0,155," 9.3"
"8918","Z35967",7582,1380,169,1211,"16.0"
"8919","Z35968",1622,235,5,230,"14.2"
"8920","Z35971",2239,355,48,307,"13.7"
"8921","Z35973",1728,265,103,162," 9.4"
"8922","Z35974",628,162,46,116,"18.5"
"8923","Z35976",8326,1648,661,987,"11.9"
"8924","Z35979",718,116,0,116,"16.2"
"8925","Z35981",798,67,14,53," 6.6"
"8926","Z35983",2551,908,641,267,"10.5"
"8927","Z35984",1563,736,507,229,"14.7"
"8928","Z35986",3373,627,48,579,"17.2"
"8929","Z35987",1201,186,4,182,"15.2"
"8930","Z35988",763,71,0,71," 9.3"
"8931","Z35989",1587,406,65,341,"21.5"
"8932","Z36003",860,111,34,77," 9.0"
"8933","Z36005",885,261,110,151,"17.1"
"8934","Z36009",1253,225,43,182,"14.5"
"8935","Z36010",2503,532,87,445,"17.8"
"8936","Z36016",1896,427,101,326,"17.2"
"8937","Z36017",899,308,55,253,"28.1"
"8938","Z36020",449,59,12,47,"10.5"
"8939","Z36022",4589,355,30,325," 7.1"
"8940","Z36024",3053,946,710,236," 7.7"
"8941","Z36025",1386,44,0,44," 3.2"
"8942","Z36026",895,509,495,14," 1.6"
"8943","Z36027",7763,1609,593,1016,"13.1"
"8944","Z36028",1105,314,182,132,"11.9"
"8945","Z36029",449,100,47,53,"11.8"
"8946","Z36032",1075,226,28,198,"18.4"
"8947","Z36033",2242,495,78,417,"18.6"
"8948","Z36034",417,123,33,90,"21.6"
"8949","Z36035",878,166,37,129,"14.7"
"8950","Z36036",1042,244,100,144,"13.8"
"8951","Z36037",6555,1114,146,968,"14.8"
"8952","Z36040",1656,218,93,125," 7.5"
"8953","Z36041",573,103,34,69,"12.0"
"8954","Z36043",1574,183,0,183,"11.6"
"8955","Z36046",712,95,46,49," 6.9"
"8956","Z36048",715,174,70,104,"14.5"
"8957","Z36049",2684,480,87,393,"14.6"
"8958","Z36052",290,83,33,50,"17.2"
"8959","Z36053",1011,219,100,119,"11.8"
"8960","Z36054",6644,755,39,716,"10.8"
"8961","Z36064",3597,260,54,206," 5.7"
"8962","Z36066",8088,670,27,643," 8.0"
"8963","Z36067",11094,1118,109,1009," 9.1"
"8964","Z36069",1101,125,27,98," 8.9"
"8965","Z36071",317,62,2,60,"18.9"
"8966","Z36075",953,127,60,67," 7.0"
"8967","Z36078",5900,1040,98,942,"16.0"
"8968","Z36079",4557,718,135,583,"12.8"
"8969","Z36080",1131,232,95,137,"12.1"
"8970","Z36081",7712,1363,244,1119,"14.5"
"8971","Z36083",4961,1082,256,826,"16.6"
"8972","Z36089",3016,378,127,251," 8.3"
"8973","Z36091",1857,430,141,289,"15.6"
"8974","Z36092",8078,823,77,746," 9.2"
"8975","Z36093",4040,144,11,133," 3.3"
"8976","Z36104",3987,1010,27,983,"24.7"
"8977","Z36105",5278,1079,130,949,"18.0"
"8978","Z36106",7146,656,0,656," 9.2"
"8979","Z36107",4352,1087,24,1063,"24.4"
"8980","Z36108",9385,1597,173,1424,"15.2"
"8981","Z36109",11103,1111,129,982," 8.8"
"8982","Z36110",5546,962,20,942,"17.0"
"8983","Z36111",5664,700,61,639,"11.3"
"8984","Z36116",19434,2610,122,2488,"12.8"
"8985","Z36117",23153,1856,240,1616," 7.0"
"8986","Z36201",9764,2302,169,2133,"21.8"
"8987","Z36203",7560,816,51,765,"10.1"
"8988","Z36205",247,35,0,35,"14.2"
"8989","Z36206",5056,505,26,479," 9.5"
"8990","Z36207",9760,1115,92,1023,"10.5"
"8991","Z36250",1903,128,0,128," 6.7"
"8992","Z36251",2407,296,124,172," 7.1"
"8993","Z36256",851,135,43,92,"10.8"
"8994","Z36260",1773,209,18,191,"10.8"
"8995","Z36262",632,101,20,81,"12.8"
"8996","Z36264",3841,573,189,384,"10.0"
"8997","Z36265",8687,1249,162,1087,"12.5"
"8998","Z36266",2700,524,323,201," 7.4"
"8999","Z36268",2398,179,26,153," 6.4"
"9000","Z36269",511,47,0,47," 9.2"
"9001","Z36272",6490,1456,269,1187,"18.3"
"9002","Z36273",1522,202,66,136," 8.9"
"9003","Z36274",5374,810,314,496," 9.2"
"9004","Z36276",1145,178,114,64," 5.6"
"9005","Z36277",2455,480,38,442,"18.0"
"9006","Z36278",2899,1206,828,378,"13.0"
"9007","Z36279",1164,106,75,31," 2.7"
"9008","Z36280",1993,552,276,276,"13.8"
"9009","Z36301",16175,2351,82,2269,"14.0"
"9010","Z36303",13897,2123,142,1981,"14.3"
"9011","Z36305",6581,600,44,556," 8.4"
"9012","Z36310",4055,1383,697,686,"16.9"
"9013","Z36311",1322,320,82,238,"18.0"
"9014","Z36312",2989,530,23,507,"17.0"
"9015","Z36316",801,136,11,125,"15.6"
"9016","Z36320",1845,379,11,368,"19.9"
"9017","Z36321",693,91,2,89,"12.8"
"9018","Z36322",4390,997,79,918,"20.9"
"9019","Z36323",3662,612,128,484,"13.2"
"9020","Z36330",15969,2517,94,2423,"15.2"
"9021","Z36340",2396,152,0,152," 6.3"
"9022","Z36344",2876,573,47,526,"18.3"
"9023","Z36345",3654,329,141,188," 5.1"
"9024","Z36350",2695,346,13,333,"12.4"
"9025","Z36351",1584,177,45,132," 8.3"
"9026","Z36352",2259,253,19,234,"10.4"
"9027","Z36353",1038,258,71,187,"18.0"
"9028","Z36360",9477,1410,96,1314,"13.9"
"9029","Z36362",1524,294,0,294,"19.3"
"9030","Z36371",277,61,0,61,"22.0"
"9031","Z36374",417,28,0,28," 6.7"
"9032","Z36375",3220,440,66,374,"11.6"
"9033","Z36376",983,218,11,207,"21.1"
"9034","Z36401",4467,1288,101,1187,"26.6"
"9035","Z36420",5345,1039,144,895,"16.7"
"9036","Z36421",4613,955,336,619,"13.4"
"9037","Z36425",670,253,124,129,"19.3"
"9038","Z36426",7497,1485,43,1442,"19.2"
"9039","Z36432",1321,260,24,236,"17.9"
"9040","Z36435",240,118,65,53,"22.1"
"9041","Z36439",280,22,12,10," 3.6"
"9042","Z36441",1649,254,0,254,"15.4"
"9043","Z36442",1891,507,141,366,"19.4"
"9044","Z36445",2281,494,149,345,"15.1"
"9045","Z36446",216,79,7,72,"33.3"
"9046","Z36451",2316,455,169,286,"12.3"
"9047","Z36453",1142,193,41,152,"13.3"
"9048","Z36456",792,168,53,115,"14.5"
"9049","Z36460",4772,875,317,558,"11.7"
"9050","Z36467",4576,800,78,722,"15.8"
"9051","Z36474",1550,311,53,258,"16.6"
"9052","Z36477",2439,532,132,400,"16.4"
"9053","Z36480",1123,457,303,154,"13.7"
"9054","Z36482",617,278,40,238,"38.6"
"9055","Z36502",7281,1013,6,1007,"13.8"
"9056","Z36505",629,80,0,80,"12.7"
"9057","Z36507",8184,1223,244,979,"12.0"
"9058","Z36509",758,142,13,129,"17.0"
"9059","Z36513",199,46,0,46,"23.1"
"9060","Z36518",1228,308,51,257,"20.9"
"9061","Z36522",2921,549,88,461,"15.8"
"9062","Z36523",1167,301,133,168,"14.4"
"9063","Z36524",923,458,258,200,"21.7"
"9064","Z36525",774,96,0,96,"12.4"
"9065","Z36526",12734,1211,145,1066," 8.4"
"9066","Z36527",5720,513,118,395," 6.9"
"9067","Z36528",1933,1389,1097,292,"15.1"
"9068","Z36530",3443,846,536,310," 9.0"
"9069","Z36532",13874,2262,747,1515,"10.9"
"9070","Z36535",14220,2772,334,2438,"17.1"
"9071","Z36539",393,62,26,36," 9.2"
"9072","Z36541",6023,851,90,761,"12.6"
"9073","Z36542",15528,9679,4072,5607,"36.1"
"9074","Z36544",4499,477,0,477,"10.6"
"9075","Z36545",4598,1052,441,611,"13.3"
"9076","Z36548",537,106,5,101,"18.8"
"9077","Z36551",3095,265,28,237," 7.7"
"9078","Z36558",1849,394,133,261,"14.1"
"9079","Z36560",1487,250,13,237,"15.9"
"9080","Z36561",12741,10069,5128,4941,"38.8"
"9081","Z36562",611,126,26,100,"16.4"
"9082","Z36567",5472,679,135,544," 9.9"
"9083","Z36571",6117,638,12,626,"10.2"
"9084","Z36572",2548,149,0,149," 5.8"
"9085","Z36574",706,338,124,214,"30.3"
"9086","Z36575",7342,725,45,680," 9.3"
"9087","Z36576",1700,127,0,127," 7.5"
"9088","Z36578",602,137,11,126,"20.9"
"9089","Z36579",1103,621,316,305,"27.7"
"9090","Z36580",2549,345,128,217," 8.5"
"9091","Z36582",10129,945,70,875," 8.6"
"9092","Z36583",297,68,0,68,"22.9"
"9093","Z36587",4461,696,109,587,"13.2"
"9094","Z36602",696,181,28,153,"22.0"
"9095","Z36603",3760,978,18,960,"25.5"
"9096","Z36604",5234,1026,49,977,"18.7"
"9097","Z36605",12819,2590,121,2469,"19.3"
"9098","Z36606",9369,1533,40,1493,"15.9"
"9099","Z36607",3436,701,19,682,"19.8"
"9100","Z36608",16375,1879,139,1740,"10.6"
"9101","Z36609",12897,1869,42,1827,"14.2"
"9102","Z36610",5876,1617,11,1606,"27.3"
"9103","Z36611",2613,405,32,373,"14.3"
"9104","Z36612",2039,419,0,419,"20.5"
"9105","Z36613",5173,724,111,613,"11.8"
"9106","Z36617",6379,1219,6,1213,"19.0"
"9107","Z36618",6944,791,22,769,"11.1"
"9108","Z36619",6274,534,54,480," 7.7"
"9109","Z36693",8372,817,40,777," 9.3"
"9110","Z36695",20057,1945,120,1825," 9.1"
"9111","Z36701",11069,2193,594,1599,"14.4"
"9112","Z36703",6027,890,153,737,"12.2"
"9113","Z36726",2528,585,285,300,"11.9"
"9114","Z36728",221,55,55,0," 0.0"
"9115","Z36732",4053,623,206,417,"10.3"
"9116","Z36736",574,146,46,100,"17.4"
"9117","Z36738",509,56,27,29," 5.7"
"9118","Z36742",942,224,95,129,"13.7"
"9119","Z36744",3356,691,283,408,"12.2"
"9120","Z36748",1661,256,75,181,"10.9"
"9121","Z36750",1217,170,3,167,"13.7"
"9122","Z36751",352,127,56,71,"20.2"
"9123","Z36756",2471,692,366,326,"13.2"
"9124","Z36758",796,114,32,82,"10.3"
"9125","Z36761",546,121,73,48," 8.8"
"9126","Z36765",635,125,83,42," 6.6"
"9127","Z36767",1002,246,92,154,"15.4"
"9128","Z36768",693,345,195,150,"21.6"
"9129","Z36769",1230,374,174,200,"16.3"
"9130","Z36775",477,127,66,61,"12.8"
"9131","Z36782",1388,330,186,144,"10.4"
"9132","Z36783",446,185,107,78,"17.5"
"9133","Z36784",3569,596,127,469,"13.1"
"9134","Z36785",636,38,24,14," 2.2"
"9135","Z36786",1633,372,153,219,"13.4"
"9136","Z36801",11038,1380,172,1208,"10.9"
"9137","Z36804",6921,622,132,490," 7.1"
"9138","Z36830",16306,1980,585,1395," 8.6"
"9139","Z36832",11979,1869,536,1333,"11.1"
"9140","Z36852",1066,106,32,74," 6.9"
"9141","Z36853",6039,2682,2025,657,"10.9"
"9142","Z36854",7334,1638,579,1059,"14.4"
"9143","Z36856",2346,311,42,269,"11.5"
"9144","Z36860",897,261,104,157,"17.5"
"9145","Z36861",2026,690,459,231,"11.4"
"9146","Z36862",3162,502,154,348,"11.0"
"9147","Z36863",5842,927,150,777,"13.3"
"9148","Z36866",1913,285,121,164," 8.6"
"9149","Z36867",10907,1450,42,1408,"12.9"
"9150","Z36869",9239,1416,86,1330,"14.4"
"9151","Z36870",7518,824,97,727," 9.7"
"9152","Z36871",512,53,40,13," 2.5"
"9153","Z36874",3541,321,87,234," 6.6"
"9154","Z36875",2136,437,46,391,"18.3"
"9155","Z36877",5272,403,47,356," 6.8"
"9156","Z36904",2129,341,14,327,"15.4"
"9157","Z36907",975,137,71,66," 6.8"
"9158","Z36908",1154,257,55,202,"17.5"
"9159","Z36912",1164,347,95,252,"21.6"
"9160","Z36919",997,260,78,182,"18.3"
"9161","Z36921",533,82,45,37," 6.9"
"9162","Z36925",1557,337,28,309,"19.8"
"9163","Z37010",1977,92,2,90," 4.6"
"9164","Z37012",1087,129,51,78," 7.2"
"9165","Z37013",35086,1969,114,1855," 5.3"
"9166","Z37014",910,95,0,95,"10.4"
"9167","Z37015",7358,624,55,569," 7.7"
"9168","Z37016",463,1,0,1," 0.2"
"9169","Z37020",2099,289,30,259,"12.3"
"9170","Z37022",2336,273,141,132," 5.7"
"9171","Z37023",785,173,0,173,"22.0"
"9172","Z37025",2090,228,57,171," 8.2"
"9173","Z37026",935,48,0,48," 5.1"
"9174","Z37027",19120,478,72,406," 2.1"
"9175","Z37028",453,126,76,50,"11.0"
"9176","Z37029",2282,339,58,281,"12.3"
"9177","Z37030",3113,344,160,184," 5.9"
"9178","Z37032",1787,169,0,169," 9.5"
"9179","Z37033",3468,540,65,475,"13.7"
"9180","Z37034",2836,348,85,263," 9.3"
"9181","Z37036",2367,340,88,252,"10.6"
"9182","Z37037",2466,207,0,207," 8.4"
"9183","Z37040",19891,2889,172,2717,"13.7"
"9184","Z37042",29693,3498,174,3324,"11.2"
"9185","Z37043",18173,1929,72,1857,"10.2"
"9186","Z37046",1684,159,0,159," 9.4"
"9187","Z37047",1040,87,0,87," 8.4"
"9188","Z37048",2468,215,0,215," 8.7"
"9189","Z37049",1448,140,0,140," 9.7"
"9190","Z37050",818,136,70,66," 8.1"
"9191","Z37051",1625,210,18,192,"11.8"
"9192","Z37055",11576,1328,160,1168,"10.1"
"9193","Z37058",3853,986,432,554,"14.4"
"9194","Z37059",554,116,64,52," 9.4"
"9195","Z37060",937,86,7,79," 8.4"
"9196","Z37061",2253,327,38,289,"12.8"
"9197","Z37062",4212,172,40,132," 3.1"
"9198","Z37064",20185,658,86,572," 2.8"
"9199","Z37066",17944,1251,123,1128," 6.3"
"9200","Z37067",10734,650,163,487," 4.5"
"9201","Z37069",7006,213,20,193," 2.8"
"9202","Z37072",13652,1194,23,1171," 8.6"
"9203","Z37073",5460,302,86,216," 4.0"
"9204","Z37074",3131,474,108,366,"11.7"
"9205","Z37075",25135,1379,127,1252," 5.0"
"9206","Z37076",17274,1554,157,1397," 8.1"
"9207","Z37078",362,90,40,50,"13.8"
"9208","Z37079",939,166,34,132,"14.1"
"9209","Z37080",3151,256,27,229," 7.3"
"9210","Z37082",2395,30,0,30," 1.3"
"9211","Z37083",6090,452,52,400," 6.6"
"9212","Z37086",11170,828,0,828," 7.4"
"9213","Z37087",17310,1595,306,1289," 7.4"
"9214","Z37090",5567,556,78,478," 8.6"
"9215","Z37091",9146,706,46,660," 7.2"
"9216","Z37095",832,182,116,66," 7.9"
"9217","Z37096",3220,979,488,491,"15.2"
"9218","Z37097",1225,286,163,123,"10.0"
"9219","Z37098",2463,328,0,328,"13.3"
"9220","Z37101",2906,439,95,344,"11.8"
"9221","Z37115",18222,2197,41,2156,"11.8"
"9222","Z37118",434,37,0,37," 8.5"
"9223","Z37122",19494,907,308,599," 3.1"
"9224","Z37127",6470,386,16,370," 5.7"
"9225","Z37128",17040,911,34,877," 5.1"
"9226","Z37129",19788,743,6,737," 3.7"
"9227","Z37130",23192,2001,124,1877," 8.1"
"9228","Z37134",1377,247,17,230,"16.7"
"9229","Z37135",3641,125,0,125," 3.4"
"9230","Z37137",1536,153,43,110," 7.2"
"9231","Z37138",9341,408,0,408," 4.4"
"9232","Z37141",497,40,9,31," 6.2"
"9233","Z37142",728,87,0,87,"12.0"
"9234","Z37143",1477,99,21,78," 5.3"
"9235","Z37144",1495,238,87,151,"10.1"
"9236","Z37145",1030,247,142,105,"10.2"
"9237","Z37146",2584,193,86,107," 4.1"
"9238","Z37148",9053,914,80,834," 9.2"
"9239","Z37149",945,141,22,119,"12.6"
"9240","Z37150",2468,499,146,353,"14.3"
"9241","Z37151",267,45,45,0," 0.0"
"9242","Z37153",2137,176,34,142," 6.6"
"9243","Z37160",13659,1356,120,1236," 9.0"
"9244","Z37166",6517,1505,695,810,"12.4"
"9245","Z37167",20557,1159,190,969," 4.7"
"9246","Z37172",11082,870,142,728," 6.6"
"9247","Z37174",11274,473,146,327," 2.9"
"9248","Z37178",990,103,47,56," 5.7"
"9249","Z37179",3902,181,34,147," 3.8"
"9250","Z37181",647,132,56,76,"11.7"
"9251","Z37183",1425,315,34,281,"19.7"
"9252","Z37184",2653,441,255,186," 7.0"
"9253","Z37185",4366,1023,723,300," 6.9"
"9254","Z37186",3871,692,45,647,"16.7"
"9255","Z37187",2983,303,37,266," 8.9"
"9256","Z37188",5275,128,0,128," 2.4"
"9257","Z37189",1411,153,28,125," 8.9"
"9258","Z37190",4007,523,61,462,"11.5"
"9259","Z37191",1670,283,0,283,"16.9"
"9260","Z37201",964,283,168,115,"11.9"
"9261","Z37203",7204,1427,346,1081,"15.0"
"9262","Z37204",5953,422,66,356," 6.0"
"9263","Z37205",11919,1044,209,835," 7.0"
"9264","Z37206",12110,1261,36,1225,"10.1"
"9265","Z37207",15225,1634,37,1597,"10.5"
"9266","Z37208",7744,997,19,978,"12.6"
"9267","Z37209",16222,2090,56,2034,"12.5"
"9268","Z37210",7329,793,9,784,"10.7"
"9269","Z37211",32431,2603,270,2333," 7.2"
"9270","Z37212",7362,779,123,656," 8.9"
"9271","Z37214",14194,967,134,833," 5.9"
"9272","Z37215",10443,735,35,700," 6.7"
"9273","Z37216",8600,766,16,750," 8.7"
"9274","Z37217",13575,1302,21,1281," 9.4"
"9275","Z37218",5937,647,20,627,"10.6"
"9276","Z37219",1198,342,118,224,"18.7"
"9277","Z37220",2478,162,25,137," 5.5"
"9278","Z37221",17493,1047,110,937," 5.4"
"9279","Z37301",666,149,12,137,"20.6"
"9280","Z37302",1609,61,0,61," 3.8"
"9281","Z37303",11512,1662,152,1510,"13.1"
"9282","Z37305",501,155,81,74,"14.8"
"9283","Z37307",2331,247,39,208," 8.9"
"9284","Z37308",1145,155,70,85," 7.4"
"9285","Z37309",925,99,9,90," 9.7"
"9286","Z37310",1954,118,32,86," 4.4"
"9287","Z37311",11531,1363,116,1247,"10.8"
"9288","Z37312",13724,1092,95,997," 7.3"
"9289","Z37313",611,118,17,101,"16.5"
"9290","Z37317",1388,310,57,253,"18.2"
"9291","Z37318",853,77,8,69," 8.1"
"9292","Z37321",7903,746,201,545," 6.9"
"9293","Z37322",3384,424,174,250," 7.4"
"9294","Z37323",12742,995,0,995," 7.8"
"9295","Z37324",2495,386,67,319,"12.8"
"9296","Z37325",747,141,49,92,"12.3"
"9297","Z37326",209,63,13,50,"23.9"
"9298","Z37327",5241,592,188,404," 7.7"
"9299","Z37328",524,47,35,12," 2.3"
"9300","Z37329",2579,339,93,246," 9.5"
"9301","Z37330",3290,287,80,207," 6.3"
"9302","Z37331",3695,592,108,484,"13.1"
"9303","Z37332",1087,115,51,64," 5.9"
"9304","Z37334",10189,1003,125,878," 8.6"
"9305","Z37335",1073,69,0,69," 6.4"
"9306","Z37336",1781,112,30,82," 4.6"
"9307","Z37337",705,135,73,62," 8.8"
"9308","Z37338",1677,276,65,211,"12.6"
"9309","Z37339",936,136,0,136,"14.5"
"9310","Z37340",323,34,8,26," 8.0"
"9311","Z37341",5333,553,251,302," 5.7"
"9312","Z37342",1373,142,52,90," 6.6"
"9313","Z37343",17453,897,34,863," 4.9"
"9314","Z37345",1027,85,16,69," 6.7"
"9315","Z37347",3365,270,0,270," 8.0"
"9316","Z37348",681,153,69,84,"12.3"
"9317","Z37350",831,87,9,78," 9.4"
"9318","Z37352",1454,260,124,136," 9.4"
"9319","Z37353",1905,173,56,117," 6.1"
"9320","Z37354",7433,1023,196,827,"11.1"
"9321","Z37355",10556,799,104,695," 6.6"
"9322","Z37356",1430,474,297,177,"12.4"
"9323","Z37357",2251,178,70,108," 4.8"
"9324","Z37361",737,232,19,213,"28.9"
"9325","Z37363",14265,1277,0,1277," 9.0"
"9326","Z37365",585,62,0,62,"10.6"
"9327","Z37366",382,44,10,34," 8.9"
"9328","Z37367",4475,947,303,644,"14.4"
"9329","Z37369",553,177,103,74,"13.4"
"9330","Z37370",1898,199,52,147," 7.7"
"9331","Z37373",1379,209,0,209,"15.2"
"9332","Z37374",914,145,105,40," 4.4"
"9333","Z37375",1336,163,103,60," 4.5"
"9334","Z37377",6501,566,137,429," 6.6"
"9335","Z37379",11637,1303,202,1101," 9.5"
"9336","Z37380",2947,259,41,218," 7.4"
"9337","Z37381",4676,933,374,559,"12.0"
"9338","Z37385",4316,1104,487,617,"14.3"
"9339","Z37387",1531,187,24,163,"10.6"
"9340","Z37388",11710,1057,209,848," 7.2"
"9341","Z37391",801,148,71,77," 9.6"
"9342","Z37397",4439,553,54,499,"11.2"
"9343","Z37398",7145,1327,501,826,"11.6"
"9344","Z37402",2442,440,19,421,"17.2"
"9345","Z37403",1527,284,62,222,"14.5"
"9346","Z37404",5834,1166,61,1105,"18.9"
"9347","Z37405",8134,1189,223,966,"11.9"
"9348","Z37406",6822,1249,82,1167,"17.1"
"9349","Z37407",3830,709,4,705,"18.4"
"9350","Z37408",788,81,9,72," 9.1"
"9351","Z37409",1423,354,0,354,"24.9"
"9352","Z37410",1904,331,0,331,"17.4"
"9353","Z37411",8568,1031,84,947,"11.1"
"9354","Z37412",10083,1110,106,1004,"10.0"
"9355","Z37415",12160,1502,151,1351,"11.1"
"9356","Z37416",6695,405,65,340," 5.1"
"9357","Z37419",3015,437,14,423,"14.0"
"9358","Z37421",21230,2269,87,2182,"10.3"
"9359","Z37601",17699,2103,274,1829,"10.3"
"9360","Z37604",17639,1735,482,1253," 7.1"
"9361","Z37615",9584,863,61,802," 8.4"
"9362","Z37617",5879,427,174,253," 4.3"
"9363","Z37618",6074,593,209,384," 6.3"
"9364","Z37620",18168,2222,411,1811,"10.0"
"9365","Z37640",2492,986,524,462,"18.5"
"9366","Z37641",4230,580,178,402," 9.5"
"9367","Z37642",6884,893,96,797,"11.6"
"9368","Z37643",16063,1706,269,1437," 8.9"
"9369","Z37645",2173,153,40,113," 5.2"
"9370","Z37650",5698,694,140,554," 9.7"
"9371","Z37658",2236,303,139,164," 7.3"
"9372","Z37659",12456,890,188,702," 5.6"
"9373","Z37660",19688,2071,437,1634," 8.3"
"9374","Z37663",6543,270,22,248," 3.8"
"9375","Z37664",12647,1252,149,1103," 8.7"
"9376","Z37665",3056,465,0,465,"15.2"
"9377","Z37680",299,43,43,0," 0.0"
"9378","Z37681",2904,507,168,339,"11.7"
"9379","Z37683",5878,934,269,665,"11.3"
"9380","Z37686",3708,384,277,107," 2.9"
"9381","Z37687",2603,755,397,358,"13.8"
"9382","Z37690",1625,143,51,92," 5.7"
"9383","Z37692",2411,497,178,319,"13.2"
"9384","Z37694",882,139,34,105,"11.9"
"9385","Z37701",3475,401,0,401,"11.5"
"9386","Z37705",2102,391,192,199," 9.5"
"9387","Z37708",3455,733,401,332," 9.6"
"9388","Z37709",1608,194,74,120," 7.5"
"9389","Z37710",426,57,4,53,"12.4"
"9390","Z37711",2370,511,46,465,"19.6"
"9391","Z37714",2300,510,224,286,"12.4"
"9392","Z37716",11265,1087,96,991," 8.8"
"9393","Z37721",5323,622,58,564,"10.6"
"9394","Z37722",3495,1115,857,258," 7.4"
"9395","Z37725",8344,1912,828,1084,"13.0"
"9396","Z37726",1069,309,145,164,"15.3"
"9397","Z37737",2658,293,131,162," 6.1"
"9398","Z37738",8525,5927,2609,3318,"38.9"
"9399","Z37742",2539,282,42,240," 9.5"
"9400","Z37743",12082,1379,398,981," 8.1"
"9401","Z37745",8349,1258,180,1078,"12.9"
"9402","Z37748",8525,1442,156,1286,"15.1"
"9403","Z37752",2681,395,45,350,"13.1"
"9404","Z37753",399,112,43,69,"17.3"
"9405","Z37755",1508,225,33,192,"12.7"
"9406","Z37756",1256,133,47,86," 6.8"
"9407","Z37757",4291,627,131,496,"11.6"
"9408","Z37760",5563,541,118,423," 7.6"
"9409","Z37762",1370,144,0,144,"10.5"
"9410","Z37763",7425,1032,366,666," 9.0"
"9411","Z37764",3994,605,95,510,"12.8"
"9412","Z37766",9971,2421,1272,1149,"11.5"
"9413","Z37769",2477,292,85,207," 8.4"
"9414","Z37771",6213,336,59,277," 4.5"
"9415","Z37772",5245,544,71,473," 9.0"
"9416","Z37774",8819,970,262,708," 8.0"
"9417","Z37777",5644,704,322,382," 6.8"
"9418","Z37779",1725,241,0,241,"14.0"
"9419","Z37801",10938,732,82,650," 5.9"
"9420","Z37803",13626,1500,224,1276," 9.4"
"9421","Z37804",10009,1004,32,972," 9.7"
"9422","Z37806",1241,170,0,170,"13.7"
"9423","Z37807",4519,769,158,611,"13.5"
"9424","Z37809",1007,165,41,124,"12.3"
"9425","Z37810",1045,269,0,269,"25.7"
"9426","Z37811",1773,406,207,199,"11.2"
"9427","Z37813",7489,712,26,686," 9.2"
"9428","Z37814",14197,1454,239,1215," 8.6"
"9429","Z37818",2271,184,59,125," 5.5"
"9430","Z37820",3259,450,53,397,"12.2"
"9431","Z37821",10506,1105,175,930," 8.9"
"9432","Z37825",4467,667,279,388," 8.7"
"9433","Z37826",2096,303,5,298,"14.2"
"9434","Z37828",827,55,0,55," 6.7"
"9435","Z37830",14547,1841,192,1649,"11.3"
"9436","Z37840",4399,506,0,506,"11.5"
"9437","Z37841",4411,795,249,546,"12.4"
"9438","Z37845",255,25,0,25," 9.8"
"9439","Z37846",2003,126,16,110," 5.5"
"9440","Z37847",1149,223,29,194,"16.9"
"9441","Z37849",10505,947,61,886," 8.4"
"9442","Z37852",1134,180,47,133,"11.7"
"9443","Z37853",1699,126,41,85," 5.0"
"9444","Z37854",6567,1006,268,738,"11.2"
"9445","Z37857",9788,1438,410,1028,"10.5"
"9446","Z37860",1724,122,64,58," 3.4"
"9447","Z37861",4018,663,278,385," 9.6"
"9448","Z37862",13062,4420,2738,1682,"12.9"
"9449","Z37863",5684,3069,1327,1742,"30.6"
"9450","Z37865",8826,381,65,316," 3.6"
"9451","Z37869",2654,570,186,384,"14.5"
"9452","Z37870",2391,420,236,184," 7.7"
"9453","Z37871",3633,344,23,321," 8.8"
"9454","Z37872",840,223,52,171,"20.4"
"9455","Z37873",2053,147,40,107," 5.2"
"9456","Z37874",6082,856,53,803,"13.2"
"9457","Z37876",17168,5270,3280,1990,"11.6"
"9458","Z37877",3835,374,46,328," 8.6"
"9459","Z37879",4848,859,146,713,"14.7"
"9460","Z37880",2161,691,453,238,"11.0"
"9461","Z37881",1078,241,63,178,"16.5"
"9462","Z37882",2389,1133,921,212," 8.9"
"9463","Z37885",2865,688,354,334,"11.7"
"9464","Z37886",2257,328,166,162," 7.2"
"9465","Z37887",2214,324,122,202," 9.1"
"9466","Z37888",1264,187,101,86," 6.8"
"9467","Z37890",3031,404,91,313,"10.3"
"9468","Z37891",1549,13,0,13," 0.8"
"9469","Z37892",943,129,12,117,"12.4"
"9470","Z37902",1364,145,19,126," 9.2"
"9471","Z37909",7582,726,29,697," 9.2"
"9472","Z37912",10925,493,34,459," 4.2"
"9473","Z37914",9626,1487,188,1299,"13.5"
"9474","Z37915",3413,117,9,108," 3.2"
"9475","Z37916",3136,418,32,386,"12.3"
"9476","Z37917",13195,1073,96,977," 7.4"
"9477","Z37918",19142,1744,130,1614," 8.4"
"9478","Z37919",14382,1486,377,1109," 7.7"
"9479","Z37920",19115,2045,260,1785," 9.3"
"9480","Z37921",12669,702,17,685," 5.4"
"9481","Z37922",13196,1072,299,773," 5.9"
"9482","Z37923",13631,1336,45,1291," 9.5"
"9483","Z37924",5324,534,0,534,"10.0"
"9484","Z37931",11828,1061,121,940," 7.9"
"9485","Z37932",6661,630,152,478," 7.2"
"9486","Z37934",9369,398,81,317," 3.4"
"9487","Z37938",6869,373,94,279," 4.1"
"9488","Z38001",1973,307,39,268,"13.6"
"9489","Z38002",13350,548,0,548," 4.1"
"9490","Z38004",3724,109,0,109," 2.9"
"9491","Z38006",2205,373,24,349,"15.8"
"9492","Z38008",3983,727,89,638,"16.0"
"9493","Z38011",3642,159,0,159," 4.4"
"9494","Z38012",6485,950,47,903,"13.9"
"9495","Z38015",1085,91,0,91," 8.4"
"9496","Z38016",19467,1471,69,1402," 7.2"
"9497","Z38017",18016,721,173,548," 3.0"
"9498","Z38018",14780,1147,52,1095," 7.4"
"9499","Z38019",6682,739,9,730,"10.9"
"9500","Z38023",2294,193,0,193," 8.4"
"9501","Z38024",12284,1256,333,923," 7.5"
"9502","Z38028",2465,63,10,53," 2.2"
"9503","Z38030",319,81,0,81,"25.4"
"9504","Z38034",1327,158,21,137,"10.3"
"9505","Z38036",220,20,0,20," 9.1"
"9506","Z38037",843,157,17,140,"16.6"
"9507","Z38039",773,124,3,121,"15.7"
"9508","Z38040",2298,338,91,247,"10.7"
"9509","Z38041",1332,315,92,223,"16.7"
"9510","Z38044",444,125,103,22," 5.0"
"9511","Z38049",1802,191,8,183,"10.2"
"9512","Z38050",244,45,3,42,"17.2"
"9513","Z38052",1821,383,93,290,"15.9"
"9514","Z38053",11360,994,71,923," 8.1"
"9515","Z38057",1555,147,57,90," 5.8"
"9516","Z38058",3527,246,0,246," 7.0"
"9517","Z38059",3205,347,24,323,"10.1"
"9518","Z38060",4214,275,43,232," 5.5"
"9519","Z38063",7574,837,146,691," 9.1"
"9520","Z38066",1191,92,8,84," 7.1"
"9521","Z38067",833,288,162,126,"15.1"
"9522","Z38068",4438,497,62,435," 9.8"
"9523","Z38069",1078,170,94,76," 7.1"
"9524","Z38079",1537,379,141,238,"15.5"
"9525","Z38080",1221,131,32,99," 8.1"
"9526","Z38103",7695,955,395,560," 7.3"
"9527","Z38104",14683,2052,183,1869,"12.7"
"9528","Z38105",3717,634,77,557,"15.0"
"9529","Z38106",12364,2758,64,2694,"21.8"
"9530","Z38107",8730,1913,11,1902,"21.8"
"9531","Z38108",8529,2089,10,2079,"24.4"
"9532","Z38109",19483,3220,24,3196,"16.4"
"9533","Z38111",19992,3021,192,2829,"14.2"
"9534","Z38112",7875,1526,101,1425,"18.1"
"9535","Z38114",13418,3672,72,3600,"26.8"
"9536","Z38115",19141,2419,13,2406,"12.6"
"9537","Z38116",18935,4804,42,4762,"25.1"
"9538","Z38117",12440,853,69,784," 6.3"
"9539","Z38118",17258,3920,0,3920,"22.7"
"9540","Z38119",10751,895,80,815," 7.6"
"9541","Z38120",6864,660,95,565," 8.2"
"9542","Z38122",11325,1791,42,1749,"15.4"
"9543","Z38125",14584,963,44,919," 6.3"
"9544","Z38126",2712,729,0,729,"26.9"
"9545","Z38127",18234,3407,13,3394,"18.6"
"9546","Z38128",18847,3345,14,3331,"17.7"
"9547","Z38133",7720,396,0,396," 5.1"
"9548","Z38134",16229,1569,35,1534," 9.5"
"9549","Z38135",10938,605,68,537," 4.9"
"9550","Z38138",10376,827,172,655," 6.3"
"9551","Z38139",5617,229,37,192," 3.4"
"9552","Z38141",8166,538,0,538," 6.6"
"9553","Z38201",4556,640,46,594,"13.0"
"9554","Z38221",1945,569,346,223,"11.5"
"9555","Z38225",2859,232,31,201," 7.0"
"9556","Z38226",112,12,0,12,"10.7"
"9557","Z38229",1410,189,15,174,"12.3"
"9558","Z38230",1694,128,31,97," 5.7"
"9559","Z38231",797,66,11,55," 6.9"
"9560","Z38232",1031,259,107,152,"14.7"
"9561","Z38233",1246,175,4,171,"13.7"
"9562","Z38237",7108,916,53,863,"12.1"
"9563","Z38240",1133,119,0,119,"10.5"
"9564","Z38241",483,113,20,93,"19.3"
"9565","Z38242",9319,1131,93,1038,"11.1"
"9566","Z38251",1193,151,17,134,"11.2"
"9567","Z38255",1098,134,10,124,"11.3"
"9568","Z38256",2872,1560,1340,220," 7.7"
"9569","Z38258",811,195,0,195,"24.0"
"9570","Z38259",372,56,0,56,"15.1"
"9571","Z38260",1481,122,14,108," 7.3"
"9572","Z38261",7711,1033,62,971,"12.6"
"9573","Z38301",15879,2783,106,2677,"16.9"
"9574","Z38305",21449,2256,119,2137,"10.0"
"9575","Z38310",2708,410,68,342,"12.6"
"9576","Z38311",563,131,71,60,"10.7"
"9577","Z38313",1124,83,51,32," 2.8"
"9578","Z38315",1631,266,75,191,"11.7"
"9579","Z38316",1426,76,4,72," 5.0"
"9580","Z38317",1309,281,97,184,"14.1"
"9581","Z38320",5582,1165,527,638,"11.4"
"9582","Z38321",1040,192,11,181,"17.4"
"9583","Z38326",2374,1257,1075,182," 7.7"
"9584","Z38327",248,68,43,25,"10.1"
"9585","Z38328",267,51,43,8," 3.0"
"9586","Z38329",1896,543,349,194,"10.2"
"9587","Z38330",1884,145,26,119," 6.3"
"9588","Z38332",670,125,10,115,"17.2"
"9589","Z38334",904,247,29,218,"24.1"
"9590","Z38337",601,122,0,122,"20.3"
"9591","Z38339",283,41,22,19," 6.7"
"9592","Z38340",5205,665,230,435," 8.4"
"9593","Z38341",1322,372,166,206,"15.6"
"9594","Z38342",688,115,19,96,"14.0"
"9595","Z38343",7316,1136,71,1065,"14.6"
"9596","Z38344",3786,525,116,409,"10.8"
"9597","Z38345",1010,52,0,52," 5.1"
"9598","Z38348",569,60,0,60,"10.5"
"9599","Z38351",8180,1280,42,1238,"15.1"
"9600","Z38355",2417,272,0,272,"11.3"
"9601","Z38356",1167,104,0,104," 8.9"
"9602","Z38357",1268,216,52,164,"12.9"
"9603","Z38358",5198,766,45,721,"13.9"
"9604","Z38359",163,36,5,31,"19.0"
"9605","Z38361",523,139,22,117,"22.4"
"9606","Z38363",3147,767,279,488,"15.5"
"9607","Z38366",1023,220,24,196,"19.2"
"9608","Z38367",1282,193,46,147,"11.5"
"9609","Z38368",838,151,36,115,"13.7"
"9610","Z38369",878,157,9,148,"16.9"
"9611","Z38371",646,194,71,123,"19.0"
"9612","Z38372",8534,2100,918,1182,"13.9"
"9613","Z38374",1038,147,28,119,"11.5"
"9614","Z38375",4290,779,114,665,"15.5"
"9615","Z38379",598,53,15,38," 6.4"
"9616","Z38380",600,344,293,51," 8.5"
"9617","Z38381",802,207,61,146,"18.2"
"9618","Z38382",4373,464,10,454,"10.4"
"9619","Z38390",370,19,0,19," 5.1"
"9620","Z38391",472,65,0,65,"13.8"
"9621","Z38392",351,81,0,81,"23.1"
"9622","Z38401",23033,1969,98,1871," 8.1"
"9623","Z38449",1220,187,17,170,"13.9"
"9624","Z38450",1270,256,74,182,"14.3"
"9625","Z38451",1995,173,42,131," 6.6"
"9626","Z38452",641,127,30,97,"15.1"
"9627","Z38456",1728,220,26,194,"11.2"
"9628","Z38460",585,62,19,43," 7.4"
"9629","Z38462",4478,582,99,483,"10.8"
"9630","Z38463",1266,173,26,147,"11.6"
"9631","Z38464",9978,1129,127,1002,"10.0"
"9632","Z38468",2170,305,9,296,"13.6"
"9633","Z38469",1836,177,39,138," 7.5"
"9634","Z38472",1306,234,78,156,"11.9"
"9635","Z38473",551,83,0,83,"15.1"
"9636","Z38474",3772,580,52,528,"14.0"
"9637","Z38477",1353,221,67,154,"11.4"
"9638","Z38478",8261,1541,342,1199,"14.5"
"9639","Z38481",468,62,27,35," 7.5"
"9640","Z38483",2409,224,42,182," 7.6"
"9641","Z38485",3048,346,79,267," 8.8"
"9642","Z38487",549,162,28,134,"24.4"
"9643","Z38488",1037,103,48,55," 5.3"
"9644","Z38501",17994,1544,184,1360," 7.6"
"9645","Z38504",478,45,27,18," 3.8"
"9646","Z38506",11486,724,85,639," 5.6"
"9647","Z38541",742,149,60,89,"12.0"
"9648","Z38544",3074,494,157,337,"11.0"
"9649","Z38545",556,84,0,84,"15.1"
"9650","Z38549",2498,813,559,254,"10.2"
"9651","Z38551",2102,469,204,265,"12.6"
"9652","Z38553",1115,142,33,109," 9.8"
"9653","Z38555",9030,1133,203,930,"10.3"
"9654","Z38556",6106,1202,475,727,"11.9"
"9655","Z38558",4972,777,529,248," 5.0"
"9656","Z38562",3393,786,264,522,"15.4"
"9657","Z38563",1207,78,56,22," 1.8"
"9658","Z38565",618,58,25,33," 5.3"
"9659","Z38567",320,19,10,9," 2.8"
"9660","Z38568",1335,441,207,234,"17.5"
"9661","Z38569",306,159,106,53,"17.3"
"9662","Z38570",4309,443,40,403," 9.4"
"9663","Z38571",6035,818,235,583," 9.7"
"9664","Z38572",5659,1113,616,497," 8.8"
"9665","Z38574",3731,492,73,419,"11.2"
"9666","Z38575",542,60,0,60,"11.1"
"9667","Z38577",601,198,24,174,"29.0"
"9668","Z38578",113,42,0,42,"37.2"
"9669","Z38580",672,76,34,42," 6.2"
"9670","Z38581",1742,234,71,163," 9.4"
"9671","Z38582",806,158,77,81,"10.0"
"9672","Z38583",10697,1757,467,1290,"12.1"
"9673","Z38585",1697,327,40,287,"16.9"
"9674","Z38587",771,203,37,166,"21.5"
"9675","Z38588",572,183,135,48," 8.4"
"9676","Z38601",1151,258,60,198,"17.2"
"9677","Z38603",1721,499,207,292,"17.0"
"9678","Z38606",6522,1125,258,867,"13.3"
"9679","Z38610",1438,148,45,103," 7.2"
"9680","Z38611",7198,909,149,760,"10.6"
"9681","Z38614",8122,978,41,937,"11.5"
"9682","Z38617",332,54,19,35,"10.5"
"9683","Z38618",4667,560,112,448," 9.6"
"9684","Z38619",2661,661,330,331,"12.4"
"9685","Z38621",746,150,52,98,"13.1"
"9686","Z38627",493,119,0,119,"24.1"
"9687","Z38629",725,98,52,46," 6.3"
"9688","Z38631",469,81,7,74,"15.8"
"9689","Z38632",9729,333,121,212," 2.2"
"9690","Z38633",1058,187,33,154,"14.6"
"9691","Z38635",6222,795,174,621,"10.0"
"9692","Z38637",10187,720,22,698," 6.9"
"9693","Z38643",1083,170,58,112,"10.3"
"9694","Z38646",1436,224,13,211,"14.7"
"9695","Z38647",538,206,18,188,"34.9"
"9696","Z38650",1602,218,51,167,"10.4"
"9697","Z38651",2809,34,0,34," 1.2"
"9698","Z38652",7096,827,109,718,"10.1"
"9699","Z38654",17896,719,61,658," 3.7"
"9700","Z38655",20322,5290,2247,3043,"15.0"
"9701","Z38658",1047,195,82,113,"10.8"
"9702","Z38659",927,156,22,134,"14.5"
"9703","Z38663",5428,792,230,562,"10.4"
"9704","Z38664",1807,611,0,611,"33.8"
"9705","Z38665",957,90,61,29," 3.0"
"9706","Z38666",3014,692,77,615,"20.4"
"9707","Z38668",5612,428,24,404," 7.2"
"9708","Z38671",14210,941,59,882," 6.2"
"9709","Z38672",4480,313,0,313," 7.0"
"9710","Z38673",241,43,8,35,"14.5"
"9711","Z38674",443,112,55,57,"12.9"
"9712","Z38676",2504,200,56,144," 5.8"
"9713","Z38677",98,40,0,40,"40.8"
"9714","Z38680",2402,183,31,152," 6.3"
"9715","Z38683",2645,381,138,243," 9.2"
"9716","Z38701",10421,1637,127,1510,"14.5"
"9717","Z38703",5651,908,48,860,"15.2"
"9718","Z38722",200,54,0,54,"27.0"
"9719","Z38725",424,128,106,22," 5.2"
"9720","Z38730",791,117,8,109,"13.8"
"9721","Z38732",7524,690,45,645," 8.6"
"9722","Z38737",1268,232,29,203,"16.0"
"9723","Z38740",154,39,5,34,"22.1"
"9724","Z38746",242,67,37,30,"12.4"
"9725","Z38748",1727,241,54,187,"10.8"
"9726","Z38751",4539,493,18,475,"10.5"
"9727","Z38753",561,74,0,74,"13.2"
"9728","Z38756",2866,476,39,437,"15.2"
"9729","Z38759",447,69,21,48,"10.7"
"9730","Z38761",878,118,19,99,"11.3"
"9731","Z38762",1012,138,0,138,"13.6"
"9732","Z38771",1167,196,30,166,"14.2"
"9733","Z38773",1383,164,0,164,"11.9"
"9734","Z38774",1040,203,18,185,"17.8"
"9735","Z38778",610,79,0,79,"13.0"
"9736","Z38801",12483,1385,18,1367,"11.0"
"9737","Z38804",7624,968,83,885,"11.6"
"9738","Z38821",5360,639,105,534,"10.0"
"9739","Z38824",3861,595,50,545,"14.1"
"9740","Z38826",2235,149,0,149," 6.7"
"9741","Z38827",1272,153,8,145,"11.4"
"9742","Z38828",1724,158,77,81," 4.7"
"9743","Z38829",7538,777,105,672," 8.9"
"9744","Z38833",1358,251,14,237,"17.5"
"9745","Z38834",13456,1892,143,1749,"13.0"
"9746","Z38838",644,132,0,132,"20.5"
"9747","Z38841",1379,250,13,237,"17.2"
"9748","Z38843",4989,667,66,601,"12.0"
"9749","Z38846",1048,125,38,87," 8.3"
"9750","Z38847",1468,242,5,237,"16.1"
"9751","Z38848",356,65,0,65,"18.3"
"9752","Z38849",2466,245,0,245," 9.9"
"9753","Z38850",1279,151,0,151,"11.8"
"9754","Z38851",3474,415,77,338," 9.7"
"9755","Z38852",5379,1806,1036,770,"14.3"
"9756","Z38855",2097,287,0,287,"13.7"
"9757","Z38856",858,57,38,19," 2.2"
"9758","Z38857",1367,83,0,83," 6.1"
"9759","Z38858",3266,473,68,405,"12.4"
"9760","Z38859",366,68,33,35," 9.6"
"9761","Z38860",2512,466,69,397,"15.8"
"9762","Z38862",1125,247,21,226,"20.1"
"9763","Z38863",8266,1294,73,1221,"14.8"
"9764","Z38865",2038,186,16,170," 8.3"
"9765","Z38866",5244,338,96,242," 4.6"
"9766","Z38868",2395,342,79,263,"11.0"
"9767","Z38869",179,36,0,36,"20.1"
"9768","Z38870",1434,356,30,326,"22.7"
"9769","Z38871",727,80,14,66," 9.1"
"9770","Z38873",1340,174,64,110," 8.2"
"9771","Z38876",644,102,0,102,"15.8"
"9772","Z38878",1281,112,28,84," 6.6"
"9773","Z38879",451,68,0,68,"15.1"
"9774","Z38901",8499,2254,114,2140,"25.2"
"9775","Z38914",276,45,2,43,"15.6"
"9776","Z38915",1936,342,65,277,"14.3"
"9777","Z38916",2477,308,51,257,"10.4"
"9778","Z38917",1599,320,95,225,"14.1"
"9779","Z38921",1577,362,54,308,"19.5"
"9780","Z38922",2061,637,185,452,"21.9"
"9781","Z38925",1210,187,30,157,"13.0"
"9782","Z38928",85,48,0,48,"56.5"
"9783","Z38929",679,210,80,130,"19.1"
"9784","Z38930",10437,1610,337,1273,"12.2"
"9785","Z38940",802,61,0,61," 7.6"
"9786","Z38941",1862,348,108,240,"12.9"
"9787","Z38947",288,42,13,29,"10.1"
"9788","Z38948",1356,287,90,197,"14.5"
"9789","Z38951",514,52,22,30," 5.8"
"9790","Z38957",303,94,27,67,"22.1"
"9791","Z38965",4048,619,97,522,"12.9"
"9792","Z38966",312,80,14,66,"21.2"
"9793","Z38967",3545,905,292,613,"17.3"
"9794","Z39038",2508,404,75,329,"13.1"
"9795","Z39039",849,201,80,121,"14.3"
"9796","Z39040",1610,144,47,97," 6.0"
"9797","Z39041",1628,262,13,249,"15.3"
"9798","Z39042",13778,761,110,651," 4.7"
"9799","Z39044",1771,310,80,230,"13.0"
"9800","Z39046",10506,1299,109,1190,"11.3"
"9801","Z39047",15028,476,80,396," 2.6"
"9802","Z39051",6535,744,201,543," 8.3"
"9803","Z39054",161,37,0,37,"23.0"
"9804","Z39056",9894,593,25,568," 5.7"
"9805","Z39057",767,131,0,131,"17.1"
"9806","Z39059",4908,799,132,667,"13.6"
"9807","Z39063",1616,368,123,245,"15.2"
"9808","Z39066",1731,184,42,142," 8.2"
"9809","Z39067",741,134,58,76,"10.3"
"9810","Z39069",2432,543,294,249,"10.2"
"9811","Z39071",2263,165,0,165," 7.3"
"9812","Z39073",7979,912,135,777," 9.7"
"9813","Z39074",6283,946,209,737,"11.7"
"9814","Z39079",697,172,69,103,"14.8"
"9815","Z39083",4475,983,255,728,"16.3"
"9816","Z39090",6015,811,173,638,"10.6"
"9817","Z39092",1319,133,30,103," 7.8"
"9818","Z39094",1760,353,29,324,"18.4"
"9819","Z39095",3359,719,295,424,"12.6"
"9820","Z39097",271,74,6,68,"25.1"
"9821","Z39108",1253,436,160,276,"22.0"
"9822","Z39110",15116,574,169,405," 2.7"
"9823","Z39111",3962,613,137,476,"12.0"
"9824","Z39113",155,24,0,24,"15.5"
"9825","Z39114",4521,967,166,801,"17.7"
"9826","Z39116",955,207,72,135,"14.1"
"9827","Z39117",4206,582,78,504,"12.0"
"9828","Z39119",2798,382,0,382,"13.7"
"9829","Z39120",14575,2647,846,1801,"12.4"
"9830","Z39140",1101,204,48,156,"14.2"
"9831","Z39145",2225,467,35,432,"19.4"
"9832","Z39146",1234,299,176,123,"10.0"
"9833","Z39149",632,123,21,102,"16.1"
"9834","Z39152",508,48,33,15," 3.0"
"9835","Z39153",1888,312,33,279,"14.8"
"9836","Z39154",3721,430,95,335," 9.0"
"9837","Z39157",11682,1120,81,1039," 8.9"
"9838","Z39159",1524,195,86,109," 7.2"
"9839","Z39168",2802,363,54,309,"11.0"
"9840","Z39169",1243,274,158,116," 9.3"
"9841","Z39170",3975,279,5,274," 6.9"
"9842","Z39175",1946,419,86,333,"17.1"
"9843","Z39176",906,342,92,250,"27.6"
"9844","Z39180",14539,1855,411,1444," 9.9"
"9845","Z39183",7159,1563,659,904,"12.6"
"9846","Z39189",1655,211,28,183,"11.1"
"9847","Z39191",3193,514,243,271," 8.5"
"9848","Z39192",867,333,146,187,"21.6"
"9849","Z39194",6912,1023,164,859,"12.4"
"9850","Z39201",317,41,0,41,"12.9"
"9851","Z39202",4166,697,78,619,"14.9"
"9852","Z39203",2873,896,54,842,"29.3"
"9853","Z39204",8547,2267,28,2239,"26.2"
"9854","Z39206",11063,1253,57,1196,"10.8"
"9855","Z39208",11904,787,134,653," 5.5"
"9856","Z39209",12731,2983,71,2912,"22.9"
"9857","Z39211",11431,1169,104,1065," 9.3"
"9858","Z39212",12934,1583,20,1563,"12.1"
"9859","Z39213",10130,1474,57,1417,"14.0"
"9860","Z39216",1934,416,0,416,"21.5"
"9861","Z39218",2859,251,0,251," 8.8"
"9862","Z39232",3526,299,14,285," 8.1"
"9863","Z39272",5114,385,38,347," 6.8"
"9864","Z39301",12499,2266,230,2036,"16.3"
"9865","Z39305",9280,1150,197,953,"10.3"
"9866","Z39307",7418,1122,74,1048,"14.1"
"9867","Z39320",832,122,49,73," 8.8"
"9868","Z39322",669,143,20,123,"18.4"
"9869","Z39323",567,58,38,20," 3.5"
"9870","Z39325",2434,162,51,111," 4.6"
"9871","Z39327",1704,311,130,181,"10.6"
"9872","Z39328",2121,524,236,288,"13.6"
"9873","Z39330",1100,185,30,155,"14.1"
"9874","Z39332",759,149,80,69," 9.1"
"9875","Z39335",1449,297,91,206,"14.2"
"9876","Z39336",414,10,0,10," 2.4"
"9877","Z39337",855,134,65,69," 8.1"
"9878","Z39338",1747,385,180,205,"11.7"
"9879","Z39339",7076,800,165,635," 9.0"
"9880","Z39341",2911,496,98,398,"13.7"
"9881","Z39342",586,57,3,54," 9.2"
"9882","Z39345",3094,444,43,401,"13.0"
"9883","Z39346",1004,116,2,114,"11.4"
"9884","Z39347",960,266,129,137,"14.3"
"9885","Z39350",10405,1335,305,1030," 9.9"
"9886","Z39354",828,203,133,70," 8.5"
"9887","Z39355",3151,538,129,409,"13.0"
"9888","Z39358",801,115,65,50," 6.2"
"9889","Z39359",120,12,0,12,"10.0"
"9890","Z39360",1954,437,76,361,"18.5"
"9891","Z39361",875,152,49,103,"11.8"
"9892","Z39362",1326,315,33,282,"21.3"
"9893","Z39363",970,202,23,179,"18.5"
"9894","Z39364",1449,169,47,122," 8.4"
"9895","Z39365",3055,406,87,319,"10.4"
"9896","Z39366",619,45,45,0," 0.0"
"9897","Z39367",6769,1151,317,834,"12.3"
"9898","Z39401",19772,2934,175,2759,"14.0"
"9899","Z39402",17377,1262,19,1243," 7.2"
"9900","Z39422",2439,231,83,148," 6.1"
"9901","Z39423",1277,287,14,273,"21.4"
"9902","Z39425",786,169,41,128,"16.3"
"9903","Z39426",7181,960,398,562," 7.8"
"9904","Z39427",673,15,15,0," 0.0"
"9905","Z39428",4201,938,35,903,"21.5"
"9906","Z39429",7669,1405,485,920,"12.0"
"9907","Z39437",5478,542,0,542," 9.9"
"9908","Z39439",2130,347,60,287,"13.5"
"9909","Z39440",9158,1645,87,1558,"17.0"
"9910","Z39443",9076,1120,163,957,"10.5"
"9911","Z39451",1828,287,85,202,"11.1"
"9912","Z39452",11308,2258,605,1653,"14.6"
"9913","Z39455",4318,634,113,521,"12.1"
"9914","Z39456",529,84,0,84,"15.9"
"9915","Z39459",1628,298,24,274,"16.8"
"9916","Z39464",891,84,71,13," 1.5"
"9917","Z39465",8441,1065,72,993,"11.8"
"9918","Z39466",11808,1417,277,1140," 9.7"
"9919","Z39470",6022,1377,427,950,"15.8"
"9920","Z39474",2874,531,184,347,"12.1"
"9921","Z39475",4891,613,73,540,"11.0"
"9922","Z39476",3299,597,70,527,"16.0"
"9923","Z39478",1005,160,45,115,"11.4"
"9924","Z39479",2301,235,0,235,"10.2"
"9925","Z39480",1285,213,10,203,"15.8"
"9926","Z39481",778,84,23,61," 7.8"
"9927","Z39482",3868,587,84,503,"13.0"
"9928","Z39483",2908,478,316,162," 5.6"
"9929","Z39501",10789,2250,250,2000,"18.5"
"9930","Z39503",20679,2337,172,2165,"10.5"
"9931","Z39507",9376,1701,315,1386,"14.8"
"9932","Z39520",8869,2252,1254,998,"11.3"
"9933","Z39525",4104,726,304,422,"10.3"
"9934","Z39530",4342,806,153,653,"15.0"
"9935","Z39531",9629,2232,262,1970,"20.5"
"9936","Z39532",14877,1759,199,1560,"10.5"
"9937","Z39540",4439,615,45,570,"12.8"
"9938","Z39553",7356,1332,279,1053,"14.3"
"9939","Z39556",3735,535,316,219," 5.9"
"9940","Z39560",7593,830,239,591," 7.8"
"9941","Z39561",918,127,0,127,"13.8"
"9942","Z39562",6988,851,126,725,"10.4"
"9943","Z39563",6523,1300,115,1185,"18.2"
"9944","Z39564",16340,2492,305,2187,"13.4"
"9945","Z39565",7619,1223,143,1080,"14.2"
"9946","Z39567",5321,839,63,776,"14.6"
"9947","Z39571",6330,1184,610,574," 9.1"
"9948","Z39572",770,173,95,78,"10.1"
"9949","Z39573",3442,701,124,577,"16.8"
"9950","Z39574",5072,335,68,267," 5.3"
"9951","Z39576",2800,410,129,281,"10.0"
"9952","Z39577",4446,1053,92,961,"21.6"
"9953","Z39581",5543,1406,44,1362,"24.6"
"9954","Z39601",10453,1550,504,1046,"10.0"
"9955","Z39629",2741,402,93,309,"11.3"
"9956","Z39630",495,107,19,88,"17.8"
"9957","Z39631",1602,238,114,124," 7.7"
"9958","Z39633",521,107,49,58,"11.1"
"9959","Z39635",119,41,41,0," 0.0"
"9960","Z39638",1896,543,178,365,"19.3"
"9961","Z39641",2139,554,151,403,"18.8"
"9962","Z39643",524,27,0,27," 5.2"
"9963","Z39645",2596,580,298,282,"10.9"
"9964","Z39648",9864,1475,484,991,"10.0"
"9965","Z39652",3757,940,405,535,"14.2"
"9966","Z39653",1524,295,177,118," 7.7"
"9967","Z39654",2601,447,175,272,"10.5"
"9968","Z39656",410,61,19,42,"10.2"
"9969","Z39657",969,259,194,65," 6.7"
"9970","Z39661",1638,479,288,191,"11.7"
"9971","Z39662",574,47,13,34," 5.9"
"9972","Z39663",1325,265,81,184,"13.9"
"9973","Z39665",585,163,93,70,"12.0"
"9974","Z39666",4150,697,259,438,"10.6"
"9975","Z39667",5793,1086,681,405," 7.0"
"9976","Z39669",3237,1523,1271,252," 7.8"
"9977","Z39701",6955,1499,253,1246,"17.9"
"9978","Z39702",9540,919,68,851," 8.9"
"9979","Z39705",6460,858,0,858,"13.3"
"9980","Z39730",5215,838,167,671,"12.9"
"9981","Z39735",1817,300,108,192,"10.6"
"9982","Z39736",119,14,2,12,"10.1"
"9983","Z39737",135,39,0,39,"28.9"
"9984","Z39739",1367,414,230,184,"13.5"
"9985","Z39740",2229,273,5,268,"12.0"
"9986","Z39741",535,62,14,48," 9.0"
"9987","Z39743",758,136,22,114,"15.0"
"9988","Z39744",2831,512,140,372,"13.1"
"9989","Z39747",1098,231,100,131,"11.9"
"9990","Z39750",1034,101,22,79," 7.6"
"9991","Z39751",752,108,15,93,"12.4"
"9992","Z39752",1365,178,137,41," 3.0"
"9993","Z39755",416,103,11,92,"22.1"
"9994","Z39756",883,75,25,50," 5.7"
"9995","Z39759",19660,3397,755,2642,"13.4"
"9996","Z39767",334,80,42,38,"11.4"
"9997","Z39769",1131,285,53,232,"20.5"
"9998","Z39772",890,230,60,170,"19.1"
"9999","Z39773",7521,1122,132,990,"13.2"
"10000","Z39813",1023,232,79,153,"15.0"
"10001","Z39815",772,92,5,87,"11.3"
"10002","Z39817",4183,459,93,366," 8.7"
"10003","Z39819",5175,688,296,392," 7.6"
"10004","Z39823",3674,689,216,473,"12.9"
"10005","Z39825",681,69,0,69,"10.1"
"10006","Z39827",1570,83,0,83," 5.3"
"10007","Z39828",6417,859,285,574," 8.9"
"10008","Z39834",1102,147,27,120,"10.9"
"10009","Z39836",219,36,36,0," 0.0"
"10010","Z39837",2921,432,131,301,"10.3"
"10011","Z39840",2710,660,481,179," 6.6"
"10012","Z39841",318,61,31,30," 9.4"
"10013","Z39842",3685,717,57,660,"17.9"
"10014","Z39845",4470,1426,767,659,"14.7"
"10015","Z39846",978,173,52,121,"12.4"
"10016","Z39854",2107,1105,740,365,"17.3"
"10017","Z39867",230,71,47,24,"10.4"
"10018","Z39877",226,98,42,56,"24.8"
"10019","Z39885",42,7,0,7,"16.7"
"10020","Z39886",800,167,96,71," 8.9"
"10021","Z39897",1603,305,72,233,"14.5"
"10022","Z40003",862,16,0,16," 1.9"
"10023","Z40004",12088,936,99,837," 6.9"
"10024","Z40006",2063,164,19,145," 7.0"
"10025","Z40008",1539,227,77,150," 9.7"
"10026","Z40009",579,110,38,72,"12.4"
"10027","Z40010",250,74,0,74,"29.6"
"10028","Z40011",1041,162,78,84," 8.1"
"10029","Z40012",265,84,0,84,"31.7"
"10030","Z40013",2114,102,39,63," 3.0"
"10031","Z40014",7232,368,57,311," 4.3"
"10032","Z40019",1633,136,0,136," 8.3"
"10033","Z40022",317,13,8,5," 1.6"
"10034","Z40023",1832,192,22,170," 9.3"
"10035","Z40026",1920,61,0,61," 3.2"
"10036","Z40031",7571,617,17,600," 7.9"
"10037","Z40033",5281,374,58,316," 6.0"
"10038","Z40040",245,56,9,47,"19.2"
"10039","Z40045",1688,232,81,151," 8.9"
"10040","Z40046",900,142,57,85," 9.4"
"10041","Z40047",8002,372,6,366," 4.6"
"10042","Z40050",679,62,0,62," 9.1"
"10043","Z40051",1913,293,49,244,"12.8"
"10044","Z40052",265,34,28,6," 2.3"
"10045","Z40055",769,32,0,32," 4.2"
"10046","Z40056",1352,100,0,100," 7.4"
"10047","Z40058",53,11,0,11,"20.8"
"10048","Z40059",6933,372,56,316," 4.6"
"10049","Z40060",490,57,0,57,"11.6"
"10050","Z40065",11488,644,32,612," 5.3"
"10051","Z40067",1996,117,45,72," 3.6"
"10052","Z40068",781,5,0,5," 0.6"
"10053","Z40069",3534,377,83,294," 8.3"
"10054","Z40070",194,55,0,55,"28.4"
"10055","Z40071",5462,168,9,159," 2.9"
"10056","Z40076",1040,72,12,60," 5.8"
"10057","Z40077",230,72,37,35,"15.2"
"10058","Z40078",1076,129,37,92," 8.6"
"10059","Z40104",646,142,100,42," 6.5"
"10060","Z40108",4998,669,53,616,"12.3"
"10061","Z40109",743,45,0,45," 6.1"
"10062","Z40111",718,114,39,75,"10.4"
"10063","Z40115",307,78,43,35,"11.4"
"10064","Z40117",1010,129,0,129,"12.8"
"10065","Z40118",3682,263,7,256," 7.0"
"10066","Z40119",1707,991,846,145," 8.5"
"10067","Z40121",2649,422,6,416,"15.7"
"10068","Z40142",1103,167,23,144,"13.1"
"10069","Z40143",2906,689,401,288," 9.9"
"10070","Z40144",987,350,238,112,"11.3"
"10071","Z40146",1704,166,37,129," 7.6"
"10072","Z40150",1622,178,46,132," 8.1"
"10073","Z40152",733,496,389,107,"14.6"
"10074","Z40155",548,102,12,90,"16.4"
"10075","Z40160",10555,1402,108,1294,"12.3"
"10076","Z40162",2457,226,0,226," 9.2"
"10077","Z40165",13231,923,80,843," 6.4"
"10078","Z40175",5766,390,60,330," 5.7"
"10079","Z40177",734,173,41,132,"18.0"
"10080","Z40202",3420,779,109,670,"19.6"
"10081","Z40203",10719,1733,7,1726,"16.1"
"10082","Z40204",8213,1074,73,1001,"12.2"
"10083","Z40205",11226,697,85,612," 5.5"
"10084","Z40206",10492,863,35,828," 7.9"
"10085","Z40207",14714,950,124,826," 5.6"
"10086","Z40208",7093,1354,29,1325,"18.7"
"10087","Z40210",7337,1469,22,1447,"19.7"
"10088","Z40211",11435,2379,13,2366,"20.7"
"10089","Z40212",8608,1770,17,1753,"20.4"
"10090","Z40213",7724,841,91,750," 9.7"
"10091","Z40214",20761,2810,62,2748,"13.2"
"10092","Z40215",9780,1639,0,1639,"16.8"
"10093","Z40216",18353,1465,7,1458," 7.9"
"10094","Z40217",6362,420,5,415," 6.5"
"10095","Z40218",15203,1557,0,1557,"10.2"
"10096","Z40219",17055,1278,50,1228," 7.2"
"10097","Z40220",15182,978,85,893," 5.9"
"10098","Z40222",10207,558,39,519," 5.1"
"10099","Z40223",9647,767,67,700," 7.3"
"10100","Z40228",6489,310,2,308," 4.7"
"10101","Z40229",15007,1240,66,1174," 7.8"
"10102","Z40241",13278,982,105,877," 6.6"
"10103","Z40242",4774,218,1,217," 4.5"
"10104","Z40243",4834,372,12,360," 7.4"
"10105","Z40245",11826,324,43,281," 2.4"
"10106","Z40258",10938,610,13,597," 5.5"
"10107","Z40272",15569,1493,68,1425," 9.2"
"10108","Z40291",15175,1058,38,1020," 6.7"
"10109","Z40299",15801,944,32,912," 5.8"
"10110","Z40311",3329,427,59,368,"11.1"
"10111","Z40312",2565,236,52,184," 7.2"
"10112","Z40313",1575,190,29,161,"10.2"
"10113","Z40324",17703,1475,54,1421," 8.0"
"10114","Z40330",8888,1073,355,718," 8.1"
"10115","Z40336",6142,979,180,799,"13.0"
"10116","Z40337",2316,302,50,252,"10.9"
"10117","Z40342",9066,769,31,738," 8.1"
"10118","Z40347",1187,126,3,123,"10.4"
"10119","Z40351",8590,1411,261,1150,"13.4"
"10120","Z40353",9291,1137,102,1035,"11.1"
"10121","Z40356",16924,1149,145,1004," 5.9"
"10122","Z40358",331,92,13,79,"23.9"
"10123","Z40359",3468,844,493,351,"10.1"
"10124","Z40360",3028,627,155,472,"15.6"
"10125","Z40361",8087,925,66,859,"10.6"
"10126","Z40370",1171,245,45,200,"17.1"
"10127","Z40371",1480,316,149,167,"11.3"
"10128","Z40372",1037,98,8,90," 8.7"
"10129","Z40374",806,130,9,121,"15.0"
"10130","Z40379",1399,88,19,69," 4.9"
"10131","Z40380",2968,593,66,527,"17.8"
"10132","Z40383",9575,914,80,834," 8.7"
"10133","Z40390",2640,238,14,224," 8.5"
"10134","Z40391",15580,1525,47,1478," 9.5"
"10135","Z40402",1198,156,18,138,"11.5"
"10136","Z40403",10363,1134,84,1050,"10.1"
"10137","Z40409",1815,224,30,194,"10.7"
"10138","Z40419",1939,101,2,99," 5.1"
"10139","Z40422",10418,1136,116,1020," 9.8"
"10140","Z40437",2261,173,34,139," 6.1"
"10141","Z40440",907,98,5,93,"10.3"
"10142","Z40444",6217,756,182,574," 9.2"
"10143","Z40447",4126,679,128,551,"13.4"
"10144","Z40456",4243,552,0,552,"13.0"
"10145","Z40461",1595,277,43,234,"14.7"
"10146","Z40468",874,54,0,54," 6.2"
"10147","Z40472",759,131,51,80,"10.5"
"10148","Z40475",24222,2327,106,2221," 9.2"
"10149","Z40481",119,21,0,21,"17.6"
"10150","Z40484",4975,466,15,451," 9.1"
"10151","Z40486",1043,124,0,124,"11.9"
"10152","Z40489",1719,289,0,289,"16.8"
"10153","Z40502",13715,1339,127,1212," 8.8"
"10154","Z40503",13181,846,82,764," 5.8"
"10155","Z40504",12245,1223,71,1152," 9.4"
"10156","Z40505",12454,1332,18,1314,"10.6"
"10157","Z40507",1404,223,63,160,"11.4"
"10158","Z40508",11113,1337,8,1329,"12.0"
"10159","Z40509",16125,1566,148,1418," 8.8"
"10160","Z40510",373,21,0,21," 5.6"
"10161","Z40511",13163,1128,115,1013," 7.7"
"10162","Z40513",4425,184,13,171," 3.9"
"10163","Z40514",6010,251,59,192," 3.2"
"10164","Z40515",15104,1027,136,891," 5.9"
"10165","Z40516",1326,169,0,169,"12.7"
"10166","Z40517",17815,1647,106,1541," 8.7"
"10167","Z40601",23589,2310,198,2112," 9.0"
"10168","Z40701",13472,1456,155,1301," 9.7"
"10169","Z40729",2428,280,37,243,"10.0"
"10170","Z40734",1599,313,31,282,"17.6"
"10171","Z40740",1179,83,22,61," 5.2"
"10172","Z40741",9779,953,131,822," 8.4"
"10173","Z40743",133,35,35,0," 0.0"
"10174","Z40744",7572,596,55,541," 7.1"
"10175","Z40769",7202,1029,76,953,"13.2"
"10176","Z40806",1091,134,27,107," 9.8"
"10177","Z40810",713,127,0,127,"17.8"
"10178","Z40815",642,76,15,61," 9.5"
"10179","Z40823",2138,345,32,313,"14.6"
"10180","Z40828",1531,213,31,182,"11.9"
"10181","Z40831",2515,274,62,212," 8.4"
"10182","Z40854",558,114,29,85,"15.2"
"10183","Z40873",971,165,33,132,"13.6"
"10184","Z40906",5299,744,55,689,"13.0"
"10185","Z40913",125,33,0,33,"26.4"
"10186","Z40914",149,45,0,45,"30.2"
"10187","Z40915",365,23,6,17," 4.7"
"10188","Z40935",1180,137,0,137,"11.6"
"10189","Z40940",326,86,0,86,"26.4"
"10190","Z40949",394,109,22,87,"22.1"
"10191","Z40962",7682,979,100,879,"11.4"
"10192","Z40965",6390,778,211,567," 8.9"
"10193","Z40972",588,100,22,78,"13.3"
"10194","Z40977",4314,804,105,699,"16.2"
"10195","Z40988",248,54,13,41,"16.5"
"10196","Z41001",6274,352,0,352," 5.6"
"10197","Z41002",1078,163,18,145,"13.5"
"10198","Z41003",1129,205,21,184,"16.3"
"10199","Z41004",1913,249,72,177," 9.3"
"10200","Z41005",8576,401,46,355," 4.1"
"10201","Z41006",1806,197,39,158," 8.7"
"10202","Z41007",1525,110,14,96," 6.3"
"10203","Z41008",3118,368,45,323,"10.4"
"10204","Z41010",1633,352,125,227,"13.9"
"10205","Z41011",13400,2260,176,2084,"15.6"
"10206","Z41014",3633,547,11,536,"14.8"
"10207","Z41015",9187,983,112,871," 9.5"
"10208","Z41016",2901,458,31,427,"14.7"
"10209","Z41017",15975,940,8,932," 5.8"
"10210","Z41018",11376,1029,58,971," 8.5"
"10211","Z41030",2349,210,72,138," 5.9"
"10212","Z41031",6963,867,94,773,"11.1"
"10213","Z41033",858,153,0,153,"17.8"
"10214","Z41035",4323,649,160,489,"11.3"
"10215","Z41039",1254,146,14,132,"10.5"
"10216","Z41040",3264,465,156,309," 9.5"
"10217","Z41041",3274,431,56,375,"11.5"
"10218","Z41042",21753,1428,114,1314," 6.0"
"10219","Z41043",773,94,56,38," 4.9"
"10220","Z41044",419,103,33,70,"16.7"
"10221","Z41045",701,187,50,137,"19.5"
"10222","Z41046",539,109,0,109,"20.2"
"10223","Z41048",4928,83,0,83," 1.7"
"10224","Z41049",1106,243,108,135,"12.2"
"10225","Z41051",10015,508,0,508," 5.1"
"10226","Z41056",6698,1138,180,958,"14.3"
"10227","Z41063",1348,204,47,157,"11.6"
"10228","Z41064",979,157,6,151,"15.4"
"10229","Z41071",10102,1614,103,1511,"15.0"
"10230","Z41073",3061,420,0,420,"13.7"
"10231","Z41074",2540,441,16,425,"16.7"
"10232","Z41075",7247,686,47,639," 8.8"
"10233","Z41076",7673,509,37,472," 6.2"
"10234","Z41080",798,190,75,115,"14.4"
"10235","Z41083",574,103,30,73,"12.7"
"10236","Z41085",290,28,0,28," 9.7"
"10237","Z41086",1361,152,21,131," 9.6"
"10238","Z41091",6167,344,29,315," 5.1"
"10239","Z41092",1263,105,6,99," 7.8"
"10240","Z41093",1219,205,117,88," 7.2"
"10241","Z41094",5477,476,29,447," 8.2"
"10242","Z41095",1641,372,114,258,"15.7"
"10243","Z41097",2954,660,305,355,"12.0"
"10244","Z41101",8986,1105,48,1057,"11.8"
"10245","Z41102",8912,925,36,889,"10.0"
"10246","Z41121",793,164,27,137,"17.3"
"10247","Z41124",553,78,2,76,"13.7"
"10248","Z41129",4347,311,0,311," 7.2"
"10249","Z41139",3680,361,24,337," 9.2"
"10250","Z41141",1017,231,100,131,"12.9"
"10251","Z41143",6235,648,110,538," 8.6"
"10252","Z41144",4428,629,147,482,"10.9"
"10253","Z41164",6167,1099,133,966,"15.7"
"10254","Z41166",447,49,0,49,"11.0"
"10255","Z41169",2568,274,23,251," 9.8"
"10256","Z41171",1919,425,116,309,"16.1"
"10257","Z41174",629,228,74,154,"24.5"
"10258","Z41175",2509,377,11,366,"14.6"
"10259","Z41179",3627,571,244,327," 9.0"
"10260","Z41180",562,120,72,48," 8.5"
"10261","Z41183",611,51,3,48," 7.9"
"10262","Z41189",1059,125,29,96," 9.1"
"10263","Z41216",500,94,0,94,"18.8"
"10264","Z41219",838,101,18,83," 9.9"
"10265","Z41224",2243,366,20,346,"15.4"
"10266","Z41230",5270,828,151,677,"12.8"
"10267","Z41231",541,89,7,82,"15.2"
"10268","Z41232",372,53,13,40,"10.8"
"10269","Z41240",3594,632,50,582,"16.2"
"10270","Z41255",489,73,0,73,"14.9"
"10271","Z41260",360,27,27,0," 0.0"
"10272","Z41267",411,95,14,81,"19.7"
"10273","Z41301",2923,526,186,340,"11.6"
"10274","Z41311",3318,577,66,511,"15.4"
"10275","Z41314",2424,535,41,494,"20.4"
"10276","Z41332",635,167,58,109,"17.2"
"10277","Z41339",5040,562,29,533,"10.6"
"10278","Z41348",511,14,0,14," 2.7"
"10279","Z41352",365,33,8,25," 6.8"
"10280","Z41425",637,149,36,113,"17.7"
"10281","Z41465",5367,847,226,621,"11.6"
"10282","Z41472",4345,675,253,422," 9.7"
"10283","Z41501",10848,1213,138,1075," 9.9"
"10284","Z41503",324,85,0,85,"26.2"
"10285","Z41512",408,77,14,63,"15.4"
"10286","Z41514",1523,211,44,167,"11.0"
"10287","Z41522",2616,522,56,466,"17.8"
"10288","Z41524",164,53,0,53,"32.3"
"10289","Z41537",2625,537,40,497,"18.9"
"10290","Z41539",757,86,0,86,"11.4"
"10291","Z41544",432,42,0,42," 9.7"
"10292","Z41548",385,54,8,46,"11.9"
"10293","Z41553",1248,143,68,75," 6.0"
"10294","Z41572",1778,270,25,245,"13.8"
"10295","Z41601",491,80,12,68,"13.8"
"10296","Z41603",494,64,0,64,"13.0"
"10297","Z41630",639,121,33,88,"13.8"
"10298","Z41635",1474,189,0,189,"12.8"
"10299","Z41645",583,55,39,16," 2.7"
"10300","Z41647",708,127,0,127,"17.9"
"10301","Z41649",1342,263,16,247,"18.4"
"10302","Z41653",5289,551,66,485," 9.2"
"10303","Z41659",246,103,0,103,"41.9"
"10304","Z41666",466,129,9,120,"25.8"
"10305","Z41701",7804,906,52,854,"10.9"
"10306","Z41719",482,73,0,73,"15.1"
"10307","Z41722",696,83,0,83,"11.9"
"10308","Z41723",584,82,0,82,"14.0"
"10309","Z41731",489,46,0,46," 9.4"
"10310","Z41740",367,32,12,20," 5.4"
"10311","Z41746",296,27,0,27," 9.1"
"10312","Z41749",1712,412,52,360,"21.0"
"10313","Z41804",438,109,4,105,"24.0"
"10314","Z41815",397,49,0,49,"12.3"
"10315","Z41822",1087,272,57,215,"19.8"
"10316","Z41824",485,40,31,9," 1.9"
"10317","Z41826",562,103,0,103,"18.3"
"10318","Z41828",397,97,0,97,"24.4"
"10319","Z41831",474,28,0,28," 5.9"
"10320","Z41834",341,33,0,33," 9.7"
"10321","Z41837",446,124,14,110,"24.7"
"10322","Z41839",712,169,58,111,"15.6"
"10323","Z41840",535,85,24,61,"11.4"
"10324","Z41844",546,83,4,79,"14.5"
"10325","Z41858",3824,562,189,373," 9.8"
"10326","Z42001",14105,1742,89,1653,"11.7"
"10327","Z42003",13629,1757,104,1653,"12.1"
"10328","Z42020",1128,202,0,202,"17.9"
"10329","Z42021",812,145,20,125,"15.4"
"10330","Z42023",1236,220,39,181,"14.6"
"10331","Z42024",730,105,29,76,"10.4"
"10332","Z42025",9757,1809,660,1149,"11.8"
"10333","Z42027",1117,174,0,174,"15.6"
"10334","Z42029",2581,261,16,245," 9.5"
"10335","Z42031",1472,236,42,194,"13.2"
"10336","Z42035",352,44,0,44,"12.5"
"10337","Z42038",2747,716,485,231," 8.4"
"10338","Z42039",807,83,10,73," 9.0"
"10339","Z42040",556,94,25,69,"12.4"
"10340","Z42041",2549,484,10,474,"18.6"
"10341","Z42045",1352,420,179,241,"17.8"
"10342","Z42048",1397,504,240,264,"18.9"
"10343","Z42049",795,79,4,75," 9.4"
"10344","Z42050",1536,346,20,326,"21.2"
"10345","Z42053",2329,341,41,300,"12.9"
"10346","Z42055",1819,745,519,226,"12.4"
"10347","Z42056",966,94,49,45," 4.7"
"10348","Z42058",992,116,0,116,"11.7"
"10349","Z42064",4090,706,186,520,"12.7"
"10350","Z42066",10624,1453,60,1393,"13.1"
"10351","Z42069",312,44,0,44,"14.1"
"10352","Z42071",14303,2659,674,1985,"13.9"
"10353","Z42076",862,336,274,62," 7.2"
"10354","Z42078",913,151,14,137,"15.0"
"10355","Z42079",619,116,0,116,"18.7"
"10356","Z42081",1013,148,39,109,"10.8"
"10357","Z42085",410,108,40,68,"16.6"
"10358","Z42086",1819,155,0,155," 8.5"
"10359","Z42088",1108,172,0,172,"15.5"
"10360","Z42101",22745,1795,173,1622," 7.1"
"10361","Z42103",8705,678,118,560," 6.4"
"10362","Z42104",13663,1006,93,913," 6.7"
"10363","Z42120",1183,135,72,63," 5.3"
"10364","Z42122",1684,123,0,123," 7.3"
"10365","Z42123",494,151,81,70,"14.2"
"10366","Z42127",2907,368,109,259," 8.9"
"10367","Z42129",3389,634,96,538,"15.9"
"10368","Z42134",7279,722,42,680," 9.3"
"10369","Z42140",521,89,0,89,"17.1"
"10370","Z42141",14096,1666,415,1251," 8.9"
"10371","Z42154",315,12,0,12," 3.8"
"10372","Z42156",77,10,10,0," 0.0"
"10373","Z42160",556,58,0,58,"10.4"
"10374","Z42164",7680,1333,487,846,"11.0"
"10375","Z42166",1118,155,0,155,"13.9"
"10376","Z42167",3899,557,60,497,"12.7"
"10377","Z42170",549,57,0,57,"10.4"
"10378","Z42171",3183,256,8,248," 7.8"
"10379","Z42202",1105,178,2,176,"15.9"
"10380","Z42206",2224,143,0,143," 6.4"
"10381","Z42210",1933,321,44,277,"14.3"
"10382","Z42211",7306,1709,1050,659," 9.0"
"10383","Z42217",1519,165,52,113," 7.4"
"10384","Z42220",2933,420,36,384,"13.1"
"10385","Z42223",4701,362,0,362," 7.7"
"10386","Z42232",345,123,0,123,"35.7"
"10387","Z42234",1106,104,43,61," 5.5"
"10388","Z42236",259,6,0,6," 2.3"
"10389","Z42240",19339,2486,111,2375,"12.3"
"10390","Z42256",2498,709,317,392,"15.7"
"10391","Z42259",824,456,430,26," 3.2"
"10392","Z42261",4880,558,140,418," 8.6"
"10393","Z42262",3960,921,87,834,"21.1"
"10394","Z42265",461,28,0,28," 6.1"
"10395","Z42266",874,111,17,94,"10.8"
"10396","Z42274",1124,74,0,74," 6.6"
"10397","Z42276",6608,494,26,468," 7.1"
"10398","Z42285",162,15,0,15," 9.3"
"10399","Z42286",514,72,6,66,"12.8"
"10400","Z42301",19391,1758,171,1587," 8.2"
"10401","Z42303",16849,1481,152,1329," 7.9"
"10402","Z42320",3462,523,160,363,"10.5"
"10403","Z42323",360,45,0,45,"12.5"
"10404","Z42325",918,59,4,55," 6.0"
"10405","Z42327",1704,197,58,139," 8.2"
"10406","Z42330",4036,746,48,698,"17.3"
"10407","Z42339",360,68,16,52,"14.4"
"10408","Z42343",934,228,114,114,"12.2"
"10409","Z42344",521,91,0,91,"17.5"
"10410","Z42345",4889,670,19,651,"13.3"
"10411","Z42347",2682,344,12,332,"12.4"
"10412","Z42348",2209,208,35,173," 7.8"
"10413","Z42349",598,117,33,84,"14.0"
"10414","Z42350",611,62,7,55," 9.0"
"10415","Z42351",1623,192,42,150," 9.2"
"10416","Z42352",893,61,0,61," 6.8"
"10417","Z42355",788,38,0,38," 4.8"
"10418","Z42361",261,45,21,24," 9.2"
"10419","Z42366",2240,218,51,167," 7.5"
"10420","Z42367",300,33,2,31,"10.3"
"10421","Z42371",258,51,0,51,"19.8"
"10422","Z42372",822,128,0,128,"15.6"
"10423","Z42376",2453,187,0,187," 7.6"
"10424","Z42378",1065,37,0,37," 3.5"
"10425","Z42404",1206,130,0,130,"10.8"
"10426","Z42406",1462,201,89,112," 7.7"
"10427","Z42408",3141,524,107,417,"13.3"
"10428","Z42409",1036,97,7,90," 8.7"
"10429","Z42410",770,170,0,170,"22.1"
"10430","Z42411",852,198,29,169,"19.8"
"10431","Z42420",17160,1360,161,1199," 7.0"
"10432","Z42431",12431,1540,152,1388,"11.2"
"10433","Z42436",454,36,0,36," 7.9"
"10434","Z42437",3380,276,0,276," 8.2"
"10435","Z42440",381,32,0,32," 8.4"
"10436","Z42442",1417,224,21,203,"14.3"
"10437","Z42445",5310,788,92,696,"13.1"
"10438","Z42450",2005,401,41,360,"18.0"
"10439","Z42452",886,25,10,15," 1.7"
"10440","Z42455",1261,129,36,93," 7.4"
"10441","Z42456",615,52,0,52," 8.5"
"10442","Z42458",389,13,0,13," 3.3"
"10443","Z42459",1891,226,14,212,"11.2"
"10444","Z42464",857,118,27,91,"10.6"
"10445","Z42501",8650,1371,269,1102,"12.7"
"10446","Z42503",10438,1037,210,827," 7.9"
"10447","Z42519",2604,1404,977,427,"16.4"
"10448","Z42528",647,86,0,86,"13.3"
"10449","Z42539",4675,650,122,528,"11.3"
"10450","Z42544",4060,1614,1380,234," 5.8"
"10451","Z42553",2244,320,79,241,"10.7"
"10452","Z42565",327,104,24,80,"24.5"
"10453","Z42566",265,16,16,0," 0.0"
"10454","Z42567",2640,246,50,196," 7.4"
"10455","Z42602",5524,1689,814,875,"15.8"
"10456","Z42629",3068,987,714,273," 8.9"
"10457","Z42633",9874,2291,1081,1210,"12.3"
"10458","Z42635",1441,160,48,112," 7.8"
"10459","Z42642",6267,1300,591,709,"11.3"
"10460","Z42647",1850,331,91,240,"13.0"
"10461","Z42649",1298,133,0,133,"10.2"
"10462","Z42653",1999,398,151,247,"12.4"
"10463","Z42701",21628,1929,72,1857," 8.6"
"10464","Z42713",779,142,29,113,"14.5"
"10465","Z42716",807,182,68,114,"14.1"
"10466","Z42717",3613,900,418,482,"13.3"
"10467","Z42718",10676,1159,146,1013," 9.5"
"10468","Z42721",1737,424,149,275,"15.8"
"10469","Z42724",1830,245,39,206,"11.3"
"10470","Z42726",3417,1448,1205,243," 7.1"
"10471","Z42728",7317,1237,485,752,"10.3"
"10472","Z42729",1400,797,681,116," 8.3"
"10473","Z42732",894,141,20,121,"13.5"
"10474","Z42740",884,164,36,128,"14.5"
"10475","Z42743",4370,665,134,531,"12.2"
"10476","Z42746",866,68,11,57," 6.6"
"10477","Z42748",3787,520,7,513,"13.5"
"10478","Z42749",2150,177,0,177," 8.2"
"10479","Z42754",7458,1461,797,664," 8.9"
"10480","Z42757",1224,171,43,128,"10.5"
"10481","Z42762",210,71,0,71,"33.8"
"10482","Z42765",2918,432,128,304,"10.4"
"10483","Z42776",1164,142,0,142,"12.2"
"10484","Z42784",1185,221,35,186,"15.7"
"10485","Z43001",1086,51,0,51," 4.7"
"10486","Z43002",1659,92,0,92," 5.5"
"10487","Z43003",1071,141,0,141,"13.2"
"10488","Z43004",9314,240,17,223," 2.4"
"10489","Z43006",300,77,8,69,"23.0"
"10490","Z43008",1364,322,167,155,"11.4"
"10491","Z43009",747,34,0,34," 4.6"
"10492","Z43011",2852,201,11,190," 6.7"
"10493","Z43013",478,9,0,9," 1.9"
"10494","Z43014",1460,165,45,120," 8.2"
"10495","Z43015",20326,1088,25,1063," 5.2"
"10496","Z43016",14399,421,149,272," 1.9"
"10497","Z43017",14865,610,131,479," 3.2"
"10498","Z43019",3485,127,32,95," 2.7"
"10499","Z43021",3763,120,10,110," 2.9"
"10500","Z43023",4157,160,44,116," 2.8"
"10501","Z43025",2681,356,166,190," 7.1"
"10502","Z43026",22715,723,30,693," 3.1"
"10503","Z43028",3974,895,476,419,"10.5"
"10504","Z43029",195,34,0,34,"17.4"
"10505","Z43031",5379,624,0,624,"11.6"
"10506","Z43035",9028,333,54,279," 3.1"
"10507","Z43037",183,10,0,10," 5.5"
"10508","Z43040",11819,686,39,647," 5.5"
"10509","Z43044",2121,162,7,155," 7.3"
"10510","Z43045",738,105,4,101,"13.7"
"10511","Z43046",1847,365,178,187,"10.1"
"10512","Z43050",12291,982,70,912," 7.4"
"10513","Z43054",8871,404,17,387," 4.4"
"10514","Z43055",26803,2138,160,1978," 7.4"
"10515","Z43056",7354,439,9,430," 5.8"
"10516","Z43060",1034,73,4,69," 6.7"
"10517","Z43061",1535,46,20,26," 1.7"
"10518","Z43062",10886,743,0,743," 6.8"
"10519","Z43064",5147,226,0,226," 4.4"
"10520","Z43065",14738,625,31,594," 4.0"
"10521","Z43068",22356,1150,8,1142," 5.1"
"10522","Z43071",953,148,0,148,"15.5"
"10523","Z43072",2259,167,37,130," 5.8"
"10524","Z43074",4495,242,0,242," 5.4"
"10525","Z43076",4189,566,134,432,"10.3"
"10526","Z43078",9274,867,8,859," 9.3"
"10527","Z43080",2104,238,0,238,"11.3"
"10528","Z43081",24515,1320,213,1107," 4.5"
"10529","Z43082",11607,291,51,240," 2.1"
"10530","Z43085",10504,293,10,283," 2.7"
"10531","Z43101",162,21,0,21,"13.0"
"10532","Z43102",1811,147,37,110," 6.1"
"10533","Z43103",4294,280,12,268," 6.2"
"10534","Z43105",3045,123,0,123," 4.0"
"10535","Z43106",709,69,17,52," 7.3"
"10536","Z43107",1271,106,0,106," 8.3"
"10537","Z43110",14378,1125,0,1125," 7.8"
"10538","Z43112",1629,143,13,130," 8.0"
"10539","Z43113",9806,826,14,812," 8.3"
"10540","Z43116",493,27,0,27," 5.5"
"10541","Z43119",10416,473,34,439," 4.2"
"10542","Z43123",25373,2329,43,2286," 9.0"
"10543","Z43125",5947,544,0,544," 9.1"
"10544","Z43126",181,22,2,20,"11.0"
"10545","Z43128",972,99,0,99,"10.2"
"10546","Z43130",25292,1917,99,1818," 7.2"
"10547","Z43135",1938,209,96,113," 5.8"
"10548","Z43136",219,24,0,24,"11.0"
"10549","Z43137",844,207,0,207,"24.5"
"10550","Z43138",8457,977,231,746," 8.8"
"10551","Z43140",8299,654,47,607," 7.3"
"10552","Z43143",2375,162,0,162," 6.8"
"10553","Z43145",691,84,1,83,"12.0"
"10554","Z43146",3455,212,0,212," 6.1"
"10555","Z43147",14351,687,41,646," 4.5"
"10556","Z43148",852,57,8,49," 5.8"
"10557","Z43149",1356,289,136,153,"11.3"
"10558","Z43151",82,14,2,12,"14.6"
"10559","Z43153",405,64,0,64,"15.8"
"10560","Z43154",1267,128,0,128,"10.1"
"10561","Z43155",1287,296,152,144,"11.2"
"10562","Z43160",10016,873,130,743," 7.4"
"10563","Z43162",2679,84,0,84," 3.1"
"10564","Z43164",806,76,0,76," 9.4"
"10565","Z43201",15115,3607,162,3445,"22.8"
"10566","Z43202",10551,844,50,794," 7.5"
"10567","Z43203",4912,1483,22,1461,"29.7"
"10568","Z43204",19255,3695,45,3650,"19.0"
"10569","Z43205",7271,2066,39,2027,"27.9"
"10570","Z43206",12275,2492,216,2276,"18.5"
"10571","Z43207",20172,2987,87,2900,"14.4"
"10572","Z43209",12594,1028,84,944," 7.5"
"10573","Z43211",10527,2448,4,2444,"23.2"
"10574","Z43212",11156,1463,36,1427,"12.8"
"10575","Z43213",15665,1749,56,1693,"10.8"
"10576","Z43214",13162,839,50,789," 6.0"
"10577","Z43215",9281,1111,133,978,"10.5"
"10578","Z43217",864,97,15,82," 9.5"
"10579","Z43219",12401,1534,76,1458,"11.8"
"10580","Z43220",12754,897,64,833," 6.5"
"10581","Z43221",13903,753,120,633," 4.6"
"10582","Z43222",1838,531,0,531,"28.9"
"10583","Z43223",11017,2493,53,2440,"22.1"
"10584","Z43224",18876,2602,49,2553,"13.5"
"10585","Z43227",10291,1450,58,1392,"13.5"
"10586","Z43228",23752,2524,20,2504,"10.5"
"10587","Z43229",22243,2232,83,2149," 9.7"
"10588","Z43230",22879,759,46,713," 3.1"
"10589","Z43231",8627,815,57,758," 8.8"
"10590","Z43232",20267,2837,52,2785,"13.7"
"10591","Z43235",18929,988,75,913," 4.8"
"10592","Z43240",1994,168,12,156," 7.8"
"10593","Z43302",22811,2765,78,2687,"11.8"
"10594","Z43310",1495,198,110,88," 5.9"
"10595","Z43311",8410,689,55,634," 7.5"
"10596","Z43314",1399,271,0,271,"19.4"
"10597","Z43315",2700,183,33,150," 5.6"
"10598","Z43316",2558,142,26,116," 4.5"
"10599","Z43317",49,5,5,0," 0.0"
"10600","Z43318",1897,139,28,111," 5.9"
"10601","Z43320",719,24,0,24," 3.3"
"10602","Z43322",166,9,0,9," 5.4"
"10603","Z43324",2257,1075,831,244,"10.8"
"10604","Z43326",5771,610,5,605,"10.5"
"10605","Z43331",3596,1349,914,435,"12.1"
"10606","Z43332",818,103,25,78," 9.5"
"10607","Z43334",2570,236,0,236," 9.2"
"10608","Z43338",4405,615,201,414," 9.4"
"10609","Z43340",649,61,0,61," 9.4"
"10610","Z43341",484,12,0,12," 2.5"
"10611","Z43342",1340,124,0,124," 9.3"
"10612","Z43343",536,72,6,66,"12.3"
"10613","Z43344",2381,265,23,242,"10.2"
"10614","Z43348",1493,735,566,169,"11.3"
"10615","Z43351",4799,221,9,212," 4.4"
"10616","Z43356",482,33,0,33," 6.8"
"10617","Z43357",1717,128,36,92," 5.4"
"10618","Z43358",1085,60,0,60," 5.5"
"10619","Z43359",297,11,0,11," 3.7"
"10620","Z43360",758,85,78,7," 0.9"
"10621","Z43402",14954,1442,48,1394," 9.3"
"10622","Z43406",771,73,2,71," 9.2"
"10623","Z43410",4461,403,25,378," 8.5"
"10624","Z43412",1962,67,50,17," 0.9"
"10625","Z43413",614,52,0,52," 8.5"
"10626","Z43416",1208,133,64,69," 5.7"
"10627","Z43420",13794,1259,147,1112," 8.1"
"10628","Z43430",1990,106,0,106," 5.3"
"10629","Z43431",1784,174,46,128," 7.2"
"10630","Z43435",512,12,8,4," 0.8"
"10631","Z43440",6460,4057,3775,282," 4.4"
"10632","Z43442",493,38,10,28," 5.7"
"10633","Z43443",740,6,0,6," 0.8"
"10634","Z43445",507,65,0,65,"12.8"
"10635","Z43447",1433,11,0,11," 0.8"
"10636","Z43449",4196,910,598,312," 7.4"
"10637","Z43450",1429,88,0,88," 6.2"
"10638","Z43451",430,59,0,59,"13.7"
"10639","Z43452",10297,4159,3426,733," 7.1"
"10640","Z43457",538,36,3,33," 6.1"
"10641","Z43460",3001,184,0,184," 6.1"
"10642","Z43464",647,235,121,114,"17.6"
"10643","Z43465",2449,83,0,83," 3.4"
"10644","Z43466",974,83,3,80," 8.2"
"10645","Z43469",1275,134,0,134,"10.5"
"10646","Z43502",2626,219,7,212," 8.1"
"10647","Z43504",536,36,0,36," 6.7"
"10648","Z43506",7001,689,36,653," 9.3"
"10649","Z43511",436,36,0,36," 8.3"
"10650","Z43512",12529,1260,66,1194," 9.5"
"10651","Z43515",3439,226,8,218," 6.3"
"10652","Z43516",1186,140,0,140,"11.8"
"10653","Z43517",1514,29,6,23," 1.5"
"10654","Z43518",1104,57,0,57," 5.2"
"10655","Z43521",1310,105,23,82," 6.3"
"10656","Z43522",1280,138,8,130,"10.2"
"10657","Z43525",467,30,0,30," 6.4"
"10658","Z43526",2439,205,0,205," 8.4"
"10659","Z43527",965,154,0,154,"16.0"
"10660","Z43528",6525,241,16,225," 3.4"
"10661","Z43532",1627,128,0,128," 7.9"
"10662","Z43533",657,20,0,20," 3.0"
"10663","Z43534",726,101,0,101,"13.9"
"10664","Z43535",338,12,0,12," 3.6"
"10665","Z43537",11532,581,124,457," 4.0"
"10666","Z43540",679,41,2,39," 5.7"
"10667","Z43542",1421,138,0,138," 9.7"
"10668","Z43543",3528,343,146,197," 5.6"
"10669","Z43545",6107,312,23,289," 4.7"
"10670","Z43547",182,49,0,49,"26.9"
"10671","Z43549",505,8,0,8," 1.6"
"10672","Z43551",15775,727,26,701," 4.4"
"10673","Z43554",1143,41,0,41," 3.6"
"10674","Z43556",754,29,0,29," 3.8"
"10675","Z43557",1022,115,15,100," 9.8"
"10676","Z43558",5293,282,15,267," 5.0"
"10677","Z43560",12468,537,139,398," 3.2"
"10678","Z43566",3106,196,43,153," 4.9"
"10679","Z43567",5316,400,22,378," 7.1"
"10680","Z43569",1318,134,0,134,"10.2"
"10681","Z43570",1366,88,5,83," 6.1"
"10682","Z43571",2711,138,16,122," 4.5"
"10683","Z43604",5354,1072,0,1072,"20.0"
"10684","Z43605",12479,2359,6,2353,"18.9"
"10685","Z43606",11677,1718,12,1706,"14.6"
"10686","Z43607",12222,2627,28,2599,"21.3"
"10687","Z43608",7244,2031,28,2003,"27.7"
"10688","Z43609",11347,2302,17,2285,"20.1"
"10689","Z43610",2523,765,13,752,"29.8"
"10690","Z43611",9007,1152,46,1106,"12.3"
"10691","Z43612",13964,2076,84,1992,"14.3"
"10692","Z43613",15020,1559,8,1551,"10.3"
"10693","Z43614",14743,1006,76,930," 6.3"
"10694","Z43615",19537,1681,55,1626," 8.3"
"10695","Z43616",9065,512,90,422," 4.7"
"10696","Z43617",2922,234,16,218," 7.5"
"10697","Z43619",3385,198,0,198," 5.8"
"10698","Z43620",3358,796,0,796,"23.7"
"10699","Z43623",9836,594,144,450," 4.6"
"10700","Z43701",25192,2312,73,2239," 8.9"
"10701","Z43713",3351,419,99,320," 9.5"
"10702","Z43717",94,25,4,21,"22.3"
"10703","Z43718",1412,124,34,90," 6.4"
"10704","Z43722",175,39,0,39,"22.3"
"10705","Z43723",2080,179,45,134," 6.4"
"10706","Z43724",3215,327,233,94," 2.9"
"10707","Z43725",9549,1464,30,1434,"15.0"
"10708","Z43727",503,51,12,39," 7.8"
"10709","Z43730",1120,223,34,189,"16.9"
"10710","Z43731",2333,138,9,129," 5.5"
"10711","Z43732",881,158,89,69," 7.8"
"10712","Z43734",610,20,0,20," 3.3"
"10713","Z43748",1053,53,0,53," 5.0"
"10714","Z43754",867,173,79,94,"10.8"
"10715","Z43755",713,179,125,54," 7.6"
"10716","Z43756",2767,404,132,272," 9.8"
"10717","Z43758",1786,523,183,340,"19.0"
"10718","Z43759",41,7,0,7,"17.1"
"10719","Z43760",895,111,0,111,"12.4"
"10720","Z43764",3452,310,35,275," 8.0"
"10721","Z43767",590,74,22,52," 8.8"
"10722","Z43771",881,175,52,123,"14.0"
"10723","Z43772",852,160,28,132,"15.5"
"10724","Z43773",1570,391,231,160,"10.2"
"10725","Z43777",1935,247,14,233,"12.0"
"10726","Z43778",607,96,35,61,"10.0"
"10727","Z43782",365,66,10,56,"15.3"
"10728","Z43783",1865,122,13,109," 5.8"
"10729","Z43788",442,126,81,45,"10.2"
"10730","Z43793",2576,331,126,205," 8.0"
"10731","Z43802",397,48,26,22," 5.5"
"10732","Z43804",910,54,0,54," 5.9"
"10733","Z43812",8937,1146,295,851," 9.5"
"10734","Z43821",1915,313,53,260,"13.6"
"10735","Z43822",1905,129,13,116," 6.1"
"10736","Z43824",1349,76,10,66," 4.9"
"10737","Z43830",2638,144,38,106," 4.0"
"10738","Z43832",3321,427,154,273," 8.2"
"10739","Z43837",780,59,38,21," 2.7"
"10740","Z43843",494,57,38,19," 3.8"
"10741","Z43844",1624,240,101,139," 8.6"
"10742","Z43845",2100,218,10,208," 9.9"
"10743","Z43901",1134,135,0,135,"11.9"
"10744","Z43906",4324,776,22,754,"17.4"
"10745","Z43907",2936,514,118,396,"13.5"
"10746","Z43908",696,147,36,111,"15.9"
"10747","Z43910",1407,105,0,105," 7.5"
"10748","Z43912",3316,389,28,361,"10.9"
"10749","Z43913",744,76,0,76,"10.2"
"10750","Z43915",753,160,40,120,"15.9"
"10751","Z43917",1570,273,19,254,"16.2"
"10752","Z43920",10680,1306,72,1234,"11.6"
"10753","Z43930",486,119,7,112,"23.0"
"10754","Z43933",949,142,0,142,"15.0"
"10755","Z43935",4289,511,0,511,"11.9"
"10756","Z43938",2733,448,52,396,"14.5"
"10757","Z43939",256,29,4,25," 9.8"
"10758","Z43940",156,31,0,31,"19.9"
"10759","Z43942",1215,154,10,144,"11.9"
"10760","Z43944",1067,84,4,80," 7.5"
"10761","Z43945",1377,181,30,151,"11.0"
"10762","Z43946",1128,185,32,153,"13.6"
"10763","Z43947",2522,226,26,200," 7.9"
"10764","Z43948",315,68,0,68,"21.6"
"10765","Z43950",6342,556,58,498," 7.9"
"10766","Z43952",9238,1863,85,1778,"19.2"
"10767","Z43953",5361,455,25,430," 8.0"
"10768","Z43963",653,65,0,65,"10.0"
"10769","Z43964",4241,362,41,321," 7.6"
"10770","Z43968",3013,372,0,372,"12.3"
"10771","Z43971",590,68,0,68,"11.5"
"10772","Z43973",1346,487,354,133," 9.9"
"10773","Z43976",817,77,21,56," 6.9"
"10774","Z43983",492,302,249,53,"10.8"
"10775","Z43986",839,93,19,74," 8.8"
"10776","Z43988",1401,468,210,258,"18.4"
"10777","Z44001",8613,489,22,467," 5.4"
"10778","Z44003",2270,527,256,271,"11.9"
"10779","Z44004",16144,2506,507,1999,"12.4"
"10780","Z44010",729,71,0,71," 9.7"
"10781","Z44011",8207,252,0,252," 3.1"
"10782","Z44012",9568,606,16,590," 6.2"
"10783","Z44017",8149,769,19,750," 9.2"
"10784","Z44021",2394,141,26,115," 4.8"
"10785","Z44022",7204,314,46,268," 3.7"
"10786","Z44023",6896,464,39,425," 6.2"
"10787","Z44024",9631,540,47,493," 5.1"
"10788","Z44026",4542,139,0,139," 3.1"
"10789","Z44028",3361,145,9,136," 4.0"
"10790","Z44030",7219,1087,251,836,"11.6"
"10791","Z44032",601,28,0,28," 4.7"
"10792","Z44035",29091,2363,54,2309," 7.9"
"10793","Z44039",12895,665,0,665," 5.2"
"10794","Z44040",1238,72,19,53," 4.3"
"10795","Z44041",7040,1164,444,720,"10.2"
"10796","Z44044",4577,323,0,323," 7.1"
"10797","Z44045",161,17,0,17,"10.6"
"10798","Z44046",701,43,26,17," 2.4"
"10799","Z44047",3801,406,28,378," 9.9"
"10800","Z44048",1037,67,11,56," 5.4"
"10801","Z44049",102,4,0,4," 3.9"
"10802","Z44050",2595,176,3,173," 6.7"
"10803","Z44052",13825,2423,55,2368,"17.1"
"10804","Z44053",8841,1155,120,1035,"11.7"
"10805","Z44054",5491,398,13,385," 7.0"
"10806","Z44055",8762,994,27,967,"11.0"
"10807","Z44056",4532,108,0,108," 2.4"
"10808","Z44057",8143,764,206,558," 6.9"
"10809","Z44060",26706,1387,268,1119," 4.2"
"10810","Z44062",4299,168,31,137," 3.2"
"10811","Z44064",707,59,0,59," 8.3"
"10812","Z44065",1783,87,0,87," 4.9"
"10813","Z44067",8669,391,0,391," 4.5"
"10814","Z44070",14269,987,17,970," 6.8"
"10815","Z44072",1917,85,32,53," 2.8"
"10816","Z44074",4011,257,26,231," 5.8"
"10817","Z44076",1924,164,0,164," 8.5"
"10818","Z44077",23574,1805,223,1582," 6.7"
"10819","Z44081",2686,145,6,139," 5.2"
"10820","Z44082",570,101,0,101,"17.7"
"10821","Z44084",1851,397,172,225,"12.2"
"10822","Z44085",1537,313,112,201,"13.1"
"10823","Z44086",1030,53,0,53," 5.1"
"10824","Z44087",8308,357,69,288," 3.5"
"10825","Z44089",7947,1304,736,568," 7.1"
"10826","Z44090",4384,207,26,181," 4.1"
"10827","Z44093",764,170,46,124,"16.2"
"10828","Z44094",17161,1324,133,1191," 6.9"
"10829","Z44095",15021,875,53,822," 5.5"
"10830","Z44099",725,46,0,46," 6.3"
"10831","Z44102",22870,4632,68,4564,"20.0"
"10832","Z44103",10649,3676,52,3624,"34.0"
"10833","Z44104",12073,2869,37,2832,"23.5"
"10834","Z44105",21131,5585,7,5578,"26.4"
"10835","Z44107",27462,2821,159,2662," 9.7"
"10836","Z44108",15060,5416,84,5332,"35.4"
"10837","Z44109",19809,2810,31,2779,"14.0"
"10838","Z44110",12072,3083,40,3043,"25.2"
"10839","Z44111",19376,2449,131,2318,"12.0"
"10840","Z44112",15328,5251,5,5246,"34.2"
"10841","Z44113",10707,1650,201,1449,"13.5"
"10842","Z44114",4193,737,54,683,"16.3"
"10843","Z44115",3917,515,29,486,"12.4"
"10844","Z44116",9795,796,138,658," 6.7"
"10845","Z44117",5849,984,0,984,"16.8"
"10846","Z44118",18268,2574,108,2466,"13.5"
"10847","Z44119",6430,1133,28,1105,"17.2"
"10848","Z44120",21709,5395,105,5290,"24.4"
"10849","Z44121",15157,1440,38,1402," 9.2"
"10850","Z44122",15012,1459,133,1326," 8.8"
"10851","Z44123",9188,1461,10,1451,"15.8"
"10852","Z44124",18499,1513,120,1393," 7.5"
"10853","Z44125",13371,1697,13,1684,"12.6"
"10854","Z44126",7622,366,9,357," 4.7"
"10855","Z44127",3022,980,0,980,"32.4"
"10856","Z44128",15041,2282,38,2244,"14.9"
"10857","Z44129",12743,1034,21,1013," 7.9"
"10858","Z44130",23073,1308,92,1216," 5.3"
"10859","Z44131",8540,359,28,331," 3.9"
"10860","Z44132",7697,1047,20,1027,"13.3"
"10861","Z44133",13064,379,11,368," 2.8"
"10862","Z44134",17192,1257,77,1180," 6.9"
"10863","Z44135",12996,1004,84,920," 7.1"
"10864","Z44136",10850,595,45,550," 5.1"
"10865","Z44137",11056,1548,0,1548,"14.0"
"10866","Z44138",9504,654,114,540," 5.7"
"10867","Z44139",9205,597,78,519," 5.6"
"10868","Z44140",6313,297,10,287," 4.5"
"10869","Z44141",5757,338,14,324," 5.6"
"10870","Z44143",12039,1082,31,1051," 8.7"
"10871","Z44144",10139,713,0,713," 7.0"
"10872","Z44145",14856,1090,230,860," 5.8"
"10873","Z44146",15415,2183,141,2042,"13.2"
"10874","Z44147",7820,334,91,243," 3.1"
"10875","Z44149",7596,398,12,386," 5.1"
"10876","Z44201",2804,193,0,193," 6.9"
"10877","Z44202",8159,499,137,362," 4.4"
"10878","Z44203",17821,1811,25,1786,"10.0"
"10879","Z44212",17825,778,42,736," 4.1"
"10880","Z44214",747,42,19,23," 3.1"
"10881","Z44216",3995,427,10,417,"10.4"
"10882","Z44217",1658,90,0,90," 5.4"
"10883","Z44221",14431,942,0,942," 6.5"
"10884","Z44223",8220,718,14,704," 8.6"
"10885","Z44224",16684,1031,0,1031," 6.2"
"10886","Z44230",3503,184,0,184," 5.3"
"10887","Z44231",3438,211,27,184," 5.4"
"10888","Z44233",3074,262,42,220," 7.2"
"10889","Z44234",1416,55,0,55," 3.9"
"10890","Z44236",9307,259,135,124," 1.3"
"10891","Z44240",18346,2567,510,2057,"11.2"
"10892","Z44241",7362,681,38,643," 8.7"
"10893","Z44250",477,73,28,45," 9.4"
"10894","Z44253",1200,61,0,61," 5.1"
"10895","Z44254",2074,143,38,105," 5.1"
"10896","Z44255",3275,154,15,139," 4.2"
"10897","Z44256",24821,1499,164,1335," 5.4"
"10898","Z44260",5288,193,0,193," 3.6"
"10899","Z44262",2133,78,18,60," 2.8"
"10900","Z44264",1139,82,0,82," 7.2"
"10901","Z44266",14465,1364,179,1185," 8.2"
"10902","Z44270",3604,306,26,280," 7.8"
"10903","Z44272",2024,200,0,200," 9.9"
"10904","Z44273",2790,89,0,89," 3.2"
"10905","Z44275",1292,146,23,123," 9.5"
"10906","Z44276",729,64,0,64," 8.8"
"10907","Z44278",7306,425,0,425," 5.8"
"10908","Z44280",1849,110,64,46," 2.5"
"10909","Z44281",12499,807,36,771," 6.2"
"10910","Z44286",2443,71,8,63," 2.6"
"10911","Z44287",2903,177,0,177," 6.1"
"10912","Z44288",1682,323,0,323,"19.2"
"10913","Z44301",7125,1076,6,1070,"15.0"
"10914","Z44302",3131,464,0,464,"14.8"
"10915","Z44303",4290,736,0,736,"17.2"
"10916","Z44304",1887,406,0,406,"21.5"
"10917","Z44305",10693,1074,0,1074,"10.0"
"10918","Z44306",10860,1968,10,1958,"18.0"
"10919","Z44307",4009,792,12,780,"19.5"
"10920","Z44308",367,69,0,69,"18.8"
"10921","Z44310",11252,1561,0,1561,"13.9"
"10922","Z44311",3787,668,0,668,"17.6"
"10923","Z44312",15046,1780,53,1727,"11.5"
"10924","Z44313",13595,2008,28,1980,"14.6"
"10925","Z44314",9190,970,0,970,"10.6"
"10926","Z44319",10627,963,98,865," 8.1"
"10927","Z44320",10012,1363,0,1363,"13.6"
"10928","Z44321",6414,472,21,451," 7.0"
"10929","Z44333",8091,632,0,632," 7.8"
"10930","Z44401",1222,87,0,87," 7.1"
"10931","Z44403",1820,121,0,121," 6.6"
"10932","Z44405",4041,589,16,573,"14.2"
"10933","Z44406",9430,744,91,653," 6.9"
"10934","Z44408",4738,226,0,226," 4.8"
"10935","Z44410",7900,386,28,358," 4.5"
"10936","Z44411",944,167,105,62," 6.6"
"10937","Z44412",1021,25,0,25," 2.4"
"10938","Z44413",3342,251,10,241," 7.2"
"10939","Z44417",660,31,0,31," 4.7"
"10940","Z44418",594,38,0,38," 6.4"
"10941","Z44420",7434,730,52,678," 9.1"
"10942","Z44423",1147,237,146,91," 7.9"
"10943","Z44425",6963,436,8,428," 6.1"
"10944","Z44427",692,21,0,21," 3.0"
"10945","Z44428",1305,132,27,105," 8.0"
"10946","Z44429",1426,332,252,80," 5.6"
"10947","Z44430",1615,178,0,178,"11.0"
"10948","Z44431",2032,105,0,105," 5.2"
"10949","Z44432",4946,587,112,475," 9.6"
"10950","Z44436",1622,184,11,173,"10.7"
"10951","Z44437",1791,59,0,59," 3.3"
"10952","Z44438",2116,317,33,284,"13.4"
"10953","Z44440",2087,218,0,218,"10.4"
"10954","Z44441",693,30,0,30," 4.3"
"10955","Z44442",1678,38,3,35," 2.1"
"10956","Z44443",845,88,0,88,"10.4"
"10957","Z44444",4675,325,73,252," 5.4"
"10958","Z44445",1435,138,0,138," 9.6"
"10959","Z44446",9706,860,0,860," 8.9"
"10960","Z44449",828,387,368,19," 2.3"
"10961","Z44451",1365,147,0,147,"10.8"
"10962","Z44452",1325,201,0,201,"15.2"
"10963","Z44455",670,63,0,63," 9.4"
"10964","Z44460",11867,955,134,821," 6.9"
"10965","Z44470",1620,99,0,99," 6.1"
"10966","Z44471",5036,652,33,619,"12.3"
"10967","Z44473",1763,188,0,188,"10.7"
"10968","Z44481",4807,345,37,308," 6.4"
"10969","Z44483",12504,1440,25,1415,"11.3"
"10970","Z44484",10964,1032,76,956," 8.7"
"10971","Z44485",8255,1169,73,1096,"13.3"
"10972","Z44490",391,30,0,30," 7.7"
"10973","Z44491",1037,86,21,65," 6.3"
"10974","Z44502",5139,1044,0,1044,"20.3"
"10975","Z44503",461,60,0,60,"13.0"
"10976","Z44504",2440,630,16,614,"25.2"
"10977","Z44505",9292,1686,49,1637,"17.6"
"10978","Z44506",1271,370,0,370,"29.1"
"10979","Z44507",3002,1020,0,1020,"34.0"
"10980","Z44509",5983,798,0,798,"13.3"
"10981","Z44510",1220,194,0,194,"15.9"
"10982","Z44511",9769,1336,58,1278,"13.1"
"10983","Z44512",16498,1451,81,1370," 8.3"
"10984","Z44514",10061,606,79,527," 5.2"
"10985","Z44515",13152,1253,0,1253," 9.5"
"10986","Z44601",15181,1635,22,1613,"10.6"
"10987","Z44606",2262,93,8,85," 3.8"
"10988","Z44609",1878,210,72,138," 7.3"
"10989","Z44611",739,73,17,56," 7.6"
"10990","Z44612",2191,39,14,25," 1.1"
"10991","Z44613",893,47,0,47," 5.3"
"10992","Z44614",5189,212,0,212," 4.1"
"10993","Z44615",5288,1053,556,497," 9.4"
"10994","Z44618",2467,126,8,118," 4.8"
"10995","Z44620",694,120,61,59," 8.5"
"10996","Z44621",2169,302,86,216,"10.0"
"10997","Z44622",8080,542,116,426," 5.3"
"10998","Z44624",1626,88,0,88," 5.4"
"10999","Z44625",642,48,0,48," 7.5"
"11000","Z44626",1311,62,0,62," 4.7"
"11001","Z44627",1697,34,8,26," 1.5"
"11002","Z44628",578,182,4,178,"30.8"
"11003","Z44629",989,56,12,44," 4.4"
"11004","Z44632",3791,172,0,172," 4.5"
"11005","Z44633",1072,95,0,95," 8.9"
"11006","Z44634",900,63,0,63," 7.0"
"11007","Z44637",1223,60,3,57," 4.7"
"11008","Z44638",707,113,25,88,"12.4"
"11009","Z44641",8362,450,34,416," 5.0"
"11010","Z44643",1344,161,0,161,"12.0"
"11011","Z44644",2292,476,239,237,"10.3"
"11012","Z44645",905,32,0,32," 3.5"
"11013","Z44646",20269,1897,69,1828," 9.0"
"11014","Z44647",8024,621,26,595," 7.4"
"11015","Z44653",230,5,0,5," 2.2"
"11016","Z44654",6057,382,189,193," 3.2"
"11017","Z44657",4422,392,25,367," 8.3"
"11018","Z44662",3907,250,23,227," 5.8"
"11019","Z44663",11012,777,165,612," 5.6"
"11020","Z44666",1202,157,0,157,"13.1"
"11021","Z44667",5752,318,29,289," 5.0"
"11022","Z44669",546,35,0,35," 6.4"
"11023","Z44672",2388,323,34,289,"12.1"
"11024","Z44675",1192,258,167,91," 7.6"
"11025","Z44676",1954,159,36,123," 6.3"
"11026","Z44677",981,64,0,64," 6.5"
"11027","Z44680",2004,141,9,132," 6.6"
"11028","Z44681",2648,145,27,118," 4.5"
"11029","Z44682",377,11,0,11," 2.9"
"11030","Z44683",3871,495,126,369," 9.5"
"11031","Z44685",10782,637,0,637," 5.9"
"11032","Z44688",1347,47,0,47," 3.5"
"11033","Z44689",214,27,4,23,"10.7"
"11034","Z44691",18923,1327,65,1262," 6.7"
"11035","Z44695",830,180,134,46," 5.5"
"11036","Z44697",99,1,0,1," 1.0"
"11037","Z44702",676,126,0,126,"18.6"
"11038","Z44703",4804,1011,0,1011,"21.0"
"11039","Z44704",2084,549,0,549,"26.3"
"11040","Z44705",8248,1038,59,979,"11.9"
"11041","Z44706",7642,658,10,648," 8.5"
"11042","Z44707",4507,691,0,691,"15.3"
"11043","Z44708",12037,1367,5,1362,"11.3"
"11044","Z44709",9514,1289,46,1243,"13.1"
"11045","Z44714",4209,406,0,406," 9.6"
"11046","Z44718",5678,462,0,462," 8.1"
"11047","Z44720",17157,973,9,964," 5.6"
"11048","Z44721",5402,49,0,49," 0.9"
"11049","Z44730",2462,164,0,164," 6.7"
"11050","Z44802",362,23,0,23," 6.4"
"11051","Z44804",519,39,0,39," 7.5"
"11052","Z44805",13820,1027,172,855," 6.2"
"11053","Z44807",1123,160,0,160,"14.2"
"11054","Z44811",5484,512,78,434," 7.9"
"11055","Z44813",3191,254,45,209," 6.5"
"11056","Z44814",1114,81,0,81," 7.3"
"11057","Z44815",275,22,0,22," 8.0"
"11058","Z44817",700,89,2,87,"12.4"
"11059","Z44818",1056,97,0,97," 9.2"
"11060","Z44820",8462,899,20,879,"10.4"
"11061","Z44824",1622,75,3,72," 4.4"
"11062","Z44826",718,102,0,102,"14.2"
"11063","Z44827",3236,432,86,346,"10.7"
"11064","Z44830",8714,916,53,863," 9.9"
"11065","Z44833",8138,991,43,948,"11.6"
"11066","Z44836",951,79,0,79," 8.3"
"11067","Z44837",1771,141,21,120," 6.8"
"11068","Z44838",102,4,0,4," 3.9"
"11069","Z44839",6396,1138,891,247," 3.9"
"11070","Z44840",1255,60,0,60," 4.8"
"11071","Z44841",265,31,0,31,"11.7"
"11072","Z44842",2360,187,24,163," 6.9"
"11073","Z44843",993,49,0,49," 4.9"
"11074","Z44844",258,42,0,42,"16.3"
"11075","Z44846",1178,111,11,100," 8.5"
"11076","Z44847",1657,103,0,103," 6.2"
"11077","Z44849",968,87,0,87," 9.0"
"11078","Z44851",2076,246,32,214,"10.3"
"11079","Z44853",501,11,0,11," 2.2"
"11080","Z44854",732,60,0,60," 8.2"
"11081","Z44855",501,51,2,49," 9.8"
"11082","Z44857",10120,926,33,893," 8.8"
"11083","Z44864",1537,188,102,86," 5.6"
"11084","Z44865",1481,172,10,162,"10.9"
"11085","Z44870",20254,2975,758,2217,"10.9"
"11086","Z44875",6393,715,14,701,"11.0"
"11087","Z44878",1145,48,0,48," 4.2"
"11088","Z44880",996,20,0,20," 2.0"
"11089","Z44882",1226,107,0,107," 8.7"
"11090","Z44883",12291,1278,33,1245,"10.1"
"11091","Z44887",470,55,0,55,"11.7"
"11092","Z44889",2749,147,0,147," 5.3"
"11093","Z44890",4833,559,127,432," 8.9"
"11094","Z44902",2591,896,0,896,"34.6"
"11095","Z44903",11387,1405,23,1382,"12.1"
"11096","Z44904",6137,377,37,340," 5.5"
"11097","Z44905",5247,562,55,507," 9.7"
"11098","Z44906",7941,743,0,743," 9.4"
"11099","Z44907",7499,1054,0,1054,"14.1"
"11100","Z45001",301,83,0,83,"27.6"
"11101","Z45002",5299,389,4,385," 7.3"
"11102","Z45005",12746,819,172,647," 5.1"
"11103","Z45011",26249,2856,189,2667,"10.2"
"11104","Z45013",22508,2134,67,2067," 9.2"
"11105","Z45014",19644,1887,258,1629," 8.3"
"11106","Z45015",5219,544,7,537,"10.3"
"11107","Z45030",7681,625,58,567," 7.4"
"11108","Z45032",145,11,0,11," 7.6"
"11109","Z45033",157,12,0,12," 7.6"
"11110","Z45036",13256,935,71,864," 6.5"
"11111","Z45039",8904,472,132,340," 3.8"
"11112","Z45040",19402,824,71,753," 3.9"
"11113","Z45042",11971,1493,131,1362,"11.4"
"11114","Z45044",21904,2548,51,2497,"11.4"
"11115","Z45050",3443,278,58,220," 6.4"
"11116","Z45052",1579,33,0,33," 2.1"
"11117","Z45056",9233,1410,86,1324,"14.3"
"11118","Z45062",349,40,0,40,"11.5"
"11119","Z45064",1044,72,0,72," 6.9"
"11120","Z45065",2082,187,55,132," 6.3"
"11121","Z45066",8526,304,0,304," 3.6"
"11122","Z45067",5245,265,0,265," 5.1"
"11123","Z45068",4356,168,16,152," 3.5"
"11124","Z45069",18955,707,30,677," 3.6"
"11125","Z45101",1186,221,41,180,"15.2"
"11126","Z45102",9547,740,35,705," 7.4"
"11127","Z45103",13249,1152,0,1152," 8.7"
"11128","Z45106",4931,413,0,413," 8.4"
"11129","Z45107",3910,552,23,529,"13.5"
"11130","Z45113",1494,148,0,148," 9.9"
"11131","Z45118",1561,218,145,73," 4.7"
"11132","Z45120",1432,254,47,207,"14.5"
"11133","Z45121",4004,521,173,348," 8.7"
"11134","Z45122",4327,428,0,428," 9.9"
"11135","Z45123",3701,361,73,288," 7.8"
"11136","Z45130",1492,144,0,144," 9.7"
"11137","Z45131",131,23,7,16,"12.2"
"11138","Z45133",11095,1646,624,1022," 9.2"
"11139","Z45135",1931,153,19,134," 6.9"
"11140","Z45140",20595,1173,64,1109," 5.4"
"11141","Z45142",1519,140,0,140," 9.2"
"11142","Z45144",2306,444,179,265,"11.5"
"11143","Z45148",592,76,0,76,"12.8"
"11144","Z45150",13739,1133,67,1066," 7.8"
"11145","Z45152",4310,281,19,262," 6.1"
"11146","Z45154",3438,279,67,212," 6.2"
"11147","Z45157",3900,354,5,349," 8.9"
"11148","Z45158",133,10,0,10," 7.5"
"11149","Z45159",1319,154,7,147,"11.1"
"11150","Z45160",477,73,0,73,"15.3"
"11151","Z45162",1061,102,24,78," 7.4"
"11152","Z45167",1998,484,157,327,"16.4"
"11153","Z45169",1952,169,0,169," 8.7"
"11154","Z45171",2798,356,179,177," 6.3"
"11155","Z45174",794,34,3,31," 3.9"
"11156","Z45176",3490,350,39,311," 8.9"
"11157","Z45177",9998,1053,81,972," 9.7"
"11158","Z45202",10199,2966,69,2897,"28.4"
"11159","Z45203",1603,169,44,125," 7.8"
"11160","Z45204",3772,958,51,907,"24.0"
"11161","Z45205",9313,2122,43,2079,"22.3"
"11162","Z45206",7559,1625,46,1579,"20.9"
"11163","Z45208",9633,725,17,708," 7.3"
"11164","Z45209",6275,767,24,743,"11.8"
"11165","Z45211",18665,2488,26,2462,"13.2"
"11166","Z45212",11753,1738,23,1715,"14.6"
"11167","Z45213",6212,750,14,736,"11.8"
"11168","Z45214",4874,1561,15,1546,"31.7"
"11169","Z45215",14093,1664,17,1647,"11.7"
"11170","Z45216",4994,881,5,876,"17.5"
"11171","Z45217",3341,580,0,580,"17.4"
"11172","Z45218",1679,227,55,172,"10.2"
"11173","Z45219",7579,1852,56,1796,"23.7"
"11174","Z45220",7687,1100,59,1041,"13.5"
"11175","Z45223",7146,1585,36,1549,"21.7"
"11176","Z45224",9823,934,0,934," 9.5"
"11177","Z45225",4570,920,0,920,"20.1"
"11178","Z45226",2914,491,12,479,"16.4"
"11179","Z45227",9434,1253,27,1226,"13.0"
"11180","Z45229",8107,2392,44,2348,"29.0"
"11181","Z45230",12685,1147,0,1147," 9.0"
"11182","Z45231",17941,1516,41,1475," 8.2"
"11183","Z45232",2712,254,8,246," 9.1"
"11184","Z45233",5712,264,13,251," 4.4"
"11185","Z45236",11735,871,80,791," 6.7"
"11186","Z45237",10248,1461,23,1438,"14.0"
"11187","Z45238",20205,1612,36,1576," 7.8"
"11188","Z45239",13058,1594,26,1568,"12.0"
"11189","Z45240",11139,819,0,819," 7.4"
"11190","Z45241",9923,367,10,357," 3.6"
"11191","Z45242",9390,588,8,580," 6.2"
"11192","Z45243",5721,211,74,137," 2.4"
"11193","Z45244",10697,536,65,471," 4.4"
"11194","Z45245",8694,599,46,553," 6.4"
"11195","Z45246",6333,627,18,609," 9.6"
"11196","Z45247",9473,512,22,490," 5.2"
"11197","Z45248",10069,462,62,400," 4.0"
"11198","Z45249",5418,134,8,126," 2.3"
"11199","Z45251",8917,601,76,525," 5.9"
"11200","Z45252",1992,129,0,129," 6.5"
"11201","Z45255",8885,474,65,409," 4.6"
"11202","Z45302",1431,66,0,66," 4.6"
"11203","Z45303",861,7,0,7," 0.8"
"11204","Z45304",3002,255,35,220," 7.3"
"11205","Z45305",4355,147,0,147," 3.4"
"11206","Z45306",967,21,11,10," 1.0"
"11207","Z45308",1812,224,0,224,"12.4"
"11208","Z45309",5523,272,62,210," 3.8"
"11209","Z45310",108,8,8,0," 0.0"
"11210","Z45311",2787,407,257,150," 5.4"
"11211","Z45312",623,80,4,76,"12.2"
"11212","Z45314",1648,180,17,163," 9.9"
"11213","Z45315",1801,143,0,143," 7.9"
"11214","Z45318",2382,242,26,216," 9.1"
"11215","Z45320",6543,567,55,512," 7.8"
"11216","Z45321",392,27,0,27," 6.9"
"11217","Z45322",9257,626,0,626," 6.8"
"11218","Z45323",2366,37,9,28," 1.2"
"11219","Z45324",18601,1728,53,1675," 9.0"
"11220","Z45326",404,48,0,48,"11.9"
"11221","Z45327",4011,379,40,339," 8.5"
"11222","Z45328",225,19,3,16," 7.1"
"11223","Z45330",385,33,0,33," 8.6"
"11224","Z45331",10762,888,137,751," 7.0"
"11225","Z45332",337,55,4,51,"15.1"
"11226","Z45335",2686,188,32,156," 5.8"
"11227","Z45337",694,27,0,27," 3.9"
"11228","Z45338",2097,176,0,176," 8.4"
"11229","Z45339",589,24,0,24," 4.1"
"11230","Z45341",1757,203,0,203,"11.6"
"11231","Z45342",17052,1318,18,1300," 7.6"
"11232","Z45344",6663,555,9,546," 8.2"
"11233","Z45345",2789,220,0,220," 7.9"
"11234","Z45346",913,73,0,73," 8.0"
"11235","Z45347",1948,159,2,157," 8.1"
"11236","Z45348",325,5,0,5," 1.5"
"11237","Z45349",129,11,2,9," 7.0"
"11238","Z45350",44,9,0,9,"20.5"
"11239","Z45351",109,10,5,5," 4.6"
"11240","Z45354",290,42,0,42,"14.5"
"11241","Z45356",11126,808,8,800," 7.2"
"11242","Z45359",747,81,7,74," 9.9"
"11243","Z45360",198,25,0,25,"12.6"
"11244","Z45363",631,19,0,19," 3.0"
"11245","Z45365",13178,1306,195,1111," 8.4"
"11246","Z45368",1931,97,8,89," 4.6"
"11247","Z45369",1415,105,0,105," 7.4"
"11248","Z45370",1008,86,8,78," 7.7"
"11249","Z45371",7918,461,33,428," 5.4"
"11250","Z45373",15207,1077,69,1008," 6.6"
"11251","Z45377",6646,444,18,426," 6.4"
"11252","Z45381",2384,276,23,253,"10.6"
"11253","Z45382",509,60,0,60,"11.8"
"11254","Z45383",3243,185,0,185," 5.7"
"11255","Z45385",16474,1115,64,1051," 6.4"
"11256","Z45387",2560,136,47,89," 3.5"
"11257","Z45389",242,20,0,20," 8.3"
"11258","Z45390",1411,113,0,113," 8.0"
"11259","Z45402",6618,1902,0,1902,"28.7"
"11260","Z45403",7747,1630,43,1587,"20.5"
"11261","Z45404",4998,973,36,937,"18.7"
"11262","Z45405",12003,3993,3,3990,"33.2"
"11263","Z45406",12434,3365,0,3365,"27.1"
"11264","Z45409",3493,415,0,415,"11.9"
"11265","Z45410",8478,1683,42,1641,"19.4"
"11266","Z45414",9675,917,53,864," 8.9"
"11267","Z45415",5907,572,0,572," 9.7"
"11268","Z45416",2504,252,0,252,"10.1"
"11269","Z45417",16514,3772,92,3680,"22.3"
"11270","Z45419",6995,515,0,515," 7.4"
"11271","Z45420",12787,1100,0,1100," 8.6"
"11272","Z45424",20613,1160,37,1123," 5.4"
"11273","Z45426",7910,1262,29,1233,"15.6"
"11274","Z45429",12561,1020,74,946," 7.5"
"11275","Z45430",3052,140,6,134," 4.4"
"11276","Z45431",12277,858,0,858," 7.0"
"11277","Z45432",6652,490,16,474," 7.1"
"11278","Z45433",656,16,0,16," 2.4"
"11279","Z45434",4579,163,0,163," 3.6"
"11280","Z45439",4509,417,0,417," 9.2"
"11281","Z45440",9693,507,88,419," 4.3"
"11282","Z45449",8934,696,10,686," 7.7"
"11283","Z45458",13404,694,26,668," 5.0"
"11284","Z45459",13000,592,99,493," 3.8"
"11285","Z45502",6613,461,26,435," 6.6"
"11286","Z45503",15536,1357,35,1322," 8.5"
"11287","Z45504",7733,812,10,802,"10.4"
"11288","Z45505",9520,1447,0,1447,"15.2"
"11289","Z45506",6782,1298,14,1284,"18.9"
"11290","Z45601",23284,2746,268,2478,"10.6"
"11291","Z45612",2439,243,97,146," 6.0"
"11292","Z45614",2239,463,64,399,"17.8"
"11293","Z45619",3581,614,99,515,"14.4"
"11294","Z45620",557,35,3,32," 5.7"
"11295","Z45621",185,34,0,34,"18.4"
"11296","Z45623",1611,389,129,260,"16.1"
"11297","Z45628",2110,387,0,387,"18.3"
"11298","Z45629",1207,58,0,58," 4.8"
"11299","Z45631",6829,891,94,797,"11.7"
"11300","Z45638",9784,1427,70,1357,"13.9"
"11301","Z45640",6984,604,149,455," 6.5"
"11302","Z45644",1808,78,0,78," 4.3"
"11303","Z45645",1472,147,14,133," 9.0"
"11304","Z45647",979,145,77,68," 6.9"
"11305","Z45648",4954,336,75,261," 5.3"
"11306","Z45651",2751,514,173,341,"12.4"
"11307","Z45652",1643,126,0,126," 7.7"
"11308","Z45653",1999,268,0,268,"13.4"
"11309","Z45654",433,64,0,64,"14.8"
"11310","Z45656",2987,332,63,269," 9.0"
"11311","Z45658",1136,268,21,247,"21.7"
"11312","Z45660",3682,558,182,376,"10.2"
"11313","Z45661",3246,463,74,389,"12.0"
"11314","Z45662",13843,2035,45,1990,"14.4"
"11315","Z45663",2800,405,109,296,"10.6"
"11316","Z45669",4519,554,0,554,"12.3"
"11317","Z45672",742,227,62,165,"22.2"
"11318","Z45674",177,22,0,22,"12.4"
"11319","Z45679",1322,314,67,247,"18.7"
"11320","Z45680",5237,626,0,626,"12.0"
"11321","Z45681",718,16,16,0," 0.0"
"11322","Z45682",1073,127,0,127,"11.8"
"11323","Z45684",844,62,20,42," 5.0"
"11324","Z45686",1587,312,141,171,"10.8"
"11325","Z45690",6492,865,247,618," 9.5"
"11326","Z45692",3977,572,0,572,"14.4"
"11327","Z45693",3669,531,341,190," 5.2"
"11328","Z45694",5104,563,35,528,"10.3"
"11329","Z45697",2099,150,76,74," 3.5"
"11330","Z45701",12714,1709,234,1475,"11.6"
"11331","Z45710",2524,278,96,182," 7.2"
"11332","Z45711",534,104,66,38," 7.1"
"11333","Z45714",4486,290,54,236," 5.3"
"11334","Z45715",1192,192,59,133,"11.2"
"11335","Z45723",1553,190,54,136," 8.8"
"11336","Z45724",841,132,52,80," 9.5"
"11337","Z45729",529,80,0,80,"15.1"
"11338","Z45732",2091,374,183,191," 9.1"
"11339","Z45734",348,152,121,31," 8.9"
"11340","Z45740",223,37,0,37,"16.6"
"11341","Z45741",494,52,13,39," 7.9"
"11342","Z45742",1244,44,0,44," 3.5"
"11343","Z45743",692,146,0,146,"21.1"
"11344","Z45744",1130,201,55,146,"12.9"
"11345","Z45745",594,94,81,13," 2.2"
"11346","Z45750",12710,1336,63,1273,"10.0"
"11347","Z45764",3790,606,46,560,"14.8"
"11348","Z45766",495,50,16,34," 6.9"
"11349","Z45769",3173,452,32,420,"13.2"
"11350","Z45771",1586,198,14,184,"11.6"
"11351","Z45772",971,147,59,88," 9.1"
"11352","Z45775",556,71,15,56,"10.1"
"11353","Z45778",397,58,21,37," 9.3"
"11354","Z45779",285,45,14,31,"10.9"
"11355","Z45780",1647,292,36,256,"15.5"
"11356","Z45784",1357,189,0,189,"13.9"
"11357","Z45786",1471,105,23,82," 5.6"
"11358","Z45788",622,148,74,74,"11.9"
"11359","Z45801",9854,1525,30,1495,"15.2"
"11360","Z45804",7426,1338,0,1338,"18.0"
"11361","Z45805",10275,873,9,864," 8.4"
"11362","Z45806",4947,359,25,334," 6.8"
"11363","Z45807",4916,306,99,207," 4.2"
"11364","Z45808",163,7,0,7," 4.3"
"11365","Z45810",3118,420,70,350,"11.2"
"11366","Z45812",900,163,11,152,"16.9"
"11367","Z45813",1523,72,0,72," 4.7"
"11368","Z45814",1146,39,0,39," 3.4"
"11369","Z45817",2631,195,23,172," 6.5"
"11370","Z45820",201,27,5,22,"10.9"
"11371","Z45821",610,61,0,61,"10.0"
"11372","Z45822",9521,1453,784,669," 7.0"
"11373","Z45826",156,1,1,0," 0.0"
"11374","Z45827",802,107,0,107,"13.3"
"11375","Z45828",2459,63,0,63," 2.6"
"11376","Z45830",2470,159,0,159," 6.4"
"11377","Z45831",1333,55,0,55," 4.1"
"11378","Z45832",1268,93,3,90," 7.1"
"11379","Z45833",4545,320,24,296," 6.5"
"11380","Z45836",689,106,5,101,"14.7"
"11381","Z45840",24691,1456,54,1402," 5.7"
"11382","Z45841",324,14,0,14," 4.3"
"11383","Z45843",1639,152,0,152," 9.3"
"11384","Z45844",1355,57,0,57," 4.2"
"11385","Z45845",1121,57,0,57," 5.1"
"11386","Z45846",1426,18,9,9," 0.6"
"11387","Z45849",481,41,0,41," 8.5"
"11388","Z45850",1390,120,0,120," 8.6"
"11389","Z45851",284,59,0,59,"20.8"
"11390","Z45853",546,8,8,0," 0.0"
"11391","Z45854",211,24,2,22,"10.4"
"11392","Z45855",81,4,0,4," 4.9"
"11393","Z45856",2075,161,12,149," 7.2"
"11394","Z45858",1287,116,9,107," 8.3"
"11395","Z45860",793,47,0,47," 5.9"
"11396","Z45862",626,24,0,24," 3.8"
"11397","Z45863",451,49,0,49,"10.9"
"11398","Z45864",70,4,0,4," 5.7"
"11399","Z45865",1896,96,68,28," 1.5"
"11400","Z45867",388,38,12,26," 6.7"
"11401","Z45868",277,23,9,14," 5.1"
"11402","Z45869",1829,52,15,37," 2.0"
"11403","Z45871",753,21,5,16," 2.1"
"11404","Z45872",1675,113,0,113," 6.7"
"11405","Z45873",1043,209,12,197,"18.9"
"11406","Z45874",991,112,0,112,"11.3"
"11407","Z45875",4509,178,20,158," 3.5"
"11408","Z45877",850,35,20,15," 1.8"
"11409","Z45879",2863,269,76,193," 6.7"
"11410","Z45880",1107,101,0,101," 9.1"
"11411","Z45881",593,24,0,24," 4.0"
"11412","Z45882",1128,51,0,51," 4.5"
"11413","Z45883",1283,27,14,13," 1.0"
"11414","Z45885",5831,711,198,513," 8.8"
"11415","Z45887",1716,97,0,97," 5.7"
"11416","Z45890",246,25,0,25,"10.2"
"11417","Z45891",6747,635,49,586," 8.7"
"11418","Z45895",7635,512,95,417," 5.5"
"11419","Z45896",862,36,6,30," 3.5"
"11420","Z45898",581,106,0,106,"18.2"
"11421","Z46001",4889,614,0,614,"12.6"
"11422","Z46011",7481,580,44,536," 7.2"
"11423","Z46012",8501,929,48,881,"10.4"
"11424","Z46013",8979,880,41,839," 9.3"
"11425","Z46016",9918,2542,4,2538,"25.6"
"11426","Z46017",2710,279,48,231," 8.5"
"11427","Z46030",1378,136,0,136," 9.9"
"11428","Z46031",879,49,0,49," 5.6"
"11429","Z46032",18723,1267,147,1120," 6.0"
"11430","Z46033",13086,296,27,269," 2.1"
"11431","Z46034",2896,148,46,102," 3.5"
"11432","Z46035",494,87,0,87,"17.6"
"11433","Z46036",5360,810,0,810,"15.1"
"11434","Z46037",13599,558,65,493," 3.6"
"11435","Z46038",16318,498,79,419," 2.6"
"11436","Z46039",262,18,0,18," 6.9"
"11437","Z46040",4089,249,0,249," 6.1"
"11438","Z46041",9677,1241,55,1186,"12.3"
"11439","Z46044",1240,122,8,114," 9.2"
"11440","Z46048",813,88,0,88,"10.8"
"11441","Z46049",388,76,0,76,"19.6"
"11442","Z46050",651,28,0,28," 4.3"
"11443","Z46051",1276,56,0,56," 4.4"
"11444","Z46052",9881,815,12,803," 8.1"
"11445","Z46055",4099,597,43,554,"13.5"
"11446","Z46056",952,53,6,47," 4.9"
"11447","Z46057",394,15,0,15," 3.8"
"11448","Z46060",14728,859,85,774," 5.3"
"11449","Z46062",12664,624,134,490," 3.9"
"11450","Z46064",5463,400,25,375," 6.9"
"11451","Z46065",1299,156,0,156,"12.0"
"11452","Z46068",1179,89,0,89," 7.5"
"11453","Z46069",3200,428,0,428,"13.4"
"11454","Z46070",1052,138,0,138,"13.1"
"11455","Z46071",1484,128,8,120," 8.1"
"11456","Z46072",4219,316,33,283," 6.7"
"11457","Z46074",10631,387,19,368," 3.5"
"11458","Z46075",1606,108,37,71," 4.4"
"11459","Z46076",763,57,0,57," 7.5"
"11460","Z46077",9944,428,25,403," 4.1"
"11461","Z46104",411,23,0,23," 5.6"
"11462","Z46105",986,183,7,176,"17.8"
"11463","Z46106",2637,294,0,294,"11.1"
"11464","Z46107",5175,367,0,367," 7.1"
"11465","Z46112",12978,297,0,297," 2.3"
"11466","Z46113",5635,470,0,470," 8.3"
"11467","Z46115",819,56,5,51," 6.2"
"11468","Z46118",2012,148,1,147," 7.3"
"11469","Z46120",2493,322,66,256,"10.3"
"11470","Z46121",2432,253,191,62," 2.5"
"11471","Z46122",5877,248,46,202," 3.4"
"11472","Z46123",12325,574,0,574," 4.7"
"11473","Z46124",3008,227,0,227," 7.5"
"11474","Z46126",2107,113,0,113," 5.4"
"11475","Z46128",708,14,2,12," 1.7"
"11476","Z46130",967,26,0,26," 2.7"
"11477","Z46131",12518,1175,88,1087," 8.7"
"11478","Z46133",313,66,0,66,"21.1"
"11479","Z46135",7406,1165,333,832,"11.2"
"11480","Z46140",16078,1361,22,1339," 8.3"
"11481","Z46142",12195,941,34,907," 7.4"
"11482","Z46143",21094,1598,43,1555," 7.4"
"11483","Z46147",1500,97,2,95," 6.3"
"11484","Z46148",2380,360,0,360,"15.1"
"11485","Z46150",292,41,0,41,"14.0"
"11486","Z46151",12531,1203,122,1081," 8.6"
"11487","Z46156",658,43,0,43," 6.5"
"11488","Z46157",1418,48,0,48," 3.4"
"11489","Z46158",9297,644,53,591," 6.4"
"11490","Z46160",2748,468,214,254," 9.2"
"11491","Z46161",1134,83,0,83," 7.3"
"11492","Z46163",4379,160,0,160," 3.7"
"11493","Z46164",2723,1092,884,208," 7.6"
"11494","Z46165",562,25,0,25," 4.4"
"11495","Z46166",905,35,0,35," 3.9"
"11496","Z46167",2122,92,0,92," 4.3"
"11497","Z46168",12834,1060,72,988," 7.7"
"11498","Z46171",796,186,26,160,"20.1"
"11499","Z46172",1107,127,0,127,"11.5"
"11500","Z46173",4884,308,0,308," 6.3"
"11501","Z46175",229,24,0,24,"10.5"
"11502","Z46176",12240,1445,64,1381,"11.3"
"11503","Z46180",309,19,0,19," 6.1"
"11504","Z46181",1857,234,112,122," 6.6"
"11505","Z46182",676,137,78,59," 8.7"
"11506","Z46184",4870,352,50,302," 6.2"
"11507","Z46186",669,36,8,28," 4.2"
"11508","Z46201",16926,4760,19,4741,"28.0"
"11509","Z46202",10507,1810,222,1588,"15.1"
"11510","Z46203",17394,3186,14,3172,"18.2"
"11511","Z46204",3576,354,63,291," 8.1"
"11512","Z46205",14155,2682,21,2661,"18.8"
"11513","Z46208",12167,3249,143,3106,"25.5"
"11514","Z46214",11921,1771,72,1699,"14.3"
"11515","Z46216",1135,63,0,63," 5.6"
"11516","Z46217",12501,486,14,472," 3.8"
"11517","Z46218",15153,3631,16,3615,"23.9"
"11518","Z46219",16751,2090,17,2073,"12.4"
"11519","Z46220",17529,1217,23,1194," 6.8"
"11520","Z46221",10509,1170,34,1136,"10.8"
"11521","Z46222",15507,3395,23,3372,"21.7"
"11522","Z46224",16955,2610,7,2603,"15.4"
"11523","Z46225",3653,968,0,968,"26.5"
"11524","Z46226",20765,3370,34,3336,"16.1"
"11525","Z46227",25778,2499,54,2445," 9.5"
"11526","Z46228",6450,649,16,633," 9.8"
"11527","Z46229",11483,1285,68,1217,"10.6"
"11528","Z46231",3819,262,0,262," 6.9"
"11529","Z46234",10505,943,48,895," 8.5"
"11530","Z46235",13609,2096,0,2096,"15.4"
"11531","Z46236",10206,370,11,359," 3.5"
"11532","Z46237",16514,1231,56,1175," 7.1"
"11533","Z46239",10121,687,75,612," 6.0"
"11534","Z46240",10284,1054,62,992," 9.6"
"11535","Z46241",12465,1486,40,1446,"11.6"
"11536","Z46250",9665,765,25,740," 7.7"
"11537","Z46254",16510,1708,30,1678,"10.2"
"11538","Z46256",10790,602,13,589," 5.5"
"11539","Z46259",3886,183,0,183," 4.7"
"11540","Z46260",15064,1867,108,1759,"11.7"
"11541","Z46268",11710,671,0,671," 5.7"
"11542","Z46278",2959,279,10,269," 9.1"
"11543","Z46280",3221,185,0,185," 5.7"
"11544","Z46301",503,210,194,16," 3.2"
"11545","Z46303",5502,553,103,450," 8.2"
"11546","Z46304",9892,616,199,417," 4.2"
"11547","Z46307",23741,1154,138,1016," 4.3"
"11548","Z46310",5418,583,178,405," 7.5"
"11549","Z46311",7901,293,51,242," 3.1"
"11550","Z46312",13376,3270,110,3160,"23.6"
"11551","Z46319",7346,539,90,449," 6.1"
"11552","Z46320",6311,1152,19,1133,"18.0"
"11553","Z46321",9186,527,89,438," 4.8"
"11554","Z46322",9917,476,53,423," 4.3"
"11555","Z46323",9107,881,27,854," 9.4"
"11556","Z46324",9385,1099,0,1099,"11.7"
"11557","Z46327",4463,742,14,728,"16.3"
"11558","Z46340",387,31,0,31," 8.0"
"11559","Z46341",3865,178,45,133," 3.4"
"11560","Z46342",12894,729,20,709," 5.5"
"11561","Z46345",114,11,0,11," 9.6"
"11562","Z46347",1875,136,35,101," 5.4"
"11563","Z46348",454,23,0,23," 5.1"
"11564","Z46349",1346,72,0,72," 5.3"
"11565","Z46350",18598,1434,169,1265," 6.8"
"11566","Z46356",6472,485,201,284," 4.4"
"11567","Z46360",21113,3255,1421,1834," 8.7"
"11568","Z46366",2397,231,84,147," 6.1"
"11569","Z46368",16119,1287,213,1074," 6.7"
"11570","Z46371",1631,211,71,140," 8.6"
"11571","Z46373",5284,75,0,75," 1.4"
"11572","Z46374",470,71,33,38," 8.1"
"11573","Z46375",9836,567,43,524," 5.3"
"11574","Z46376",140,10,0,10," 7.1"
"11575","Z46382",818,57,0,57," 7.0"
"11576","Z46383",16432,1323,248,1075," 6.5"
"11577","Z46385",15074,603,128,475," 3.2"
"11578","Z46390",1273,105,15,90," 7.1"
"11579","Z46391",2261,213,67,146," 6.5"
"11580","Z46392",3262,305,67,238," 7.3"
"11581","Z46394",5557,915,114,801,"14.4"
"11582","Z46402",3853,1273,12,1261,"32.7"
"11583","Z46403",6817,1285,70,1215,"17.8"
"11584","Z46404",8562,1858,31,1827,"21.3"
"11585","Z46405",4513,545,0,545,"12.1"
"11586","Z46406",4519,736,0,736,"16.3"
"11587","Z46407",7501,2586,40,2546,"33.9"
"11588","Z46408",8087,2089,0,2089,"25.8"
"11589","Z46409",4477,1551,19,1532,"34.2"
"11590","Z46410",16368,1203,146,1057," 6.5"
"11591","Z46501",1514,196,17,179,"11.8"
"11592","Z46504",1505,90,19,71," 4.7"
"11593","Z46506",3754,247,183,64," 1.7"
"11594","Z46507",3911,445,86,359," 9.2"
"11595","Z46508",74,17,0,17,"23.0"
"11596","Z46510",1872,507,349,158," 8.4"
"11597","Z46511",2641,924,638,286,"10.8"
"11598","Z46514",17841,2119,304,1815,"10.2"
"11599","Z46516",13764,1971,0,1971,"14.3"
"11600","Z46517",9189,802,0,802," 8.7"
"11601","Z46524",929,90,0,90," 9.7"
"11602","Z46526",12204,741,69,672," 5.5"
"11603","Z46528",8789,558,26,532," 6.1"
"11604","Z46530",11262,414,43,371," 3.3"
"11605","Z46532",835,47,0,47," 5.6"
"11606","Z46534",5621,1314,792,522," 9.3"
"11607","Z46537",225,33,0,33,"14.7"
"11608","Z46538",2693,1187,1016,171," 6.3"
"11609","Z46539",894,123,0,123,"13.8"
"11610","Z46540",3796,215,41,174," 4.6"
"11611","Z46542",1640,195,80,115," 7.0"
"11612","Z46543",1036,47,0,47," 4.5"
"11613","Z46544",13762,1213,22,1191," 8.7"
"11614","Z46545",12301,1794,227,1567,"12.7"
"11615","Z46550",4528,426,0,426," 9.4"
"11616","Z46552",2991,296,103,193," 6.5"
"11617","Z46554",2148,173,32,141," 6.6"
"11618","Z46555",2200,992,773,219,"10.0"
"11619","Z46556",309,58,13,45,"14.6"
"11620","Z46561",5149,205,0,205," 4.0"
"11621","Z46562",2243,271,155,116," 5.2"
"11622","Z46563",9901,1116,220,896," 9.0"
"11623","Z46565",2448,187,95,92," 3.8"
"11624","Z46567",5778,1953,1489,464," 8.0"
"11625","Z46570",482,84,50,34," 7.1"
"11626","Z46573",1360,79,26,53," 3.9"
"11627","Z46574",4055,891,487,404,"10.0"
"11628","Z46580",9107,732,186,546," 6.0"
"11629","Z46582",5669,1017,715,302," 5.3"
"11630","Z46590",1938,268,47,221,"11.4"
"11631","Z46601",2943,433,18,415,"14.1"
"11632","Z46613",4829,1015,0,1015,"21.0"
"11633","Z46614",13687,1124,42,1082," 7.9"
"11634","Z46615",7045,1040,20,1020,"14.5"
"11635","Z46616",2934,626,11,615,"21.0"
"11636","Z46617",4666,877,217,660,"14.1"
"11637","Z46619",8567,1139,50,1089,"12.7"
"11638","Z46628",11601,1640,108,1532,"13.2"
"11639","Z46635",2869,322,0,322,"11.2"
"11640","Z46637",7401,950,123,827,"11.2"
"11641","Z46701",3543,376,116,260," 7.3"
"11642","Z46702",1061,64,0,64," 6.0"
"11643","Z46703",9181,2439,1571,868," 9.5"
"11644","Z46705",767,148,0,148,"19.3"
"11645","Z46706",8036,510,42,468," 5.8"
"11646","Z46710",1734,140,0,140," 8.1"
"11647","Z46711",2728,274,56,218," 8.0"
"11648","Z46714",6341,530,0,530," 8.4"
"11649","Z46721",2069,172,0,172," 8.3"
"11650","Z46723",3163,190,60,130," 4.1"
"11651","Z46725",10229,943,451,492," 4.8"
"11652","Z46732",1414,274,126,148,"10.5"
"11653","Z46733",7993,524,0,524," 6.6"
"11654","Z46737",4957,1926,1568,358," 7.2"
"11655","Z46738",3242,173,0,173," 5.3"
"11656","Z46740",1373,73,15,58," 4.2"
"11657","Z46741",1567,77,9,68," 4.3"
"11658","Z46742",2136,758,637,121," 5.7"
"11659","Z46743",755,36,0,36," 4.8"
"11660","Z46745",820,23,7,16," 2.0"
"11661","Z46746",1791,304,130,174," 9.7"
"11662","Z46747",1690,475,282,193,"11.4"
"11663","Z46748",2038,85,0,85," 4.2"
"11664","Z46750",11467,1052,75,977," 8.5"
"11665","Z46755",6558,380,59,321," 4.9"
"11666","Z46760",591,12,0,12," 2.0"
"11667","Z46761",4664,795,432,363," 7.8"
"11668","Z46763",741,54,0,54," 7.3"
"11669","Z46764",506,87,0,87,"17.2"
"11670","Z46765",1858,94,0,94," 5.1"
"11671","Z46767",2847,170,18,152," 5.3"
"11672","Z46770",1149,77,0,77," 6.7"
"11673","Z46773",1421,138,10,128," 9.0"
"11674","Z46774",6557,230,0,230," 3.5"
"11675","Z46776",923,368,357,11," 1.2"
"11676","Z46777",2600,146,0,146," 5.6"
"11677","Z46779",1107,186,134,52," 4.7"
"11678","Z46783",2572,232,8,224," 8.7"
"11679","Z46784",1344,462,388,74," 5.5"
"11680","Z46785",594,20,0,20," 3.4"
"11681","Z46787",1563,140,3,137," 8.8"
"11682","Z46788",1155,46,0,46," 4.0"
"11683","Z46791",402,4,0,4," 1.0"
"11684","Z46792",1658,113,40,73," 4.4"
"11685","Z46793",1595,78,0,78," 4.9"
"11686","Z46794",797,198,170,28," 3.5"
"11687","Z46795",3490,1162,971,191," 5.5"
"11688","Z46798",690,47,0,47," 6.8"
"11689","Z46799",98,14,0,14,"14.3"
"11690","Z46802",5797,1231,16,1215,"21.0"
"11691","Z46803",4382,910,28,882,"20.1"
"11692","Z46804",12243,523,0,523," 4.3"
"11693","Z46805",10131,1401,41,1360,"13.4"
"11694","Z46806",10370,1844,16,1828,"17.6"
"11695","Z46807",6751,853,16,837,"12.4"
"11696","Z46808",8786,951,7,944,"10.7"
"11697","Z46809",4209,436,21,415," 9.9"
"11698","Z46814",4313,80,10,70," 1.6"
"11699","Z46815",11270,816,7,809," 7.2"
"11700","Z46816",8514,938,0,938,"11.0"
"11701","Z46818",7881,299,43,256," 3.2"
"11702","Z46819",4064,282,7,275," 6.8"
"11703","Z46825",12782,706,28,678," 5.3"
"11704","Z46835",14828,808,106,702," 4.7"
"11705","Z46845",8097,354,0,354," 4.4"
"11706","Z46901",18482,2468,144,2324,"12.6"
"11707","Z46902",16956,1575,81,1494," 8.8"
"11708","Z46911",598,122,23,99,"16.6"
"11709","Z46913",460,26,0,26," 5.7"
"11710","Z46914",700,115,13,102,"14.6"
"11711","Z46915",334,47,0,47,"14.1"
"11712","Z46917",839,105,0,105,"12.5"
"11713","Z46919",1033,61,20,41," 4.0"
"11714","Z46920",375,25,10,15," 4.0"
"11715","Z46923",3436,242,28,214," 6.2"
"11716","Z46926",756,76,5,71," 9.4"
"11717","Z46928",2042,239,7,232,"11.4"
"11718","Z46929",1500,279,0,279,"18.6"
"11719","Z46931",76,4,0,4," 5.3"
"11720","Z46932",1598,169,28,141," 8.8"
"11721","Z46933",2914,365,18,347,"11.9"
"11722","Z46936",2546,200,0,200," 7.9"
"11723","Z46940",1057,43,19,24," 2.3"
"11724","Z46941",457,42,5,37," 8.1"
"11725","Z46947",11878,1314,147,1167," 9.8"
"11726","Z46951",1048,331,162,169,"16.1"
"11727","Z46952",9412,838,213,625," 6.6"
"11728","Z46953",10294,1642,283,1359,"13.2"
"11729","Z46960",495,84,36,48," 9.7"
"11730","Z46962",4011,373,56,317," 7.9"
"11731","Z46970",10193,1566,129,1437,"14.1"
"11732","Z46975",6827,1076,456,620," 9.1"
"11733","Z46978",949,103,17,86," 9.1"
"11734","Z46982",1119,202,118,84," 7.5"
"11735","Z46985",693,138,94,44," 6.3"
"11736","Z46986",988,238,60,178,"18.0"
"11737","Z46987",323,28,0,28," 8.7"
"11738","Z46992",7543,667,55,612," 8.1"
"11739","Z46994",1185,159,41,118,"10.0"
"11740","Z46996",3259,476,190,286," 8.8"
"11741","Z47001",4692,465,58,407," 8.7"
"11742","Z47003",458,41,0,41," 9.0"
"11743","Z47006",4681,331,6,325," 6.9"
"11744","Z47011",356,115,53,62,"17.4"
"11745","Z47012",4379,376,112,264," 6.0"
"11746","Z47018",1958,284,54,230,"11.7"
"11747","Z47023",597,41,0,41," 6.9"
"11748","Z47024",1322,131,22,109," 8.2"
"11749","Z47025",9115,712,109,603," 6.6"
"11750","Z47031",2293,175,9,166," 7.2"
"11751","Z47032",1207,76,32,44," 3.6"
"11752","Z47034",74,19,0,19,"25.7"
"11753","Z47036",364,19,0,19," 5.2"
"11754","Z47037",2055,265,53,212,"10.3"
"11755","Z47038",876,220,130,90,"10.3"
"11756","Z47040",2403,301,139,162," 6.7"
"11757","Z47041",2460,210,12,198," 8.0"
"11758","Z47042",1864,191,10,181," 9.7"
"11759","Z47043",2616,537,277,260," 9.9"
"11760","Z47060",2584,120,4,116," 4.5"
"11761","Z47102",3261,354,0,354,"10.9"
"11762","Z47106",2028,392,8,384,"18.9"
"11763","Z47108",1067,245,78,167,"15.7"
"11764","Z47111",6160,707,81,626,"10.2"
"11765","Z47112",7168,704,91,613," 8.6"
"11766","Z47115",1111,227,0,227,"20.4"
"11767","Z47117",1837,319,69,250,"13.6"
"11768","Z47118",1668,288,186,102," 6.1"
"11769","Z47119",4252,300,8,292," 6.9"
"11770","Z47122",4047,258,6,252," 6.2"
"11771","Z47124",1428,78,66,12," 0.8"
"11772","Z47125",678,88,34,54," 8.0"
"11773","Z47126",1756,260,58,202,"11.5"
"11774","Z47129",9325,1108,33,1075,"11.5"
"11775","Z47130",20335,2791,205,2586,"12.7"
"11776","Z47135",647,95,0,95,"14.7"
"11777","Z47136",1682,29,2,27," 1.6"
"11778","Z47137",696,194,167,27," 3.9"
"11779","Z47138",1809,87,14,73," 4.0"
"11780","Z47140",1037,159,12,147,"14.2"
"11781","Z47141",715,106,26,80,"11.2"
"11782","Z47142",452,61,24,37," 8.2"
"11783","Z47143",1142,61,27,34," 3.0"
"11784","Z47150",21860,2514,106,2408,"11.0"
"11785","Z47161",1504,259,32,227,"15.1"
"11786","Z47163",698,8,0,8," 1.1"
"11787","Z47164",1599,210,137,73," 4.6"
"11788","Z47165",2746,380,96,284,"10.3"
"11789","Z47166",647,90,16,74,"11.4"
"11790","Z47167",6471,732,17,715,"11.0"
"11791","Z47170",6497,1172,152,1020,"15.7"
"11792","Z47172",6153,262,0,262," 4.3"
"11793","Z47177",440,15,0,15," 3.4"
"11794","Z47201",18656,1806,268,1538," 8.2"
"11795","Z47203",11086,682,50,632," 5.7"
"11796","Z47220",2309,205,27,178," 7.7"
"11797","Z47224",241,23,0,23," 9.5"
"11798","Z47229",1345,169,3,166,"12.3"
"11799","Z47232",1133,137,4,133,"11.7"
"11800","Z47234",611,34,0,34," 5.6"
"11801","Z47235",648,123,0,123,"19.0"
"11802","Z47240",8969,799,156,643," 7.2"
"11803","Z47243",2076,213,132,81," 3.9"
"11804","Z47244",329,37,0,37,"11.2"
"11805","Z47246",1838,141,13,128," 7.0"
"11806","Z47247",68,13,0,13,"19.1"
"11807","Z47250",10507,1269,226,1043," 9.9"
"11808","Z47260",724,81,3,78,"10.8"
"11809","Z47263",83,16,0,16,"19.3"
"11810","Z47264",746,66,37,29," 3.9"
"11811","Z47265",8899,1135,333,802," 9.0"
"11812","Z47272",926,150,3,147,"15.9"
"11813","Z47274",12900,1354,175,1179," 9.1"
"11814","Z47282",149,30,2,28,"18.8"
"11815","Z47283",1407,227,3,224,"15.9"
"11816","Z47302",13400,1907,0,1907,"14.2"
"11817","Z47303",11584,1472,5,1467,"12.7"
"11818","Z47304",14239,1351,71,1280," 9.0"
"11819","Z47305",2560,868,34,834,"32.6"
"11820","Z47320",1795,113,0,113," 6.3"
"11821","Z47326",689,64,0,64," 9.3"
"11822","Z47327",2004,205,0,205,"10.2"
"11823","Z47330",2406,196,5,191," 7.9"
"11824","Z47331",10463,1424,73,1351,"12.9"
"11825","Z47334",1426,92,0,92," 6.5"
"11826","Z47336",1724,291,9,282,"16.4"
"11827","Z47338",1318,226,0,226,"17.1"
"11828","Z47339",270,11,0,11," 4.1"
"11829","Z47340",1358,153,3,150,"11.0"
"11830","Z47341",905,72,0,72," 8.0"
"11831","Z47342",1354,100,0,100," 7.4"
"11832","Z47346",1751,144,3,141," 8.1"
"11833","Z47348",4646,604,141,463,"10.0"
"11834","Z47351",154,23,0,23,"14.9"
"11835","Z47353",2516,172,34,138," 5.5"
"11836","Z47354",518,83,7,76,"14.7"
"11837","Z47355",1271,115,0,115," 9.0"
"11838","Z47356",2409,241,11,230," 9.5"
"11839","Z47357",518,52,0,52,"10.0"
"11840","Z47358",451,45,0,45,"10.0"
"11841","Z47359",1430,191,60,131," 9.2"
"11842","Z47360",566,39,0,39," 6.9"
"11843","Z47361",95,25,0,25,"26.3"
"11844","Z47362",13072,2170,30,2140,"16.4"
"11845","Z47371",5403,543,89,454," 8.4"
"11846","Z47373",995,121,26,95," 9.5"
"11847","Z47374",21952,3185,38,3147,"14.3"
"11848","Z47380",824,98,0,98,"11.9"
"11849","Z47383",1280,200,0,200,"15.6"
"11850","Z47384",828,116,8,108,"13.0"
"11851","Z47385",673,69,0,69,"10.3"
"11852","Z47386",536,18,2,16," 3.0"
"11853","Z47387",260,9,0,9," 3.5"
"11854","Z47388",159,28,1,27,"17.0"
"11855","Z47390",2447,296,0,296,"12.1"
"11856","Z47394",3656,260,9,251," 6.9"
"11857","Z47396",3027,203,0,203," 6.7"
"11858","Z47401",18883,1828,700,1128," 6.0"
"11859","Z47403",14619,1049,52,997," 6.8"
"11860","Z47404",10202,1141,76,1065,"10.4"
"11861","Z47408",10771,1059,162,897," 8.3"
"11862","Z47420",67,35,0,35,"52.2"
"11863","Z47421",12822,1557,191,1366,"10.7"
"11864","Z47424",4373,774,195,579,"13.2"
"11865","Z47427",516,76,49,27," 5.2"
"11866","Z47429",3773,223,48,175," 4.6"
"11867","Z47432",2199,263,129,134," 6.1"
"11868","Z47433",1787,239,12,227,"12.7"
"11869","Z47438",2303,477,59,418,"18.2"
"11870","Z47441",4278,587,77,510,"11.9"
"11871","Z47443",562,81,21,60,"10.7"
"11872","Z47446",4757,440,30,410," 8.6"
"11873","Z47448",4133,1007,546,461,"11.2"
"11874","Z47451",526,50,15,35," 6.7"
"11875","Z47452",2096,264,44,220,"10.5"
"11876","Z47454",3635,596,395,201," 5.5"
"11877","Z47456",554,82,0,82,"14.8"
"11878","Z47459",1719,219,71,148," 8.6"
"11879","Z47460",5019,522,147,375," 7.5"
"11880","Z47462",1826,94,57,37," 2.0"
"11881","Z47465",293,33,7,26," 8.9"
"11882","Z47468",815,331,282,49," 6.0"
"11883","Z47469",886,164,43,121,"13.7"
"11884","Z47471",1081,152,0,152,"14.1"
"11885","Z47501",7438,704,37,667," 9.0"
"11886","Z47512",1976,418,23,395,"20.0"
"11887","Z47515",427,86,66,20," 4.7"
"11888","Z47516",624,81,0,81,"13.0"
"11889","Z47520",1585,323,89,234,"14.8"
"11890","Z47521",278,29,0,29,"10.4"
"11891","Z47522",141,32,0,32,"22.7"
"11892","Z47523",1452,166,36,130," 9.0"
"11893","Z47524",209,54,17,37,"17.7"
"11894","Z47527",840,71,0,71," 8.5"
"11895","Z47528",296,96,3,93,"31.4"
"11896","Z47529",532,85,6,79,"14.8"
"11897","Z47531",370,25,0,25," 6.8"
"11898","Z47532",1866,54,0,54," 2.9"
"11899","Z47535",249,68,0,68,"27.3"
"11900","Z47537",327,14,0,14," 4.3"
"11901","Z47541",539,22,6,16," 3.0"
"11902","Z47542",3712,192,0,192," 5.2"
"11903","Z47546",9117,946,213,733," 8.0"
"11904","Z47550",336,43,0,43,"12.8"
"11905","Z47553",3429,196,54,142," 4.1"
"11906","Z47557",633,61,0,61," 9.6"
"11907","Z47558",1310,60,1,59," 4.5"
"11908","Z47562",1685,81,8,73," 4.3"
"11909","Z47567",2527,245,29,216," 8.5"
"11910","Z47568",349,28,0,28," 8.0"
"11911","Z47575",460,7,0,7," 1.5"
"11912","Z47578",363,61,15,46,"12.7"
"11913","Z47579",1095,104,60,44," 4.0"
"11914","Z47581",1935,336,161,175," 9.0"
"11915","Z47586",5182,625,159,466," 9.0"
"11916","Z47588",335,62,1,61,"18.2"
"11917","Z47590",381,118,24,94,"24.7"
"11918","Z47591",11557,1186,35,1151,"10.0"
"11919","Z47598",1524,190,2,188,"12.3"
"11920","Z47601",6257,705,49,656,"10.5"
"11921","Z47610",2192,252,26,226,"10.3"
"11922","Z47611",594,108,2,106,"17.8"
"11923","Z47613",1141,118,0,118,"10.3"
"11924","Z47615",681,140,5,135,"19.8"
"11925","Z47619",679,74,13,61," 9.0"
"11926","Z47620",5732,687,25,662,"11.5"
"11927","Z47630",13849,657,0,657," 4.7"
"11928","Z47631",881,189,71,118,"13.4"
"11929","Z47633",1304,81,0,81," 6.2"
"11930","Z47634",1025,139,0,139,"13.6"
"11931","Z47635",2532,268,31,237," 9.4"
"11932","Z47637",562,57,0,57,"10.1"
"11933","Z47638",1605,84,0,84," 5.2"
"11934","Z47639",1639,163,7,156," 9.5"
"11935","Z47640",450,59,8,51,"11.3"
"11936","Z47648",1946,125,8,117," 6.0"
"11937","Z47660",2277,235,0,235,"10.3"
"11938","Z47665",1421,152,0,152,"10.7"
"11939","Z47666",820,158,37,121,"14.8"
"11940","Z47670",5414,628,0,628,"11.6"
"11941","Z47708",261,62,29,33,"12.6"
"11942","Z47710",9451,1388,25,1363,"14.4"
"11943","Z47711",14423,1552,67,1485,"10.3"
"11944","Z47712",11388,966,59,907," 8.0"
"11945","Z47713",6036,1457,0,1457,"24.1"
"11946","Z47714",15297,1782,64,1718,"11.2"
"11947","Z47715",13772,1043,145,898," 6.5"
"11948","Z47720",7737,692,0,692," 8.9"
"11949","Z47725",6247,239,30,209," 3.3"
"11950","Z47802",14653,1609,129,1480,"10.1"
"11951","Z47803",9395,1279,291,988,"10.5"
"11952","Z47804",5322,785,47,738,"13.9"
"11953","Z47805",5398,641,32,609,"11.3"
"11954","Z47807",6185,1141,34,1107,"17.9"
"11955","Z47832",429,30,2,28," 6.5"
"11956","Z47833",557,46,13,33," 5.9"
"11957","Z47834",8688,1105,302,803," 9.2"
"11958","Z47837",516,66,6,60,"11.6"
"11959","Z47840",809,126,45,81,"10.0"
"11960","Z47841",962,155,60,95," 9.9"
"11961","Z47842",4751,586,44,542,"11.4"
"11962","Z47846",241,42,0,42,"17.4"
"11963","Z47847",458,79,25,54,"11.8"
"11964","Z47848",855,150,62,88,"10.3"
"11965","Z47850",1144,163,32,131,"11.5"
"11966","Z47855",198,62,0,62,"31.3"
"11967","Z47857",195,17,0,17," 8.7"
"11968","Z47859",463,60,5,55,"11.9"
"11969","Z47862",685,137,0,137,"20.0"
"11970","Z47868",1576,369,203,166,"10.5"
"11971","Z47871",86,12,0,12,"14.0"
"11972","Z47872",3920,1189,885,304," 7.8"
"11973","Z47874",1609,185,0,185,"11.5"
"11974","Z47879",1640,198,0,198,"12.1"
"11975","Z47882",3838,507,56,451,"11.8"
"11976","Z47885",3846,367,15,352," 9.2"
"11977","Z47901",2329,370,0,370,"15.9"
"11978","Z47904",7536,624,0,624," 8.3"
"11979","Z47905",17894,898,37,861," 4.8"
"11980","Z47906",24876,2085,102,1983," 8.0"
"11981","Z47909",17160,1138,16,1122," 6.5"
"11982","Z47918",2744,303,72,231," 8.4"
"11983","Z47920",889,44,3,41," 4.6"
"11984","Z47922",668,138,17,121,"18.1"
"11985","Z47923",1489,147,21,126," 8.5"
"11986","Z47926",358,14,0,14," 3.9"
"11987","Z47928",909,105,0,105,"11.6"
"11988","Z47932",2293,186,25,161," 7.0"
"11989","Z47933",12241,1335,206,1129," 9.2"
"11990","Z47940",595,98,6,92,"15.5"
"11991","Z47942",336,32,0,32," 9.5"
"11992","Z47943",389,28,0,28," 7.2"
"11993","Z47944",1578,203,34,169,"10.7"
"11994","Z47946",872,66,32,34," 3.9"
"11995","Z47948",669,121,0,121,"18.1"
"11996","Z47949",704,82,0,82,"11.6"
"11997","Z47950",364,73,0,73,"20.1"
"11998","Z47951",989,75,7,68," 6.9"
"11999","Z47952",1555,375,106,269,"17.3"
"12000","Z47954",1002,101,0,101,"10.1"
"12001","Z47955",461,89,0,89,"19.3"
"12002","Z47959",1407,355,268,87," 6.2"
"12003","Z47960",9904,3664,2453,1211,"12.2"
"12004","Z47963",878,126,9,117,"13.3"
"12005","Z47965",217,14,0,14," 6.5"
"12006","Z47967",309,48,0,48,"15.5"
"12007","Z47968",356,72,0,72,"20.2"
"12008","Z47970",906,73,8,65," 7.2"
"12009","Z47971",853,79,6,73," 8.6"
"12010","Z47974",583,105,3,102,"17.5"
"12011","Z47977",872,86,0,86," 9.9"
"12012","Z47978",4473,378,45,333," 7.4"
"12013","Z47980",464,36,0,36," 7.8"
"12014","Z47987",1592,48,8,40," 2.5"
"12015","Z47989",606,86,28,58," 9.6"
"12016","Z47990",749,55,9,46," 6.1"
"12017","Z47991",507,25,0,25," 4.9"
"12018","Z47992",636,56,0,56," 8.8"
"12019","Z47993",1655,168,59,109," 6.6"
"12020","Z47994",205,41,4,37,"18.0"
"12021","Z47995",634,40,6,34," 5.4"
"12022","Z48001",6295,984,590,394," 6.3"
"12023","Z48002",1348,115,6,109," 8.1"
"12024","Z48003",2314,90,13,77," 3.3"
"12025","Z48005",2047,67,20,47," 2.3"
"12026","Z48006",1521,44,6,38," 2.5"
"12027","Z48009",9529,694,246,448," 4.7"
"12028","Z48014",1638,140,0,140," 8.5"
"12029","Z48015",4032,338,0,338," 8.4"
"12030","Z48017",5734,262,0,262," 4.6"
"12031","Z48021",13572,1314,0,1314," 9.7"
"12032","Z48022",979,46,14,32," 3.3"
"12033","Z48023",2255,280,66,214," 9.5"
"12034","Z48025",5976,270,74,196," 3.3"
"12035","Z48026",6609,428,38,390," 5.9"
"12036","Z48027",1360,79,12,67," 4.9"
"12037","Z48028",1500,950,896,54," 3.6"
"12038","Z48030",7948,990,7,983,"12.4"
"12039","Z48033",8534,933,26,907,"10.6"
"12040","Z48034",8196,1104,58,1046,"12.8"
"12041","Z48035",15658,1142,25,1117," 7.1"
"12042","Z48036",9960,722,26,696," 7.0"
"12043","Z48038",20206,1150,0,1150," 5.7"
"12044","Z48039",3509,340,81,259," 7.4"
"12045","Z48040",4459,251,40,211," 4.7"
"12046","Z48042",9875,214,38,176," 1.8"
"12047","Z48043",7574,938,65,873,"11.5"
"12048","Z48044",18704,376,64,312," 1.7"
"12049","Z48045",12221,1135,126,1009," 8.3"
"12050","Z48047",16012,750,167,583," 3.6"
"12051","Z48048",2697,244,53,191," 7.1"
"12052","Z48049",2221,138,8,130," 5.9"
"12053","Z48050",746,24,0,24," 3.2"
"12054","Z48051",6465,494,15,479," 7.4"
"12055","Z48054",3077,247,47,200," 6.5"
"12056","Z48059",7071,1015,358,657," 9.3"
"12057","Z48060",18154,1820,118,1702," 9.4"
"12058","Z48062",3838,334,20,314," 8.2"
"12059","Z48063",1617,167,14,153," 9.5"
"12060","Z48064",1515,112,0,112," 7.4"
"12061","Z48065",4233,281,39,242," 5.7"
"12062","Z48066",21398,1579,96,1483," 6.9"
"12063","Z48067",12858,545,56,489," 3.8"
"12064","Z48069",1154,45,0,45," 3.9"
"12065","Z48070",2548,91,5,86," 3.4"
"12066","Z48071",13735,880,144,736," 5.4"
"12067","Z48072",6996,423,25,398," 5.7"
"12068","Z48073",17324,1257,246,1011," 5.8"
"12069","Z48074",3985,320,105,215," 5.4"
"12070","Z48075",10210,1051,48,1003," 9.8"
"12071","Z48076",10612,678,17,661," 6.2"
"12072","Z48079",5234,370,70,300," 5.7"
"12073","Z48080",11426,774,117,657," 5.8"
"12074","Z48081",9414,461,58,403," 4.3"
"12075","Z48082",7641,465,58,407," 5.3"
"12076","Z48083",9493,432,106,326," 3.4"
"12077","Z48084",6954,558,147,411," 5.9"
"12078","Z48085",8695,401,79,322," 3.7"
"12079","Z48088",9992,617,35,582," 5.8"
"12080","Z48089",13852,1977,30,1947,"14.1"
"12081","Z48091",13627,1778,99,1679,"12.3"
"12082","Z48092",11191,679,61,618," 5.5"
"12083","Z48093",10646,764,91,673," 6.3"
"12084","Z48094",7314,502,129,373," 5.1"
"12085","Z48095",1976,123,54,69," 3.5"
"12086","Z48096",1631,75,0,75," 4.6"
"12087","Z48097",2183,234,22,212," 9.7"
"12088","Z48098",7366,305,94,211," 2.9"
"12089","Z48101",11342,762,29,733," 6.5"
"12090","Z48103",24188,1253,87,1166," 4.8"
"12091","Z48104",16832,1311,121,1190," 7.1"
"12092","Z48105",15782,810,36,774," 4.9"
"12093","Z48108",11349,446,58,388," 3.4"
"12094","Z48111",18457,1964,230,1734," 9.4"
"12095","Z48114",8024,404,87,317," 4.0"
"12096","Z48116",11591,825,160,665," 5.7"
"12097","Z48117",4087,389,4,385," 9.4"
"12098","Z48118",5565,369,163,206," 3.7"
"12099","Z48120",2620,356,43,313,"11.9"
"12100","Z48122",4544,408,0,408," 9.0"
"12101","Z48124",13600,1121,69,1052," 7.7"
"12102","Z48125",8538,987,45,942,"11.0"
"12103","Z48126",14515,1732,49,1683,"11.6"
"12104","Z48127",13721,626,13,613," 4.5"
"12105","Z48128",4139,163,0,163," 3.9"
"12106","Z48130",5861,372,132,240," 4.1"
"12107","Z48131",3116,232,0,232," 7.4"
"12108","Z48133",2417,150,0,150," 6.2"
"12109","Z48134",8322,694,14,680," 8.2"
"12110","Z48135",11166,846,82,764," 6.8"
"12111","Z48137",2381,521,389,132," 5.5"
"12112","Z48138",4279,244,38,206," 4.8"
"12113","Z48140",1293,36,0,36," 2.8"
"12114","Z48141",11371,1920,118,1802,"15.8"
"12115","Z48144",4191,232,0,232," 5.5"
"12116","Z48145",1432,144,5,139," 9.7"
"12117","Z48146",16053,1687,43,1644,"10.2"
"12118","Z48150",11008,657,26,631," 5.7"
"12119","Z48152",13121,771,77,694," 5.3"
"12120","Z48154",15117,619,63,556," 3.7"
"12121","Z48157",744,92,12,80,"10.8"
"12122","Z48158",3251,319,71,248," 7.6"
"12123","Z48159",955,24,0,24," 2.5"
"12124","Z48160",4921,426,0,426," 8.7"
"12125","Z48161",11407,1214,53,1161,"10.2"
"12126","Z48162",12176,805,39,766," 6.3"
"12127","Z48164",3218,125,0,125," 3.9"
"12128","Z48165",2738,143,12,131," 4.8"
"12129","Z48166",4563,463,85,378," 8.3"
"12130","Z48167",9677,575,43,532," 5.5"
"12131","Z48168",8275,444,37,407," 4.9"
"12132","Z48169",9254,1282,904,378," 4.1"
"12133","Z48170",17080,936,127,809," 4.7"
"12134","Z48173",5263,653,144,509," 9.7"
"12135","Z48174",12310,1003,103,900," 7.3"
"12136","Z48176",8518,395,59,336," 3.9"
"12137","Z48178",12793,861,252,609," 4.8"
"12138","Z48179",1348,37,0,37," 2.7"
"12139","Z48180",25922,2180,129,2051," 7.9"
"12140","Z48182",8999,416,0,416," 4.6"
"12141","Z48183",18347,961,46,915," 5.0"
"12142","Z48184",7620,828,48,780,"10.2"
"12143","Z48185",22392,1568,57,1511," 6.7"
"12144","Z48186",14364,1465,0,1465,"10.2"
"12145","Z48187",18282,911,51,860," 4.7"
"12146","Z48188",15027,893,26,867," 5.8"
"12147","Z48189",6101,635,157,478," 7.8"
"12148","Z48191",1414,109,0,109," 7.7"
"12149","Z48192",11750,1125,117,1008," 8.6"
"12150","Z48193",6528,572,27,545," 8.3"
"12151","Z48195",13435,936,143,793," 5.9"
"12152","Z48197",27166,2201,54,2147," 7.9"
"12153","Z48198",17781,1895,37,1858,"10.4"
"12154","Z48201",9603,2315,91,2224,"23.2"
"12155","Z48202",11021,3576,126,3450,"31.3"
"12156","Z48203",16855,6966,16,6950,"41.2"
"12157","Z48204",16165,6682,174,6508,"40.3"
"12158","Z48205",19008,6121,56,6065,"31.9"
"12159","Z48206",13658,6965,28,6937,"50.8"
"12160","Z48207",13547,2284,43,2241,"16.5"
"12161","Z48208",6063,2096,13,2083,"34.4"
"12162","Z48209",13301,3103,36,3067,"23.1"
"12163","Z48210",13435,4165,24,4141,"30.8"
"12164","Z48211",3271,1136,0,1136,"34.7"
"12165","Z48212",15524,4364,50,4314,"27.8"
"12166","Z48213",14120,5358,7,5351,"37.9"
"12167","Z48214",14098,4607,46,4561,"32.4"
"12168","Z48216",2977,691,16,675,"22.7"
"12169","Z48217",3938,973,0,973,"24.7"
"12170","Z48218",3826,1057,9,1048,"27.4"
"12171","Z48219",23654,5343,0,5343,"22.6"
"12172","Z48220",11736,1205,108,1097," 9.3"
"12173","Z48221",18297,3883,43,3840,"21.0"
"12174","Z48223",12571,3436,0,3436,"27.3"
"12175","Z48224",19721,5497,50,5447,"27.6"
"12176","Z48225",6331,832,44,788,"12.4"
"12177","Z48226",4468,886,109,777,"17.4"
"12178","Z48227",22019,7276,218,7058,"32.1"
"12179","Z48228",25585,7043,92,6951,"27.2"
"12180","Z48229",4557,1084,11,1073,"23.5"
"12181","Z48230",7143,685,139,546," 7.6"
"12182","Z48234",16720,4580,17,4563,"27.3"
"12183","Z48235",21310,4016,84,3932,"18.5"
"12184","Z48236",12456,938,175,763," 6.1"
"12185","Z48237",12782,1288,156,1132," 8.9"
"12186","Z48238",18540,7476,611,6865,"37.0"
"12187","Z48239",14625,1116,33,1083," 7.4"
"12188","Z48240",7375,820,10,810,"11.0"
"12189","Z48301",5858,346,104,242," 4.1"
"12190","Z48302",6829,587,133,454," 6.6"
"12191","Z48304",7002,591,231,360," 5.1"
"12192","Z48306",10034,207,58,149," 1.5"
"12193","Z48307",18657,1264,231,1033," 5.5"
"12194","Z48309",11393,633,190,443," 3.9"
"12195","Z48310",15497,669,29,640," 4.1"
"12196","Z48312",13667,515,8,507," 3.7"
"12197","Z48313",14012,922,35,887," 6.3"
"12198","Z48314",8456,130,0,130," 1.5"
"12199","Z48315",10679,579,39,540," 5.1"
"12200","Z48316",10604,389,69,320," 3.0"
"12201","Z48317",11952,564,90,474," 4.0"
"12202","Z48320",2313,184,45,139," 6.0"
"12203","Z48322",12979,750,121,629," 4.8"
"12204","Z48323",6888,416,83,333," 4.8"
"12205","Z48324",6713,387,123,264," 3.9"
"12206","Z48326",9978,871,48,823," 8.2"
"12207","Z48327",10293,781,164,617," 6.0"
"12208","Z48328",11770,856,129,727," 6.2"
"12209","Z48329",10592,911,192,719," 6.8"
"12210","Z48331",8868,381,58,323," 3.6"
"12211","Z48334",8637,687,108,579," 6.7"
"12212","Z48335",11393,858,9,849," 7.5"
"12213","Z48336",11668,797,24,773," 6.6"
"12214","Z48340",11298,1282,21,1261,"11.2"
"12215","Z48341",8021,1235,0,1235,"15.4"
"12216","Z48342",8631,1727,13,1714,"19.9"
"12217","Z48346",9617,473,152,321," 3.3"
"12218","Z48348",8756,462,71,391," 4.5"
"12219","Z48350",2842,217,125,92," 3.2"
"12220","Z48353",2556,193,93,100," 3.9"
"12221","Z48356",3598,359,199,160," 4.4"
"12222","Z48357",3345,276,56,220," 6.6"
"12223","Z48359",3484,272,11,261," 7.5"
"12224","Z48360",4419,160,24,136," 3.1"
"12225","Z48362",6275,544,238,306," 4.9"
"12226","Z48363",2006,69,14,55," 2.7"
"12227","Z48367",1756,116,93,23," 1.3"
"12228","Z48371",9148,536,160,376," 4.1"
"12229","Z48374",4946,97,33,64," 1.3"
"12230","Z48375",9353,479,0,479," 5.1"
"12231","Z48377",8229,567,54,513," 6.2"
"12232","Z48381",5384,219,28,191," 3.5"
"12233","Z48382",8149,285,26,259," 3.2"
"12234","Z48383",5027,276,20,256," 5.1"
"12235","Z48386",7590,705,115,590," 7.8"
"12236","Z48390",10500,548,43,505," 4.8"
"12237","Z48393",7546,372,40,332," 4.4"
"12238","Z48401",805,212,120,92,"11.4"
"12239","Z48412",2529,368,150,218," 8.6"
"12240","Z48413",3385,464,126,338,"10.0"
"12241","Z48414",1148,124,27,97," 8.4"
"12242","Z48415",3809,210,3,207," 5.4"
"12243","Z48416",1984,201,40,161," 8.1"
"12244","Z48417",1133,78,14,64," 5.6"
"12245","Z48418",1687,153,77,76," 4.5"
"12246","Z48419",1460,435,312,123," 8.4"
"12247","Z48420",9220,714,134,580," 6.3"
"12248","Z48422",3062,559,64,495,"16.2"
"12249","Z48423",14134,801,93,708," 5.0"
"12250","Z48426",477,102,33,69,"14.5"
"12251","Z48427",1632,533,352,181,"11.1"
"12252","Z48428",1963,138,76,62," 3.2"
"12253","Z48429",3952,622,265,357," 9.0"
"12254","Z48430",15088,927,410,517," 3.4"
"12255","Z48433",10834,607,78,529," 4.9"
"12256","Z48435",816,76,15,61," 7.5"
"12257","Z48437",297,34,12,22," 7.4"
"12258","Z48438",2757,162,85,77," 2.8"
"12259","Z48439",20118,1341,150,1191," 5.9"
"12260","Z48441",2423,771,553,218," 9.0"
"12261","Z48442",8655,632,229,403," 4.7"
"12262","Z48444",3630,327,18,309," 8.5"
"12263","Z48445",646,104,50,54," 8.4"
"12264","Z48446",12866,1143,244,899," 7.0"
"12265","Z48449",1251,141,0,141,"11.3"
"12266","Z48450",4413,2290,1971,319," 7.2"
"12267","Z48451",5686,361,169,192," 3.4"
"12268","Z48453",2150,354,35,319,"14.8"
"12269","Z48454",533,85,22,63,"11.8"
"12270","Z48455",3333,286,119,167," 5.0"
"12271","Z48456",445,111,47,64,"14.4"
"12272","Z48457",3282,300,0,300," 9.1"
"12273","Z48458",9488,1423,33,1390,"14.7"
"12274","Z48460",896,58,0,58," 6.5"
"12275","Z48461",3364,384,0,384,"11.4"
"12276","Z48462",4982,262,77,185," 3.7"
"12277","Z48463",1937,49,0,49," 2.5"
"12278","Z48464",941,170,89,81," 8.6"
"12279","Z48466",654,75,12,63," 9.6"
"12280","Z48468",1177,551,475,76," 6.5"
"12281","Z48469",1088,578,481,97," 8.9"
"12282","Z48470",364,45,21,24," 6.6"
"12283","Z48471",2315,202,17,185," 8.0"
"12284","Z48472",782,150,33,117,"15.0"
"12285","Z48473",9220,682,15,667," 7.2"
"12286","Z48475",1206,230,108,122,"10.1"
"12287","Z48476",317,37,0,37,"11.7"
"12288","Z48502",348,163,0,163,"46.8"
"12289","Z48503",14357,3169,42,3127,"21.8"
"12290","Z48504",14850,3703,18,3685,"24.8"
"12291","Z48505",13032,4442,34,4408,"33.8"
"12292","Z48506",13705,2230,44,2186,"16.0"
"12293","Z48507",15520,2462,29,2433,"15.7"
"12294","Z48509",3952,244,74,170," 4.3"
"12295","Z48519",3332,239,24,215," 6.5"
"12296","Z48529",4433,740,0,740,"16.7"
"12297","Z48532",9368,1221,90,1131,"12.1"
"12298","Z48601",17526,2989,59,2930,"16.7"
"12299","Z48602",13931,2341,31,2310,"16.6"
"12300","Z48603",12417,567,75,492," 4.0"
"12301","Z48604",4532,311,7,304," 6.7"
"12302","Z48607",1090,473,0,473,"43.4"
"12303","Z48609",5212,279,0,279," 5.4"
"12304","Z48610",2690,1362,1228,134," 5.0"
"12305","Z48611",2857,224,0,224," 7.8"
"12306","Z48612",5699,1787,1521,266," 4.7"
"12307","Z48613",500,52,20,32," 6.4"
"12308","Z48614",634,91,25,66,"10.4"
"12309","Z48615",1370,138,45,93," 6.8"
"12310","Z48616",3219,283,25,258," 8.0"
"12311","Z48617",3959,502,252,250," 6.3"
"12312","Z48618",2481,257,111,146," 5.9"
"12313","Z48619",588,357,323,34," 5.8"
"12314","Z48621",829,307,255,52," 6.3"
"12315","Z48622",3545,1024,838,186," 5.2"
"12316","Z48623",5005,213,9,204," 4.1"
"12317","Z48624",11477,4663,4293,370," 3.2"
"12318","Z48625",11515,5624,5149,475," 4.1"
"12319","Z48626",2388,80,6,74," 3.1"
"12320","Z48628",1219,391,332,59," 4.8"
"12321","Z48629",7536,3922,3505,417," 5.5"
"12322","Z48631",1838,128,17,111," 6.0"
"12323","Z48634",1968,127,6,121," 6.1"
"12324","Z48635",1909,1153,1061,92," 4.8"
"12325","Z48637",1418,113,3,110," 7.8"
"12326","Z48638",6121,392,83,309," 5.0"
"12327","Z48640",13984,822,352,470," 3.4"
"12328","Z48642",13673,755,242,513," 3.8"
"12329","Z48647",3748,2063,1941,122," 3.3"
"12330","Z48649",606,38,4,34," 5.6"
"12331","Z48650",3117,348,73,275," 8.8"
"12332","Z48651",4317,1853,1469,384," 8.9"
"12333","Z48652",728,81,68,13," 1.8"
"12334","Z48653",10067,5534,5118,416," 4.1"
"12335","Z48654",2002,1010,898,112," 5.6"
"12336","Z48655",2579,122,15,107," 4.1"
"12337","Z48656",4035,2119,1834,285," 7.1"
"12338","Z48657",3609,326,285,41," 1.1"
"12339","Z48658",2485,443,345,98," 3.9"
"12340","Z48659",1375,302,256,46," 3.3"
"12341","Z48661",6607,2051,1640,411," 6.2"
"12342","Z48662",609,40,17,23," 3.8"
"12343","Z48701",696,130,52,78,"11.2"
"12344","Z48703",2849,1409,1302,107," 3.8"
"12345","Z48705",749,494,436,58," 7.7"
"12346","Z48706",17993,1593,199,1394," 7.7"
"12347","Z48708",12599,1452,209,1243," 9.9"
"12348","Z48720",612,165,106,59," 9.6"
"12349","Z48721",432,224,207,17," 3.9"
"12350","Z48722",1535,125,32,93," 6.1"
"12351","Z48723",5525,655,79,576,"10.4"
"12352","Z48725",2915,1763,1620,143," 4.9"
"12353","Z48726",2657,377,90,287,"10.8"
"12354","Z48727",520,67,11,56,"10.8"
"12355","Z48728",691,522,477,45," 6.5"
"12356","Z48730",3257,1268,965,303," 9.3"
"12357","Z48732",5335,478,0,478," 9.0"
"12358","Z48733",812,73,20,53," 6.5"
"12359","Z48734",3474,268,90,178," 5.1"
"12360","Z48735",482,59,6,53,"11.0"
"12361","Z48737",1471,886,820,66," 4.5"
"12362","Z48738",1497,833,754,79," 5.3"
"12363","Z48739",4371,2532,2232,300," 6.9"
"12364","Z48740",1765,667,529,138," 7.8"
"12365","Z48741",875,113,59,54," 6.2"
"12366","Z48742",1424,674,577,97," 6.8"
"12367","Z48744",2082,259,60,199," 9.6"
"12368","Z48745",862,315,245,70," 8.1"
"12369","Z48746",3515,312,62,250," 7.1"
"12370","Z48747",622,29,6,23," 3.7"
"12371","Z48750",7045,3030,2607,423," 6.0"
"12372","Z48755",2266,858,730,128," 5.6"
"12373","Z48756",3339,1300,1026,274," 8.2"
"12374","Z48757",1699,129,19,110," 6.5"
"12375","Z48759",1795,425,195,230,"12.8"
"12376","Z48760",741,241,183,58," 7.8"
"12377","Z48761",1585,1086,1013,73," 4.6"
"12378","Z48762",1039,539,460,79," 7.6"
"12379","Z48763",3078,1028,833,195," 6.3"
"12380","Z48767",924,147,81,66," 7.1"
"12381","Z48768",3994,377,74,303," 7.6"
"12382","Z48770",1147,385,245,140,"12.2"
"12383","Z48801",5213,365,75,290," 5.6"
"12384","Z48807",366,57,10,47,"12.8"
"12385","Z48808",2514,258,37,221," 8.8"
"12386","Z48809",4451,471,141,330," 7.4"
"12387","Z48811",1354,118,29,89," 6.6"
"12388","Z48813",8841,779,27,752," 8.5"
"12389","Z48815",1049,205,82,123,"11.7"
"12390","Z48817",2581,89,0,89," 3.4"
"12391","Z48818",1654,661,519,142," 8.6"
"12392","Z48819",976,51,0,51," 5.2"
"12393","Z48820",6684,215,62,153," 2.3"
"12394","Z48821",2593,225,35,190," 7.3"
"12395","Z48822",1166,105,17,88," 7.5"
"12396","Z48823",21987,1879,61,1818," 8.3"
"12397","Z48827",6290,453,22,431," 6.9"
"12398","Z48829",1422,196,116,80," 5.6"
"12399","Z48831",1424,111,11,100," 7.0"
"12400","Z48832",565,63,0,63,"11.2"
"12401","Z48834",927,136,80,56," 6.0"
"12402","Z48835",997,44,3,41," 4.1"
"12403","Z48836",5308,431,86,345," 6.5"
"12404","Z48837",8227,419,45,374," 4.5"
"12405","Z48838",7853,950,269,681," 8.7"
"12406","Z48840",6108,292,56,236," 3.9"
"12407","Z48841",356,23,0,23," 6.5"
"12408","Z48842",8918,290,0,290," 3.3"
"12409","Z48843",17481,1112,206,906," 5.2"
"12410","Z48846",6698,707,120,587," 8.8"
"12411","Z48847",2680,253,49,204," 7.6"
"12412","Z48848",3045,215,41,174," 5.7"
"12413","Z48849",2526,327,139,188," 7.4"
"12414","Z48850",2019,468,354,114," 5.6"
"12415","Z48851",1033,128,6,122,"11.8"
"12416","Z48854",7580,571,66,505," 6.7"
"12417","Z48855",5705,200,88,112," 2.0"
"12418","Z48857",1056,94,20,74," 7.0"
"12419","Z48858",19137,2152,247,1905,"10.0"
"12420","Z48860",576,44,15,29," 5.0"
"12421","Z48861",717,92,0,92,"12.8"
"12422","Z48864",8931,375,89,286," 3.2"
"12423","Z48865",881,212,70,142,"16.1"
"12424","Z48866",1868,98,11,87," 4.7"
"12425","Z48867",12286,1112,38,1074," 8.7"
"12426","Z48871",885,141,27,114,"12.9"
"12427","Z48872",3061,187,4,183," 6.0"
"12428","Z48873",665,40,4,36," 5.4"
"12429","Z48875",4057,290,31,259," 6.4"
"12430","Z48877",1115,146,30,116,"10.4"
"12431","Z48878",656,75,0,75,"11.4"
"12432","Z48879",7358,446,37,409," 5.6"
"12433","Z48880",2815,336,47,289,"10.3"
"12434","Z48881",2242,136,8,128," 5.7"
"12435","Z48883",3025,264,64,200," 6.6"
"12436","Z48884",1954,205,129,76," 3.9"
"12437","Z48885",367,13,0,13," 3.5"
"12438","Z48886",1310,431,388,43," 3.3"
"12439","Z48888",3116,598,432,166," 5.3"
"12440","Z48889",548,29,9,20," 3.6"
"12441","Z48890",909,101,0,101,"11.1"
"12442","Z48891",1296,201,110,91," 7.0"
"12443","Z48892",1731,91,11,80," 4.6"
"12444","Z48893",2674,608,497,111," 4.2"
"12445","Z48894",681,29,0,29," 4.3"
"12446","Z48895",4860,417,47,370," 7.6"
"12447","Z48906",11789,1229,71,1158," 9.8"
"12448","Z48910",17664,2095,163,1932,"10.9"
"12449","Z48911",17794,2081,55,2026,"11.4"
"12450","Z48912",8486,846,0,846,"10.0"
"12451","Z48915",4307,880,21,859,"19.9"
"12452","Z48917",15473,939,73,866," 5.6"
"12453","Z48933",2076,336,0,336,"16.2"
"12454","Z49001",10061,1333,106,1227,"12.2"
"12455","Z49002",8709,369,99,270," 3.1"
"12456","Z49004",6887,820,42,778,"11.3"
"12457","Z49006",11147,1152,13,1139,"10.2"
"12458","Z49007",5360,959,103,856,"16.0"
"12459","Z49008",7068,549,103,446," 6.3"
"12460","Z49009",19404,1433,397,1036," 5.3"
"12461","Z49010",7942,1075,654,421," 5.3"
"12462","Z49011",905,112,3,109,"12.0"
"12463","Z49012",1465,155,132,23," 1.6"
"12464","Z49013",2398,503,273,230," 9.6"
"12465","Z49014",9228,1167,183,984,"10.7"
"12466","Z49015",12237,1347,58,1289,"10.5"
"12467","Z49017",9956,1399,137,1262,"12.7"
"12468","Z49022",14927,2407,443,1964,"13.2"
"12469","Z49024",12142,538,88,450," 3.7"
"12470","Z49026",1418,440,298,142,"10.0"
"12471","Z49028",2958,585,345,240," 8.1"
"12472","Z49029",606,41,9,32," 5.3"
"12473","Z49030",1074,244,138,106," 9.9"
"12474","Z49031",4136,1114,850,264," 6.4"
"12475","Z49032",1263,121,10,111," 8.8"
"12476","Z49033",719,80,20,60," 8.3"
"12477","Z49034",1063,86,27,59," 5.6"
"12478","Z49036",11410,2930,1942,988," 8.7"
"12479","Z49037",10581,1564,34,1530,"14.5"
"12480","Z49038",5258,1584,1062,522," 9.9"
"12481","Z49040",1913,543,425,118," 6.2"
"12482","Z49042",2034,171,8,163," 8.0"
"12483","Z49045",2634,601,333,268,"10.2"
"12484","Z49046",4121,1051,697,354," 8.6"
"12485","Z49047",8467,2763,1789,974,"11.5"
"12486","Z49048",11077,994,21,973," 8.8"
"12487","Z49050",680,42,0,42," 6.2"
"12488","Z49052",383,23,0,23," 6.0"
"12489","Z49053",2742,193,9,184," 6.7"
"12490","Z49055",2994,662,453,209," 7.0"
"12491","Z49056",2063,735,433,302,"14.6"
"12492","Z49057",2645,349,46,303,"11.5"
"12493","Z49058",8347,822,252,570," 6.8"
"12494","Z49061",729,102,64,38," 5.2"
"12495","Z49064",1856,465,219,246,"13.3"
"12496","Z49065",3028,643,518,125," 4.1"
"12497","Z49066",273,23,0,23," 8.4"
"12498","Z49067",1990,426,220,206,"10.4"
"12499","Z49068",6542,643,68,575," 8.8"
"12500","Z49070",965,32,4,28," 2.9"
"12501","Z49071",3539,221,62,159," 4.5"
"12502","Z49072",1438,213,20,193,"13.4"
"12503","Z49073",2027,263,133,130," 6.4"
"12504","Z49076",1538,193,62,131," 8.5"
"12505","Z49079",5871,874,365,509," 8.7"
"12506","Z49080",6644,689,296,393," 5.9"
"12507","Z49082",2996,688,472,216," 7.2"
"12508","Z49083",3139,386,155,231," 7.4"
"12509","Z49085",11031,1213,429,784," 7.1"
"12510","Z49087",2448,146,22,124," 5.1"
"12511","Z49088",1381,185,123,62," 4.5"
"12512","Z49089",832,201,89,112,"13.5"
"12513","Z49090",8703,2924,2101,823," 9.5"
"12514","Z49091",8579,1069,490,579," 6.7"
"12515","Z49092",902,95,3,92,"10.2"
"12516","Z49093",8762,1628,852,776," 8.9"
"12517","Z49094",1948,263,65,198,"10.2"
"12518","Z49095",1279,466,395,71," 5.6"
"12519","Z49096",1323,125,15,110," 8.3"
"12520","Z49097",4355,372,129,243," 5.6"
"12521","Z49098",3017,751,271,480,"15.9"
"12522","Z49099",2642,513,364,149," 5.6"
"12523","Z49101",1361,113,52,61," 4.5"
"12524","Z49103",4068,785,245,540,"13.3"
"12525","Z49106",2322,438,288,150," 6.5"
"12526","Z49107",4863,640,399,241," 5.0"
"12527","Z49111",1536,273,52,221,"14.4"
"12528","Z49112",4277,607,298,309," 7.2"
"12529","Z49113",888,159,41,118,"13.3"
"12530","Z49115",507,335,327,8," 1.6"
"12531","Z49116",663,493,417,76,"11.5"
"12532","Z49117",3791,2079,1839,240," 6.3"
"12533","Z49120",16342,1932,557,1375," 8.4"
"12534","Z49125",1649,817,691,126," 7.6"
"12535","Z49126",635,63,1,62," 9.8"
"12536","Z49127",5120,714,267,447," 8.7"
"12537","Z49128",2168,493,272,221,"10.2"
"12538","Z49129",1177,962,770,192,"16.3"
"12539","Z49130",971,218,181,37," 3.8"
"12540","Z49201",17035,1603,303,1300," 7.6"
"12541","Z49202",10119,1328,0,1328,"13.1"
"12542","Z49203",17069,1868,60,1808,"10.6"
"12543","Z49220",1005,97,73,24," 2.4"
"12544","Z49221",16247,1536,200,1336," 8.2"
"12545","Z49224",6262,1140,92,1048,"16.7"
"12546","Z49228",2410,182,38,144," 6.0"
"12547","Z49229",1280,51,10,41," 3.2"
"12548","Z49230",6222,1968,1291,677,"10.9"
"12549","Z49232",1290,372,264,108," 8.4"
"12550","Z49234",1368,346,254,92," 6.7"
"12551","Z49235",884,70,5,65," 7.4"
"12552","Z49236",1913,110,50,60," 3.1"
"12553","Z49237",1205,112,18,94," 7.8"
"12554","Z49240",3969,424,190,234," 5.9"
"12555","Z49241",983,100,6,94," 9.6"
"12556","Z49242",6480,893,338,555," 8.6"
"12557","Z49245",1957,202,6,196,"10.0"
"12558","Z49246",1452,197,171,26," 1.8"
"12559","Z49247",2747,430,168,262," 9.5"
"12560","Z49248",392,49,0,49,"12.5"
"12561","Z49249",2091,465,394,71," 3.4"
"12562","Z49250",2549,300,118,182," 7.1"
"12563","Z49251",2629,313,18,295,"11.2"
"12564","Z49252",1136,115,22,93," 8.2"
"12565","Z49253",2510,1111,1034,77," 3.1"
"12566","Z49254",1506,270,139,131," 8.7"
"12567","Z49256",1692,125,0,125," 7.4"
"12568","Z49259",1011,167,15,152,"15.0"
"12569","Z49265",2457,406,333,73," 3.0"
"12570","Z49266",1583,366,259,107," 6.8"
"12571","Z49267",1731,165,0,165," 9.5"
"12572","Z49268",428,55,8,47,"11.0"
"12573","Z49269",2726,397,41,356,"13.1"
"12574","Z49270",2235,151,0,151," 6.8"
"12575","Z49271",947,162,76,86," 9.1"
"12576","Z49272",1089,128,0,128,"11.8"
"12577","Z49274",1859,446,334,112," 6.0"
"12578","Z49277",1308,45,14,31," 2.4"
"12579","Z49279",305,44,8,36,"11.8"
"12580","Z49283",1252,38,0,38," 3.0"
"12581","Z49284",1367,226,104,122," 8.9"
"12582","Z49285",2222,149,27,122," 5.5"
"12583","Z49286",6301,302,56,246," 3.9"
"12584","Z49287",930,181,112,69," 7.4"
"12585","Z49288",591,57,11,46," 7.8"
"12586","Z49301",6680,162,71,91," 1.4"
"12587","Z49302",2927,174,71,103," 3.5"
"12588","Z49303",394,26,0,26," 6.6"
"12589","Z49304",6297,4706,4539,167," 2.7"
"12590","Z49305",1582,716,571,145," 9.2"
"12591","Z49306",3774,73,0,73," 1.9"
"12592","Z49307",7918,1106,375,731," 9.2"
"12593","Z49309",2167,1469,1291,178," 8.2"
"12594","Z49310",1193,152,94,58," 4.9"
"12595","Z49315",8054,538,14,524," 6.5"
"12596","Z49316",7917,388,190,198," 2.5"
"12597","Z49318",569,63,6,57,"10.0"
"12598","Z49319",6297,354,19,335," 5.3"
"12599","Z49321",6821,351,33,318," 4.7"
"12600","Z49322",707,214,172,42," 5.9"
"12601","Z49323",3232,116,21,95," 2.9"
"12602","Z49325",601,16,0,16," 2.7"
"12603","Z49326",1872,271,230,41," 2.2"
"12604","Z49327",3577,590,308,282," 7.9"
"12605","Z49328",1651,285,216,69," 4.2"
"12606","Z49329",3421,447,352,95," 2.8"
"12607","Z49330",1963,96,10,86," 4.4"
"12608","Z49331",6571,470,226,244," 3.7"
"12609","Z49332",2224,1007,909,98," 4.4"
"12610","Z49333",4615,655,406,249," 5.4"
"12611","Z49335",165,26,0,26,"15.8"
"12612","Z49336",1845,280,210,70," 3.8"
"12613","Z49337",6710,1750,1400,350," 5.2"
"12614","Z49338",773,153,119,34," 4.4"
"12615","Z49339",1128,257,238,19," 1.7"
"12616","Z49340",1425,249,170,79," 5.5"
"12617","Z49341",12646,709,293,416," 3.3"
"12618","Z49343",2394,364,278,86," 3.6"
"12619","Z49344",1912,489,311,178," 9.3"
"12620","Z49345",5127,250,12,238," 4.6"
"12621","Z49346",3564,1299,968,331," 9.3"
"12622","Z49348",4893,490,310,180," 3.7"
"12623","Z49349",4365,1324,1045,279," 6.4"
"12624","Z49401",5972,475,0,475," 8.0"
"12625","Z49402",1410,818,737,81," 5.7"
"12626","Z49403",980,111,38,73," 7.4"
"12627","Z49404",3399,205,45,160," 4.7"
"12628","Z49405",893,268,183,85," 9.5"
"12629","Z49406",945,548,461,87," 9.2"
"12630","Z49408",4985,1316,1094,222," 4.5"
"12631","Z49410",1683,775,680,95," 5.6"
"12632","Z49411",1042,408,344,64," 6.1"
"12633","Z49412",4702,581,322,259," 5.5"
"12634","Z49415",2738,259,8,251," 9.2"
"12635","Z49417",13541,1551,623,928," 6.9"
"12636","Z49418",10712,238,54,184," 1.7"
"12637","Z49419",2722,105,38,67," 2.5"
"12638","Z49420",2777,516,244,272," 9.8"
"12639","Z49421",3064,847,683,164," 5.4"
"12640","Z49423",17442,1470,631,839," 4.8"
"12641","Z49424",18297,1441,527,914," 5.0"
"12642","Z49425",1468,304,177,127," 8.7"
"12643","Z49426",11802,309,49,260," 2.2"
"12644","Z49428",10115,307,55,252," 2.5"
"12645","Z49431",9437,1999,1352,647," 6.9"
"12646","Z49435",1425,41,0,41," 2.9"
"12647","Z49436",2328,1636,1541,95," 4.1"
"12648","Z49437",3469,788,505,283," 8.2"
"12649","Z49440",609,110,21,89,"14.6"
"12650","Z49441",17058,1739,455,1284," 7.5"
"12651","Z49442",16570,1865,137,1728,"10.4"
"12652","Z49444",11813,1789,81,1708,"14.5"
"12653","Z49445",8763,839,229,610," 7.0"
"12654","Z49446",1162,275,170,105," 9.0"
"12655","Z49448",1432,112,0,112," 7.8"
"12656","Z49449",2803,1628,1487,141," 5.0"
"12657","Z49450",1609,528,325,203,"12.6"
"12658","Z49451",2306,225,13,212," 9.2"
"12659","Z49452",940,193,67,126,"13.4"
"12660","Z49453",1632,566,419,147," 9.0"
"12661","Z49454",2124,441,136,305,"14.4"
"12662","Z49455",2677,895,668,227," 8.5"
"12663","Z49456",9154,1334,742,592," 6.5"
"12664","Z49458",108,72,65,7," 6.5"
"12665","Z49459",876,433,288,145,"16.6"
"12666","Z49460",3247,426,195,231," 7.1"
"12667","Z49461",4015,562,350,212," 5.3"
"12668","Z49464",10041,224,32,192," 1.9"
"12669","Z49503",16497,1909,52,1857,"11.3"
"12670","Z49504",17468,1956,78,1878,"10.8"
"12671","Z49505",13921,813,93,720," 5.2"
"12672","Z49506",12592,665,66,599," 4.8"
"12673","Z49507",13761,1479,48,1431,"10.4"
"12674","Z49508",16006,428,23,405," 2.5"
"12675","Z49509",10341,542,0,542," 5.2"
"12676","Z49512",7696,550,0,550," 7.1"
"12677","Z49519",11800,268,31,237," 2.0"
"12678","Z49525",11628,425,84,341," 2.9"
"12679","Z49534",8804,221,31,190," 2.2"
"12680","Z49544",3908,187,78,109," 2.8"
"12681","Z49546",13073,759,258,501," 3.8"
"12682","Z49548",12457,1003,106,897," 7.2"
"12683","Z49601",10538,2175,1398,777," 7.4"
"12684","Z49612",904,408,371,37," 4.1"
"12685","Z49613",676,372,323,49," 7.2"
"12686","Z49614",1844,727,566,161," 8.7"
"12687","Z49615",3697,1952,1799,153," 4.1"
"12688","Z49616",1037,323,225,98," 9.5"
"12689","Z49617",2484,1071,972,99," 4.0"
"12690","Z49619",752,276,202,74," 9.8"
"12691","Z49620",1077,166,79,87," 8.1"
"12692","Z49621",1911,675,544,131," 6.9"
"12693","Z49622",1876,814,684,130," 6.9"
"12694","Z49625",807,250,195,55," 6.8"
"12695","Z49628",211,113,77,36,"17.1"
"12696","Z49629",1682,613,530,83," 4.9"
"12697","Z49630",1241,584,489,95," 7.7"
"12698","Z49631",4087,1727,1489,238," 5.8"
"12699","Z49632",841,376,333,43," 5.1"
"12700","Z49633",2684,1219,1079,140," 5.2"
"12701","Z49635",3361,1741,1512,229," 6.8"
"12702","Z49636",1291,1061,928,133,"10.3"
"12703","Z49637",1263,171,166,5," 0.4"
"12704","Z49639",1295,466,346,120," 9.3"
"12705","Z49640",1360,720,610,110," 8.1"
"12706","Z49643",3159,761,580,181," 5.7"
"12707","Z49644",3616,2768,2656,112," 3.1"
"12708","Z49645",1031,340,241,99," 9.6"
"12709","Z49646",6017,2521,2120,401," 6.7"
"12710","Z49648",1931,1046,953,93," 4.8"
"12711","Z49649",2562,263,122,141," 5.5"
"12712","Z49650",1593,316,241,75," 4.7"
"12713","Z49651",5225,2030,1778,252," 4.8"
"12714","Z49653",1398,586,485,101," 7.2"
"12715","Z49654",847,474,399,75," 8.9"
"12716","Z49655",2145,1045,978,67," 3.1"
"12717","Z49657",1598,262,166,96," 6.0"
"12718","Z49659",4710,1992,1659,333," 7.1"
"12719","Z49660",7699,1990,1058,932,"12.1"
"12720","Z49663",2916,744,562,182," 6.2"
"12721","Z49664",1339,507,345,162,"12.1"
"12722","Z49665",2353,739,558,181," 7.7"
"12723","Z49667",435,230,187,43," 9.9"
"12724","Z49668",2110,774,603,171," 8.1"
"12725","Z49670",1889,928,727,201,"10.6"
"12726","Z49675",985,520,444,76," 7.7"
"12727","Z49676",2510,1030,982,48," 1.9"
"12728","Z49677",3517,790,635,155," 4.4"
"12729","Z49679",1039,536,492,44," 4.2"
"12730","Z49680",933,229,201,28," 3.0"
"12731","Z49682",2283,549,422,127," 5.6"
"12732","Z49683",1684,900,752,148," 8.8"
"12733","Z49684",18280,2475,1265,1210," 6.6"
"12734","Z49686",16371,2749,1582,1167," 7.1"
"12735","Z49688",1437,471,420,51," 3.5"
"12736","Z49689",1666,991,865,126," 7.6"
"12737","Z49690",3652,1021,691,330," 9.0"
"12738","Z49701",877,447,316,131,"14.9"
"12739","Z49706",2521,695,598,97," 3.8"
"12740","Z49707",11949,2094,1297,797," 6.7"
"12741","Z49709",4069,2481,2274,207," 5.1"
"12742","Z49712",4972,1662,1443,219," 4.4"
"12743","Z49713",1333,617,552,65," 4.9"
"12744","Z49715",2018,856,725,131," 6.5"
"12745","Z49716",679,340,286,54," 8.0"
"12746","Z49719",1699,1011,912,99," 5.8"
"12747","Z49720",5986,2080,1909,171," 2.9"
"12748","Z49721",8780,2604,1770,834," 9.5"
"12749","Z49725",851,486,426,60," 7.1"
"12750","Z49726",1701,1147,1032,115," 6.8"
"12751","Z49727",4208,1377,1196,181," 4.3"
"12752","Z49728",729,607,557,50," 6.9"
"12753","Z49729",956,402,361,41," 4.3"
"12754","Z49730",1304,552,474,78," 6.0"
"12755","Z49735",10927,2972,2572,400," 3.7"
"12756","Z49738",7877,3708,3150,558," 7.1"
"12757","Z49740",6244,3123,2679,444," 7.1"
"12758","Z49743",808,479,431,48," 5.9"
"12759","Z49744",544,157,128,29," 5.3"
"12760","Z49745",966,425,376,49," 5.1"
"12761","Z49746",2877,1346,1170,176," 6.1"
"12762","Z49747",1724,882,816,66," 3.8"
"12763","Z49749",3616,1795,1412,383,"10.6"
"12764","Z49751",2097,1216,1155,61," 2.9"
"12765","Z49752",347,83,34,49,"14.1"
"12766","Z49755",1401,590,502,88," 6.3"
"12767","Z49756",4835,3171,2978,193," 4.0"
"12768","Z49757",918,622,369,253,"27.6"
"12769","Z49759",1905,1153,1016,137," 7.2"
"12770","Z49762",881,565,516,49," 5.6"
"12771","Z49765",2915,1152,947,205," 7.0"
"12772","Z49766",1298,340,230,110," 8.5"
"12773","Z49769",910,232,190,42," 4.6"
"12774","Z49770",9665,2429,1774,655," 6.8"
"12775","Z49774",1257,363,282,81," 6.4"
"12776","Z49775",482,427,414,13," 2.7"
"12777","Z49776",1113,304,218,86," 7.7"
"12778","Z49777",1892,1050,995,55," 2.9"
"12779","Z49779",2635,521,355,166," 6.3"
"12780","Z49780",1204,528,417,111," 9.2"
"12781","Z49781",2472,620,341,279,"11.3"
"12782","Z49782",1031,762,710,52," 5.0"
"12783","Z49783",9209,1347,583,764," 8.3"
"12784","Z49788",1156,104,29,75," 6.5"
"12785","Z49791",300,172,148,24," 8.0"
"12786","Z49795",1401,483,430,53," 3.8"
"12787","Z49796",373,190,177,13," 3.5"
"12788","Z49799",1645,681,548,133," 8.1"
"12789","Z49801",5748,972,444,528," 9.2"
"12790","Z49802",3004,271,140,131," 4.4"
"12791","Z49806",772,501,424,77,"10.0"
"12792","Z49807",1843,592,409,183," 9.9"
"12793","Z49812",607,219,186,33," 5.4"
"12794","Z49814",1000,431,404,27," 2.7"
"12795","Z49815",514,307,294,13," 2.5"
"12796","Z49816",383,151,137,14," 3.7"
"12797","Z49818",801,392,351,41," 5.1"
"12798","Z49820",280,165,139,26," 9.3"
"12799","Z49821",1049,478,422,56," 5.3"
"12800","Z49825",202,63,46,17," 8.4"
"12801","Z49827",824,435,375,60," 7.3"
"12802","Z49829",8520,930,87,843," 9.9"
"12803","Z49831",655,363,303,60," 9.2"
"12804","Z49836",1051,625,543,82," 7.8"
"12805","Z49837",4613,606,182,424," 9.2"
"12806","Z49838",652,405,323,82,"12.6"
"12807","Z49840",889,556,503,53," 6.0"
"12808","Z49841",4486,1576,816,760,"16.9"
"12809","Z49848",108,49,37,12,"11.1"
"12810","Z49849",6557,1394,910,484," 7.4"
"12811","Z49853",1360,803,737,66," 4.9"
"12812","Z49854",4310,1682,1221,461,"10.7"
"12813","Z49855",14501,1762,945,817," 5.6"
"12814","Z49858",6466,772,308,464," 7.2"
"12815","Z49862",2346,670,507,163," 6.9"
"12816","Z49864",71,25,10,15,"21.1"
"12817","Z49866",3702,602,337,265," 7.2"
"12818","Z49868",3055,1205,841,364,"11.9"
"12819","Z49870",1720,201,46,155," 9.0"
"12820","Z49874",517,95,73,22," 4.3"
"12821","Z49876",400,38,0,38," 9.5"
"12822","Z49878",2915,1398,1134,264," 9.1"
"12823","Z49879",1158,712,680,32," 2.8"
"12824","Z49880",978,500,422,78," 8.0"
"12825","Z49885",1145,294,214,80," 7.0"
"12826","Z49886",323,65,44,21," 6.5"
"12827","Z49887",1975,876,659,217,"11.0"
"12828","Z49891",531,227,182,45," 8.5"
"12829","Z49893",1009,214,185,29," 2.9"
"12830","Z49895",1226,959,933,26," 2.1"
"12831","Z49896",697,112,61,51," 7.3"
"12832","Z49901",269,105,57,48,"17.8"
"12833","Z49902",89,38,33,5," 5.6"
"12834","Z49903",265,204,198,6," 2.3"
"12835","Z49905",811,214,188,26," 3.2"
"12836","Z49908",965,235,164,71," 7.4"
"12837","Z49910",490,315,260,55,"11.2"
"12838","Z49911",2005,755,629,126," 6.3"
"12839","Z49912",881,410,373,37," 4.2"
"12840","Z49913",4009,1057,392,665,"16.6"
"12841","Z49915",379,114,35,79,"20.8"
"12842","Z49916",1484,394,254,140," 9.4"
"12843","Z49918",193,133,114,19," 9.8"
"12844","Z49919",208,124,90,34,"16.3"
"12845","Z49920",3445,1601,1329,272," 7.9"
"12846","Z49925",408,190,150,40," 9.8"
"12847","Z49927",246,66,40,26,"10.6"
"12848","Z49930",3235,531,287,244," 7.5"
"12849","Z49931",3745,414,138,276," 7.4"
"12850","Z49934",395,64,35,29," 7.3"
"12851","Z49935",4635,1667,1295,372," 8.0"
"12852","Z49938",4659,1149,612,537,"11.5"
"12853","Z49945",2131,997,857,140," 6.6"
"12854","Z49946",2646,899,677,222," 8.4"
"12855","Z49947",944,634,581,53," 5.6"
"12856","Z49948",449,198,183,15," 3.3"
"12857","Z49950",1400,797,742,55," 3.9"
"12858","Z49953",2172,809,692,117," 5.4"
"12859","Z49958",813,401,348,53," 6.5"
"12860","Z49963",539,135,81,54,"10.0"
"12861","Z49967",775,525,457,68," 8.8"
"12862","Z49968",1436,456,344,112," 7.8"
"12863","Z49970",255,150,133,17," 6.7"
"12864","Z49971",345,154,128,26," 7.5"
"12865","Z50001",264,30,3,27,"10.2"
"12866","Z50002",681,52,0,52," 7.6"
"12867","Z50003",2785,85,35,50," 1.8"
"12868","Z50006",745,120,5,115,"15.4"
"12869","Z50008",430,37,2,35," 8.1"
"12870","Z50009",6845,259,28,231," 3.4"
"12871","Z50010",14133,584,19,565," 4.0"
"12872","Z50014",12440,623,168,455," 3.7"
"12873","Z50020",612,27,2,25," 4.1"
"12874","Z50021",10343,473,94,379," 3.7"
"12875","Z50022",4003,199,0,199," 5.0"
"12876","Z50023",11667,530,60,470," 4.0"
"12877","Z50025",1664,220,35,185,"11.1"
"12878","Z50026",339,34,4,30," 8.8"
"12879","Z50027",152,12,0,12," 7.9"
"12880","Z50028",738,123,29,94,"12.7"
"12881","Z50033",19,7,0,7,"36.8"
"12882","Z50034",228,81,63,18," 7.9"
"12883","Z50035",2053,59,59,0," 0.0"
"12884","Z50036",7502,643,21,622," 8.3"
"12885","Z50039",221,9,0,9," 4.1"
"12886","Z50042",183,36,4,32,"17.5"
"12887","Z50044",458,29,0,29," 6.3"
"12888","Z50046",525,43,6,37," 7.0"
"12889","Z50047",2302,94,6,88," 3.8"
"12890","Z50048",374,33,0,33," 8.8"
"12891","Z50049",3162,357,111,246," 7.8"
"12892","Z50050",356,56,11,45,"12.6"
"12893","Z50052",79,1,1,0," 0.0"
"12894","Z50054",1311,94,0,94," 7.2"
"12895","Z50056",562,25,0,25," 4.4"
"12896","Z50058",877,80,28,52," 5.9"
"12897","Z50060",1197,211,55,156,"13.0"
"12898","Z50061",704,30,0,30," 4.3"
"12899","Z50063",1031,64,8,56," 5.4"
"12900","Z50069",485,23,0,23," 4.7"
"12901","Z50070",724,89,59,30," 4.1"
"12902","Z50072",1134,92,24,68," 6.0"
"12903","Z50073",447,17,0,17," 3.8"
"12904","Z50074",496,295,277,18," 3.6"
"12905","Z50075",340,32,2,30," 8.8"
"12906","Z50076",765,55,0,55," 7.2"
"12907","Z50104",60,4,0,4," 6.7"
"12908","Z50105",443,14,0,14," 3.2"
"12909","Z50106",560,79,0,79,"14.1"
"12910","Z50107",496,35,0,35," 7.1"
"12911","Z50111",4125,62,0,62," 1.5"
"12912","Z50112",4754,348,87,261," 5.5"
"12913","Z50115",1309,202,12,190,"14.5"
"12914","Z50119",241,40,0,40,"16.6"
"12915","Z50122",678,104,0,104,"15.3"
"12916","Z50123",444,89,10,79,"17.8"
"12917","Z50124",1530,90,0,90," 5.9"
"12918","Z50125",7736,369,9,360," 4.7"
"12919","Z50126",3223,457,9,448,"13.9"
"12920","Z50129",2585,380,29,351,"13.6"
"12921","Z50130",775,102,7,95,"12.3"
"12922","Z50131",7915,244,50,194," 2.5"
"12923","Z50132",182,27,0,27,"14.8"
"12924","Z50133",274,88,63,25," 9.1"
"12925","Z50134",256,12,0,12," 4.7"
"12926","Z50135",834,118,0,118,"14.1"
"12927","Z50136",177,15,2,13," 7.3"
"12928","Z50138",5183,411,5,406," 7.8"
"12929","Z50140",1277,199,24,175,"13.7"
"12930","Z50142",414,18,3,15," 3.6"
"12931","Z50144",1278,233,31,202,"15.8"
"12932","Z50146",181,34,4,30,"16.6"
"12933","Z50147",241,40,10,30,"12.4"
"12934","Z50149",564,141,4,137,"24.3"
"12935","Z50150",441,6,0,6," 1.4"
"12936","Z50151",294,51,5,46,"15.6"
"12937","Z50153",359,16,0,16," 4.5"
"12938","Z50156",1854,131,31,100," 5.4"
"12939","Z50157",405,109,26,83,"20.5"
"12940","Z50158",12717,1148,6,1142," 9.0"
"12941","Z50160",202,17,0,17," 8.4"
"12942","Z50161",898,59,12,47," 5.2"
"12943","Z50162",568,20,0,20," 3.5"
"12944","Z50166",660,54,0,54," 8.2"
"12945","Z50167",262,24,0,24," 9.2"
"12946","Z50168",313,11,0,11," 3.5"
"12947","Z50169",1145,94,0,94," 8.2"
"12948","Z50170",1203,62,0,62," 5.2"
"12949","Z50171",1785,652,417,235,"13.2"
"12950","Z50173",330,19,4,15," 4.5"
"12951","Z50174",650,81,31,50," 7.7"
"12952","Z50201",3657,233,36,197," 5.4"
"12953","Z50207",1047,93,2,91," 8.7"
"12954","Z50208",8991,1123,49,1074,"11.9"
"12955","Z50210",703,71,0,71,"10.1"
"12956","Z50211",4690,147,16,131," 2.8"
"12957","Z50212",1509,152,10,142," 9.4"
"12958","Z50213",2983,228,62,166," 5.6"
"12959","Z50214",280,13,13,0," 0.0"
"12960","Z50216",1785,705,507,198,"11.1"
"12961","Z50220",3734,499,0,499,"13.4"
"12962","Z50223",239,15,2,13," 5.4"
"12963","Z50225",1316,102,0,102," 7.8"
"12964","Z50226",2026,48,0,48," 2.4"
"12965","Z50228",1037,90,0,90," 8.7"
"12966","Z50230",526,89,17,72,"13.7"
"12967","Z50232",226,27,0,27,"11.9"
"12968","Z50233",648,75,22,53," 8.2"
"12969","Z50236",663,38,0,38," 5.7"
"12970","Z50238",555,93,25,68,"12.3"
"12971","Z50239",69,21,0,21,"30.4"
"12972","Z50240",1094,59,0,59," 5.4"
"12973","Z50244",716,34,0,34," 4.7"
"12974","Z50246",388,80,27,53,"13.7"
"12975","Z50247",863,49,0,49," 5.7"
"12976","Z50249",547,77,14,63,"11.5"
"12977","Z50250",1116,126,17,109," 9.8"
"12978","Z50251",525,18,9,9," 1.7"
"12979","Z50257",441,37,16,21," 4.8"
"12980","Z50258",470,72,5,67,"14.3"
"12981","Z50261",854,24,15,9," 1.1"
"12982","Z50263",7407,407,35,372," 5.0"
"12983","Z50265",14753,799,54,745," 5.0"
"12984","Z50266",11866,614,95,519," 4.4"
"12985","Z50268",486,74,6,68,"14.0"
"12986","Z50271",308,43,3,40,"13.0"
"12987","Z50273",3571,220,14,206," 5.8"
"12988","Z50276",1004,56,0,56," 5.6"
"12989","Z50277",244,17,0,17," 7.0"
"12990","Z50278",387,30,0,30," 7.8"
"12991","Z50309",3902,572,68,504,"12.9"
"12992","Z50310",14013,1063,18,1045," 7.5"
"12993","Z50311",6346,641,62,579," 9.1"
"12994","Z50312",8049,756,109,647," 8.0"
"12995","Z50313",7053,510,0,510," 7.2"
"12996","Z50314",4693,664,21,643,"13.7"
"12997","Z50315",15298,1258,49,1209," 7.9"
"12998","Z50316",6299,626,48,578," 9.2"
"12999","Z50317",15232,981,0,981," 6.4"
"13000","Z50320",7997,572,0,572," 7.2"
"13001","Z50321",3523,153,8,145," 4.1"
"13002","Z50322",14287,763,18,745," 5.2"
"13003","Z50323",4249,141,0,141," 3.3"
"13004","Z50325",6368,259,29,230," 3.6"
"13005","Z50401",14279,902,46,856," 6.0"
"13006","Z50420",189,10,0,10," 5.3"
"13007","Z50421",1508,147,16,131," 8.7"
"13008","Z50423",1402,179,11,168,"12.0"
"13009","Z50424",735,107,0,107,"14.6"
"13010","Z50428",5454,1516,1215,301," 5.5"
"13011","Z50430",243,25,5,20," 8.2"
"13012","Z50431",134,11,0,11," 8.2"
"13013","Z50433",108,20,0,20,"18.5"
"13014","Z50434",206,13,0,13," 6.3"
"13015","Z50435",264,11,11,0," 0.0"
"13016","Z50436",2743,194,10,184," 6.7"
"13017","Z50438",1762,172,0,172," 9.8"
"13018","Z50441",2548,286,12,274,"10.8"
"13019","Z50446",290,36,0,36,"12.4"
"13020","Z50447",593,77,16,61,"10.3"
"13021","Z50448",343,27,1,26," 7.6"
"13022","Z50449",275,34,0,34,"12.4"
"13023","Z50450",1413,204,69,135," 9.6"
"13024","Z50451",254,22,0,22," 8.7"
"13025","Z50452",349,37,0,37,"10.6"
"13026","Z50453",292,47,24,23," 7.9"
"13027","Z50455",196,35,4,31,"15.8"
"13028","Z50456",790,61,0,61," 7.7"
"13029","Z50458",957,86,13,73," 7.6"
"13030","Z50459",1378,131,0,131," 9.5"
"13031","Z50460",117,15,0,15,"12.8"
"13032","Z50461",2615,232,35,197," 7.5"
"13033","Z50464",281,17,0,17," 6.0"
"13034","Z50465",145,28,0,28,"19.3"
"13035","Z50466",818,132,24,108,"13.2"
"13036","Z50468",751,106,5,101,"13.4"
"13037","Z50469",747,63,0,63," 8.4"
"13038","Z50470",129,21,0,21,"16.3"
"13039","Z50471",387,26,10,16," 4.1"
"13040","Z50472",1070,163,62,101," 9.4"
"13041","Z50475",700,33,9,24," 3.4"
"13042","Z50476",394,23,0,23," 5.8"
"13043","Z50477",194,31,0,31,"16.0"
"13044","Z50478",408,30,2,28," 6.9"
"13045","Z50479",317,30,0,30," 9.5"
"13046","Z50480",463,39,0,39," 8.4"
"13047","Z50482",500,81,67,14," 2.8"
"13048","Z50483",329,31,7,24," 7.3"
"13049","Z50501",12699,1436,147,1289,"10.2"
"13050","Z50510",489,54,8,46," 9.4"
"13051","Z50511",3500,280,0,280," 8.0"
"13052","Z50514",753,101,0,101,"13.4"
"13053","Z50516",313,41,0,41,"13.1"
"13054","Z50517",455,40,2,38," 8.4"
"13055","Z50519",276,23,0,23," 8.3"
"13056","Z50522",401,113,0,113,"28.2"
"13057","Z50523",362,39,0,39,"10.8"
"13058","Z50525",1722,302,76,226,"13.1"
"13059","Z50528",208,39,0,39,"18.8"
"13060","Z50529",366,23,0,23," 6.3"
"13061","Z50530",546,50,2,48," 8.8"
"13062","Z50532",499,62,0,62,"12.4"
"13063","Z50533",1920,298,0,298,"15.5"
"13064","Z50536",2144,231,22,209," 9.7"
"13065","Z50538",263,28,0,28,"10.6"
"13066","Z50540",518,119,3,116,"22.4"
"13067","Z50541",459,108,4,104,"22.7"
"13068","Z50542",518,67,5,62,"12.0"
"13069","Z50543",711,75,0,75,"10.5"
"13070","Z50544",224,20,0,20," 8.9"
"13071","Z50548",2733,217,0,217," 7.9"
"13072","Z50551",53,15,0,15,"28.3"
"13073","Z50554",911,152,18,134,"14.7"
"13074","Z50556",148,25,0,25,"16.9"
"13075","Z50557",395,49,7,42,"10.6"
"13076","Z50558",320,27,0,27," 8.4"
"13077","Z50561",272,69,25,44,"16.2"
"13078","Z50562",267,37,0,37,"13.9"
"13079","Z50563",1406,230,126,104," 7.4"
"13080","Z50566",173,5,0,5," 2.9"
"13081","Z50568",648,17,9,8," 1.2"
"13082","Z50569",362,24,2,22," 6.1"
"13083","Z50570",116,22,0,22,"19.0"
"13084","Z50574",1086,115,17,98," 9.0"
"13085","Z50575",586,85,4,81,"13.8"
"13086","Z50576",169,32,0,32,"18.9"
"13087","Z50577",212,35,1,34,"16.0"
"13088","Z50578",362,46,0,46,"12.7"
"13089","Z50579",1236,183,67,116," 9.4"
"13090","Z50581",460,66,7,59,"12.8"
"13091","Z50582",143,32,21,11," 7.7"
"13092","Z50583",1504,208,0,208,"13.8"
"13093","Z50585",524,61,0,61,"11.6"
"13094","Z50588",4803,309,70,239," 5.0"
"13095","Z50590",468,40,0,40," 8.5"
"13096","Z50591",136,17,0,17,"12.5"
"13097","Z50594",119,8,0,8," 6.7"
"13098","Z50595",4286,401,0,401," 9.4"
"13099","Z50597",605,33,2,31," 5.1"
"13100","Z50598",390,25,0,25," 6.4"
"13101","Z50599",190,27,0,27,"14.2"
"13102","Z50601",1159,75,9,66," 5.7"
"13103","Z50602",755,40,0,40," 5.3"
"13104","Z50603",334,71,33,38,"11.4"
"13105","Z50604",784,54,8,46," 5.9"
"13106","Z50605",85,7,0,7," 8.2"
"13107","Z50606",439,54,38,16," 3.6"
"13108","Z50611",187,10,0,10," 5.3"
"13109","Z50612",152,13,0,13," 8.6"
"13110","Z50613",16884,1165,69,1096," 6.5"
"13111","Z50616",4886,366,7,359," 7.3"
"13112","Z50619",1025,83,10,73," 7.1"
"13113","Z50621",693,21,0,21," 3.0"
"13114","Z50622",1373,47,27,20," 1.5"
"13115","Z50624",735,16,0,16," 2.2"
"13116","Z50625",464,39,0,39," 8.4"
"13117","Z50626",751,37,7,30," 4.0"
"13118","Z50627",1660,320,38,282,"17.0"
"13119","Z50628",581,24,0,24," 4.1"
"13120","Z50629",891,34,4,30," 3.4"
"13121","Z50630",939,57,7,50," 5.3"
"13122","Z50635",826,151,69,82," 9.9"
"13123","Z50636",934,108,11,97,"10.4"
"13124","Z50638",1553,153,15,138," 8.9"
"13125","Z50643",1142,35,0,35," 3.1"
"13126","Z50644",3974,397,137,260," 6.5"
"13127","Z50645",466,13,1,12," 2.6"
"13128","Z50647",813,92,0,92,"11.3"
"13129","Z50648",1754,92,12,80," 4.6"
"13130","Z50650",298,46,0,46,"15.4"
"13131","Z50651",1520,117,27,90," 5.9"
"13132","Z50653",240,27,0,27,"11.2"
"13133","Z50654",228,38,0,38,"16.7"
"13134","Z50655",357,37,8,29," 8.1"
"13135","Z50658",1099,71,21,50," 4.5"
"13136","Z50659",2470,118,0,118," 4.8"
"13137","Z50660",608,29,0,29," 4.8"
"13138","Z50662",3462,432,84,348,"10.1"
"13139","Z50665",1295,84,11,73," 5.6"
"13140","Z50666",377,7,0,7," 1.9"
"13141","Z50668",545,33,0,33," 6.1"
"13142","Z50672",240,26,0,26,"10.8"
"13143","Z50674",1588,91,12,79," 5.0"
"13144","Z50675",1091,108,8,100," 9.2"
"13145","Z50676",982,113,52,61," 6.2"
"13146","Z50677",4756,376,42,334," 7.0"
"13147","Z50680",592,39,2,37," 6.2"
"13148","Z50682",650,2,0,2," 0.3"
"13149","Z50701",13754,1016,30,986," 7.2"
"13150","Z50702",9151,609,25,584," 6.4"
"13151","Z50703",8655,898,0,898,"10.4"
"13152","Z50707",3591,152,3,149," 4.1"
"13153","Z50801",4423,389,27,362," 8.2"
"13154","Z50830",786,63,17,46," 5.9"
"13155","Z50833",1073,148,63,85," 7.9"
"13156","Z50837",237,95,6,89,"37.6"
"13157","Z50840",292,48,9,39,"13.4"
"13158","Z50841",1391,195,11,184,"13.2"
"13159","Z50845",383,75,17,58,"15.1"
"13160","Z50846",525,50,0,50," 9.5"
"13161","Z50849",1307,167,0,167,"12.8"
"13162","Z50851",979,53,8,45," 4.6"
"13163","Z50853",374,68,19,49,"13.1"
"13164","Z50854",1032,77,13,64," 6.2"
"13165","Z50858",351,33,5,28," 8.0"
"13166","Z50860",141,13,5,8," 5.7"
"13167","Z50864",1012,121,5,116,"11.5"
"13168","Z51001",1098,84,4,80," 7.3"
"13169","Z51002",1265,105,14,91," 7.2"
"13170","Z51003",717,20,0,20," 2.8"
"13171","Z51004",561,51,0,51," 9.1"
"13172","Z51005",695,72,13,59," 8.5"
"13173","Z51006",556,58,2,56,"10.1"
"13174","Z51009",97,4,0,4," 4.1"
"13175","Z51012",3049,132,0,132," 4.3"
"13176","Z51016",578,50,10,40," 6.9"
"13177","Z51019",346,23,0,23," 6.6"
"13178","Z51020",275,31,0,31,"11.3"
"13179","Z51022",376,48,0,48,"12.8"
"13180","Z51023",1385,110,0,110," 7.9"
"13181","Z51024",720,14,2,12," 1.7"
"13182","Z51025",980,121,3,118,"12.0"
"13183","Z51026",384,20,16,4," 1.0"
"13184","Z51027",505,70,0,70,"13.9"
"13185","Z51028",918,103,8,95,"10.3"
"13186","Z51030",709,68,0,68," 9.6"
"13187","Z51031",5397,310,14,296," 5.5"
"13188","Z51033",225,7,4,3," 1.3"
"13189","Z51034",934,104,31,73," 7.8"
"13190","Z51035",840,90,0,90,"10.7"
"13191","Z51036",214,3,0,3," 1.4"
"13192","Z51039",1045,98,17,81," 7.8"
"13193","Z51040",1784,236,59,177," 9.9"
"13194","Z51041",2462,161,31,130," 5.3"
"13195","Z51044",116,29,0,29,"25.0"
"13196","Z51046",766,54,0,54," 7.0"
"13197","Z51048",301,37,2,35,"11.6"
"13198","Z51050",1038,48,0,48," 4.6"
"13199","Z51052",420,73,0,73,"17.4"
"13200","Z51054",1855,95,0,95," 5.1"
"13201","Z51055",644,77,12,65,"10.1"
"13202","Z51056",215,23,0,23,"10.7"
"13203","Z51058",478,63,12,51,"10.7"
"13204","Z51060",320,61,15,46,"14.4"
"13205","Z51061",291,56,17,39,"13.4"
"13206","Z51063",571,66,3,63,"11.0"
"13207","Z51101",525,80,0,80,"15.2"
"13208","Z51103",6581,464,0,464," 7.1"
"13209","Z51104",8801,420,10,410," 4.7"
"13210","Z51105",4036,471,0,471,"11.7"
"13211","Z51106",11083,644,46,598," 5.4"
"13212","Z51108",2241,102,0,102," 4.6"
"13213","Z51109",1283,49,32,17," 1.3"
"13214","Z51201",2779,148,55,93," 3.3"
"13215","Z51231",136,1,0,1," 0.7"
"13216","Z51232",428,58,1,57,"13.3"
"13217","Z51237",759,52,0,52," 6.9"
"13218","Z51238",454,17,0,17," 3.7"
"13219","Z51239",1180,73,0,73," 6.2"
"13220","Z51240",743,46,0,46," 6.2"
"13221","Z51241",740,87,3,84,"11.4"
"13222","Z51242",93,5,0,5," 5.4"
"13223","Z51243",430,24,3,21," 4.9"
"13224","Z51244",34,4,0,4,"11.8"
"13225","Z51245",565,115,0,115,"20.4"
"13226","Z51246",1615,203,13,190,"11.8"
"13227","Z51247",1842,95,0,95," 5.2"
"13228","Z51248",783,37,0,37," 4.7"
"13229","Z51249",1481,123,0,123," 8.3"
"13230","Z51250",2810,126,0,126," 4.5"
"13231","Z51301",6164,675,14,661,"10.7"
"13232","Z51331",1454,860,748,112," 7.7"
"13233","Z51334",3334,323,0,323," 9.7"
"13234","Z51338",432,37,0,37," 8.6"
"13235","Z51342",572,93,0,93,"16.3"
"13236","Z51343",136,3,0,3," 2.2"
"13237","Z51346",1170,168,10,158,"13.5"
"13238","Z51347",775,185,52,133,"17.2"
"13239","Z51351",2876,878,649,229," 8.0"
"13240","Z51354",564,80,0,80,"14.2"
"13241","Z51355",1252,852,808,44," 3.5"
"13242","Z51357",290,27,0,27," 9.3"
"13243","Z51358",743,214,153,61," 8.2"
"13244","Z51360",6404,2505,1957,548," 8.6"
"13245","Z51364",342,41,23,18," 5.3"
"13246","Z51366",194,30,0,30,"15.5"
"13247","Z51401",5679,559,0,559," 9.8"
"13248","Z51430",326,24,9,15," 4.6"
"13249","Z51431",195,9,0,9," 4.6"
"13250","Z51433",287,62,5,57,"19.9"
"13251","Z51436",338,42,0,42,"12.4"
"13252","Z51439",510,59,5,54,"10.6"
"13253","Z51440",167,32,5,27,"16.2"
"13254","Z51442",3498,276,39,237," 6.8"
"13255","Z51443",784,53,0,53," 6.8"
"13256","Z51445",1359,94,0,94," 6.9"
"13257","Z51446",274,33,3,30,"10.9"
"13258","Z51448",287,47,0,47,"16.4"
"13259","Z51449",1107,185,35,150,"13.6"
"13260","Z51450",1113,395,241,154,"13.8"
"13261","Z51453",334,30,0,30," 9.0"
"13262","Z51454",653,37,8,29," 4.4"
"13263","Z51455",1124,101,7,94," 8.4"
"13264","Z51458",718,83,3,80,"11.1"
"13265","Z51461",551,64,0,64,"11.6"
"13266","Z51462",468,62,8,54,"11.5"
"13267","Z51463",236,4,0,4," 1.7"
"13268","Z51465",342,20,0,20," 5.8"
"13269","Z51501",15105,1371,91,1280," 8.5"
"13270","Z51503",15661,961,46,915," 5.8"
"13271","Z51510",1567,79,20,59," 3.8"
"13272","Z51521",881,95,9,86," 9.8"
"13273","Z51525",477,33,0,33," 6.9"
"13274","Z51526",646,41,27,14," 2.2"
"13275","Z51527",167,13,1,12," 7.2"
"13276","Z51528",377,41,1,40,"10.6"
"13277","Z51529",803,48,0,48," 6.0"
"13278","Z51530",419,7,1,6," 1.4"
"13279","Z51531",345,30,0,30," 8.7"
"13280","Z51532",270,11,0,11," 4.1"
"13281","Z51533",419,43,10,33," 7.9"
"13282","Z51534",3704,383,83,300," 8.1"
"13283","Z51535",837,115,15,100,"11.9"
"13284","Z51537",3233,328,91,237," 7.3"
"13285","Z51544",393,5,0,5," 1.3"
"13286","Z51545",178,52,0,52,"29.2"
"13287","Z51546",1234,155,5,150,"12.2"
"13288","Z51548",157,14,0,14," 8.9"
"13289","Z51551",742,96,0,96,"12.9"
"13290","Z51553",398,7,0,7," 1.8"
"13291","Z51555",2347,208,0,208," 8.9"
"13292","Z51556",237,56,4,52,"21.9"
"13293","Z51557",509,162,96,66,"13.0"
"13294","Z51559",731,49,0,49," 6.7"
"13295","Z51563",285,7,2,5," 1.8"
"13296","Z51564",269,55,24,31,"11.5"
"13297","Z51566",3444,417,0,417,"12.1"
"13298","Z51570",407,18,6,12," 2.9"
"13299","Z51571",250,30,4,26,"10.4"
"13300","Z51573",494,46,10,36," 7.3"
"13301","Z51575",675,24,8,16," 2.4"
"13302","Z51577",606,95,15,80,"13.2"
"13303","Z51579",1058,74,15,59," 5.6"
"13304","Z51601",2846,382,22,360,"12.6"
"13305","Z51630",103,5,0,5," 4.9"
"13306","Z51631",142,11,0,11," 7.7"
"13307","Z51632",3041,384,17,367,"12.1"
"13308","Z51636",206,23,8,15," 7.3"
"13309","Z51638",670,73,20,53," 7.9"
"13310","Z51640",812,148,8,140,"17.2"
"13311","Z51645",140,29,0,29,"20.7"
"13312","Z51646",359,46,2,44,"12.3"
"13313","Z51648",98,20,0,20,"20.4"
"13314","Z51649",146,14,0,14," 9.6"
"13315","Z51650",217,52,24,28,"12.9"
"13316","Z51652",809,126,19,107,"13.2"
"13317","Z51653",622,73,12,61," 9.8"
"13318","Z52001",18929,1342,84,1258," 6.6"
"13319","Z52002",6366,225,35,190," 3.0"
"13320","Z52003",5695,271,64,207," 3.6"
"13321","Z52031",2462,371,196,175," 7.1"
"13322","Z52032",808,199,180,19," 2.4"
"13323","Z52033",1336,56,0,56," 4.2"
"13324","Z52035",541,56,6,50," 9.2"
"13325","Z52037",514,37,20,17," 3.3"
"13326","Z52038",216,10,0,10," 4.6"
"13327","Z52040",2333,82,0,82," 3.5"
"13328","Z52041",674,25,0,25," 3.7"
"13329","Z52042",701,48,26,22," 3.1"
"13330","Z52043",1072,83,0,83," 7.7"
"13331","Z52045",942,10,0,10," 1.1"
"13332","Z52047",266,38,21,17," 6.4"
"13333","Z52049",651,58,42,16," 2.5"
"13334","Z52052",1780,483,332,151," 8.5"
"13335","Z52053",413,19,2,17," 4.1"
"13336","Z52054",419,18,11,7," 1.7"
"13337","Z52057",3541,390,149,241," 6.8"
"13338","Z52060",3984,225,9,216," 5.4"
"13339","Z52064",448,39,4,35," 7.8"
"13340","Z52065",486,30,0,30," 6.2"
"13341","Z52068",1539,23,3,20," 1.3"
"13342","Z52069",736,56,0,56," 7.6"
"13343","Z52070",493,54,8,46," 9.3"
"13344","Z52072",171,58,22,36,"21.1"
"13345","Z52073",505,72,72,0," 0.0"
"13346","Z52076",1015,95,18,77," 7.6"
"13347","Z52078",403,4,0,4," 1.0"
"13348","Z52079",412,64,0,64,"15.5"
"13349","Z52101",5689,386,78,308," 5.4"
"13350","Z52132",917,77,6,71," 7.7"
"13351","Z52135",390,45,11,34," 8.7"
"13352","Z52136",2715,309,7,302,"11.1"
"13353","Z52141",696,54,14,40," 5.7"
"13354","Z52142",611,80,0,80,"13.1"
"13355","Z52151",1341,447,371,76," 5.7"
"13356","Z52154",411,26,0,26," 6.3"
"13357","Z52157",998,199,95,104,"10.4"
"13358","Z52158",182,34,27,7," 3.8"
"13359","Z52159",1191,90,17,73," 6.1"
"13360","Z52160",540,29,11,18," 3.3"
"13361","Z52161",619,17,2,15," 2.4"
"13362","Z52162",1410,140,0,140," 9.9"
"13363","Z52163",152,11,3,8," 5.3"
"13364","Z52165",362,18,0,18," 5.0"
"13365","Z52166",62,5,0,5," 8.1"
"13366","Z52168",117,11,0,11," 9.4"
"13367","Z52169",198,17,14,3," 1.5"
"13368","Z52171",402,32,10,22," 5.5"
"13369","Z52172",2618,110,0,110," 4.2"
"13370","Z52175",1751,161,34,127," 7.3"
"13371","Z52201",520,23,0,23," 4.4"
"13372","Z52202",431,46,0,46,"10.7"
"13373","Z52203",906,72,0,72," 7.9"
"13374","Z52205",3438,307,59,248," 7.2"
"13375","Z52206",872,42,0,42," 4.8"
"13376","Z52207",220,31,0,31,"14.1"
"13377","Z52208",1486,192,0,192,"12.9"
"13378","Z52209",444,32,18,14," 3.2"
"13379","Z52211",1504,439,222,217,"14.4"
"13380","Z52212",127,35,0,35,"27.6"
"13381","Z52213",1667,70,0,70," 4.2"
"13382","Z52214",1450,70,6,64," 4.4"
"13383","Z52215",374,101,4,97,"25.9"
"13384","Z52216",627,10,0,10," 1.6"
"13385","Z52217",236,44,1,43,"18.2"
"13386","Z52223",1053,474,457,17," 1.6"
"13387","Z52224",933,135,0,135,"14.5"
"13388","Z52228",1110,5,5,0," 0.0"
"13389","Z52229",325,22,0,22," 6.8"
"13390","Z52231",146,37,12,25,"17.1"
"13391","Z52233",3298,304,23,281," 8.5"
"13392","Z52235",338,27,6,21," 6.2"
"13393","Z52236",235,16,0,16," 6.8"
"13394","Z52237",595,22,0,22," 3.7"
"13395","Z52240",15111,777,30,747," 4.9"
"13396","Z52241",8318,501,12,489," 5.9"
"13397","Z52245",9384,308,72,236," 2.5"
"13398","Z52246",10045,315,66,249," 2.5"
"13399","Z52247",2051,40,0,40," 2.0"
"13400","Z52248",773,63,4,59," 7.6"
"13401","Z52249",495,13,0,13," 2.6"
"13402","Z52253",1236,54,0,54," 4.4"
"13403","Z52254",380,39,0,39,"10.3"
"13404","Z52255",587,55,7,48," 8.2"
"13405","Z52301",1598,107,13,94," 5.9"
"13406","Z52302",16490,931,0,931," 5.6"
"13407","Z52305",283,22,0,22," 7.8"
"13408","Z52306",784,44,0,44," 5.6"
"13409","Z52309",161,4,0,4," 2.5"
"13410","Z52310",2884,153,8,145," 5.0"
"13411","Z52314",2015,186,0,186," 9.2"
"13412","Z52315",466,13,0,13," 2.8"
"13413","Z52316",733,95,17,78,"10.6"
"13414","Z52317",6887,258,59,199," 2.9"
"13415","Z52318",457,12,0,12," 2.6"
"13416","Z52320",580,71,8,63,"10.9"
"13417","Z52321",258,8,0,8," 3.1"
"13418","Z52322",1265,68,42,26," 2.1"
"13419","Z52323",464,26,0,26," 5.6"
"13420","Z52324",791,24,0,24," 3.0"
"13421","Z52325",421,18,13,5," 1.2"
"13422","Z52327",1300,63,10,53," 4.1"
"13423","Z52328",1040,18,0,18," 1.7"
"13424","Z52330",392,61,3,58,"14.8"
"13425","Z52332",921,116,0,116,"12.6"
"13426","Z52333",2442,56,35,21," 0.9"
"13427","Z52336",942,35,0,35," 3.7"
"13428","Z52338",1366,127,9,118," 8.6"
"13429","Z52339",1795,201,14,187,"10.4"
"13430","Z52340",1098,41,19,22," 2.0"
"13431","Z52342",1293,122,0,122," 9.4"
"13432","Z52345",580,23,0,23," 4.0"
"13433","Z52346",423,53,0,53,"12.5"
"13434","Z52347",762,32,10,22," 2.9"
"13435","Z52349",3370,369,67,302," 9.0"
"13436","Z52351",523,12,0,12," 2.3"
"13437","Z52352",733,106,36,70," 9.5"
"13438","Z52353",4099,238,0,238," 5.8"
"13439","Z52356",1124,125,0,125,"11.1"
"13440","Z52358",1595,58,0,58," 3.6"
"13441","Z52359",131,3,0,3," 2.3"
"13442","Z52361",1891,55,0,55," 2.9"
"13443","Z52362",494,124,0,124,"25.1"
"13444","Z52401",1148,135,6,129,"11.2"
"13445","Z52402",17778,1186,0,1186," 6.7"
"13446","Z52403",10791,957,8,949," 8.8"
"13447","Z52404",17721,1771,43,1728," 9.8"
"13448","Z52405",11094,708,0,708," 6.4"
"13449","Z52411",2558,42,0,42," 1.6"
"13450","Z52501",13414,1232,62,1170," 8.7"
"13451","Z52531",2795,342,28,314,"11.2"
"13452","Z52534",126,13,0,13,"10.3"
"13453","Z52535",437,39,5,34," 7.8"
"13454","Z52537",2869,317,69,248," 8.6"
"13455","Z52540",635,48,0,48," 7.6"
"13456","Z52542",236,19,6,13," 5.5"
"13457","Z52544",3911,619,83,536,"13.7"
"13458","Z52550",232,22,0,22," 9.5"
"13459","Z52551",311,55,0,55,"17.7"
"13460","Z52552",398,84,25,59,"14.8"
"13461","Z52553",843,57,9,48," 5.7"
"13462","Z52554",684,75,4,71,"10.4"
"13463","Z52556",5851,557,109,448," 7.7"
"13464","Z52561",359,19,0,19," 5.3"
"13465","Z52563",782,117,0,117,"15.0"
"13466","Z52565",1023,275,138,137,"13.4"
"13467","Z52567",363,34,0,34," 9.4"
"13468","Z52571",810,155,122,33," 4.1"
"13469","Z52572",580,109,19,90,"15.5"
"13470","Z52574",419,69,11,58,"13.8"
"13471","Z52576",254,29,26,3," 1.2"
"13472","Z52577",6784,533,0,533," 7.9"
"13473","Z52580",194,23,0,23,"11.9"
"13474","Z52583",223,58,42,16," 7.2"
"13475","Z52585",467,82,0,82,"17.6"
"13476","Z52590",534,99,5,94,"17.6"
"13477","Z52591",1517,183,0,183,"12.1"
"13478","Z52601",13815,1399,137,1262," 9.1"
"13479","Z52623",796,38,0,38," 4.8"
"13480","Z52624",125,6,0,6," 4.8"
"13481","Z52625",1168,154,0,154,"13.2"
"13482","Z52626",654,84,13,71,"10.9"
"13483","Z52627",6225,819,24,795,"12.8"
"13484","Z52630",246,25,1,24," 9.8"
"13485","Z52632",5729,485,29,456," 8.0"
"13486","Z52637",1034,82,9,73," 7.1"
"13487","Z52639",986,188,60,128,"13.0"
"13488","Z52640",620,44,3,41," 6.6"
"13489","Z52641",4758,260,0,260," 5.5"
"13490","Z52644",167,13,0,13," 7.8"
"13491","Z52645",1331,62,0,62," 4.7"
"13492","Z52649",371,27,12,15," 4.0"
"13493","Z52650",360,19,0,19," 5.3"
"13494","Z52651",330,57,0,57,"17.3"
"13495","Z52653",1710,326,116,210,"12.3"
"13496","Z52654",681,49,2,47," 6.9"
"13497","Z52655",2147,182,0,182," 8.5"
"13498","Z52656",1142,76,9,67," 5.9"
"13499","Z52657",28,4,4,0," 0.0"
"13500","Z52659",752,179,0,179,"23.8"
"13501","Z52701",34,1,0,1," 2.9"
"13502","Z52720",391,29,29,0," 0.0"
"13503","Z52722",15198,774,91,683," 4.5"
"13504","Z52726",1888,73,0,73," 3.9"
"13505","Z52727",181,15,0,15," 8.3"
"13506","Z52728",458,16,7,9," 2.0"
"13507","Z52729",360,20,11,9," 2.5"
"13508","Z52730",2269,107,0,107," 4.7"
"13509","Z52731",323,5,0,5," 1.5"
"13510","Z52732",12920,1171,116,1055," 8.2"
"13511","Z52737",166,15,0,15," 9.0"
"13512","Z52738",1582,223,19,204,"12.9"
"13513","Z52739",287,41,0,41,"14.3"
"13514","Z52742",3236,137,0,137," 4.2"
"13515","Z52745",309,38,0,38,"12.3"
"13516","Z52746",393,7,0,7," 1.8"
"13517","Z52747",983,72,13,59," 6.0"
"13518","Z52748",3667,107,0,107," 2.9"
"13519","Z52750",221,19,1,18," 8.1"
"13520","Z52751",418,28,0,28," 6.7"
"13521","Z52753",2373,195,46,149," 6.3"
"13522","Z52754",603,54,0,54," 9.0"
"13523","Z52755",906,89,0,89," 9.8"
"13524","Z52756",831,127,98,29," 3.5"
"13525","Z52757",75,18,0,18,"24.0"
"13526","Z52758",91,6,0,6," 6.6"
"13527","Z52761",12801,1007,79,928," 7.2"
"13528","Z52765",153,3,0,3," 2.0"
"13529","Z52769",284,10,0,10," 3.5"
"13530","Z52772",2217,147,24,123," 5.5"
"13531","Z52773",1065,114,26,88," 8.3"
"13532","Z52776",1668,224,19,205,"12.3"
"13533","Z52777",572,59,0,59,"10.3"
"13534","Z52778",1916,195,46,149," 7.8"
"13535","Z52801",681,145,8,137,"20.1"
"13536","Z52802",4444,599,19,580,"13.1"
"13537","Z52803",10353,1171,8,1163,"11.2"
"13538","Z52804",11598,769,0,769," 6.6"
"13539","Z52806",11607,635,21,614," 5.3"
"13540","Z52807",7028,328,0,328," 4.7"
"13541","Z53001",812,55,12,43," 5.3"
"13542","Z53003",34,5,0,5,"14.7"
"13543","Z53004",1338,112,24,88," 6.6"
"13544","Z53005",7753,173,9,164," 2.1"
"13545","Z53007",950,54,0,54," 5.7"
"13546","Z53010",3447,447,258,189," 5.5"
"13547","Z53011",1106,202,152,50," 4.5"
"13548","Z53012",7454,333,41,292," 3.9"
"13549","Z53013",1424,148,98,50," 3.5"
"13550","Z53014",3716,527,168,359," 9.7"
"13551","Z53015",1087,92,57,35," 3.2"
"13552","Z53016",149,11,0,11," 7.4"
"13553","Z53017",2304,96,75,21," 0.9"
"13554","Z53018",3146,132,71,61," 1.9"
"13555","Z53019",822,79,7,72," 8.8"
"13556","Z53020",1877,241,192,49," 2.6"
"13557","Z53021",1921,87,0,87," 4.5"
"13558","Z53022",7917,316,92,224," 2.8"
"13559","Z53023",561,29,9,20," 3.6"
"13560","Z53024",6948,346,73,273," 3.9"
"13561","Z53027",9305,562,135,427," 4.6"
"13562","Z53029",8123,456,310,146," 1.8"
"13563","Z53032",2056,265,11,254,"12.4"
"13564","Z53033",2063,122,93,29," 1.4"
"13565","Z53034",811,80,29,51," 6.3"
"13566","Z53035",1046,120,28,92," 8.8"
"13567","Z53036",1108,109,59,50," 4.5"
"13568","Z53037",4044,164,14,150," 3.7"
"13569","Z53038",1653,59,11,48," 2.9"
"13570","Z53039",1870,250,146,104," 5.6"
"13571","Z53040",3028,44,0,44," 1.5"
"13572","Z53042",3116,214,148,66," 2.1"
"13573","Z53045",8843,434,53,381," 4.3"
"13574","Z53046",520,31,9,22," 4.2"
"13575","Z53048",1366,120,0,120," 8.8"
"13576","Z53049",1123,213,194,19," 1.7"
"13577","Z53050",2999,240,9,231," 7.7"
"13578","Z53051",15222,556,30,526," 3.5"
"13579","Z53057",705,60,43,17," 2.4"
"13580","Z53058",1621,197,136,61," 3.8"
"13581","Z53059",731,54,11,43," 5.9"
"13582","Z53061",2396,235,27,208," 8.7"
"13583","Z53063",648,46,23,23," 3.5"
"13584","Z53065",961,46,11,35," 3.6"
"13585","Z53066",14487,1156,748,408," 2.8"
"13586","Z53070",2092,184,109,75," 3.6"
"13587","Z53072",10981,532,169,363," 3.3"
"13588","Z53073",6491,513,139,374," 5.8"
"13589","Z53074",5589,306,118,188," 3.4"
"13590","Z53075",1406,94,44,50," 3.6"
"13591","Z53076",1247,73,3,70," 5.6"
"13592","Z53078",731,9,0,9," 1.2"
"13593","Z53079",643,82,55,27," 4.2"
"13594","Z53080",2432,149,0,149," 6.1"
"13595","Z53081",19515,1542,256,1286," 6.6"
"13596","Z53083",8587,633,82,551," 6.4"
"13597","Z53085",5044,272,32,240," 4.8"
"13598","Z53086",3374,147,0,147," 4.4"
"13599","Z53088",207,6,0,6," 2.9"
"13600","Z53089",7213,212,48,164," 2.3"
"13601","Z53090",8941,397,4,393," 4.4"
"13602","Z53091",864,60,0,60," 6.9"
"13603","Z53093",792,46,4,42," 5.3"
"13604","Z53094",8054,515,37,478," 5.9"
"13605","Z53095",12080,565,139,426," 3.5"
"13606","Z53097",2204,207,73,134," 6.1"
"13607","Z53098",4960,493,88,405," 8.2"
"13608","Z53103",1472,22,14,8," 0.5"
"13609","Z53104",2287,235,72,163," 7.1"
"13610","Z53105",12509,1295,589,706," 5.6"
"13611","Z53108",1272,49,40,9," 0.7"
"13612","Z53110",8204,484,0,484," 5.9"
"13613","Z53114",1060,89,9,80," 7.5"
"13614","Z53115",8198,2000,1439,561," 6.8"
"13615","Z53118",3015,189,93,96," 3.2"
"13616","Z53119",2083,119,101,18," 0.9"
"13617","Z53120",4488,443,289,154," 3.4"
"13618","Z53121",8359,904,703,201," 2.4"
"13619","Z53122",2473,178,0,178," 7.2"
"13620","Z53125",2605,1850,1711,139," 5.3"
"13621","Z53126",2669,26,6,20," 0.7"
"13622","Z53128",4224,1123,794,329," 7.8"
"13623","Z53129",6126,267,25,242," 4.0"
"13624","Z53130",3418,210,0,210," 6.1"
"13625","Z53132",13745,635,57,578," 4.2"
"13626","Z53139",1425,235,134,101," 7.1"
"13627","Z53140",13213,1424,110,1314," 9.9"
"13628","Z53142",12429,697,89,608," 4.9"
"13629","Z53143",9779,1082,200,882," 9.0"
"13630","Z53144",10447,596,87,509," 4.9"
"13631","Z53146",3119,42,0,42," 1.3"
"13632","Z53147",10098,3476,2764,712," 7.1"
"13633","Z53149",7586,251,47,204," 2.7"
"13634","Z53150",10130,679,176,503," 5.0"
"13635","Z53151",14105,466,32,434," 3.1"
"13636","Z53153",882,21,12,9," 1.0"
"13637","Z53154",14395,368,63,305," 2.1"
"13638","Z53156",1414,221,130,91," 6.4"
"13639","Z53158",6466,451,51,400," 6.2"
"13640","Z53168",3801,528,270,258," 6.8"
"13641","Z53170",1113,267,147,120,"10.8"
"13642","Z53172",8956,502,0,502," 5.6"
"13643","Z53177",2794,120,37,83," 3.0"
"13644","Z53178",1177,52,6,46," 3.9"
"13645","Z53179",2430,173,123,50," 2.1"
"13646","Z53181",3795,1052,671,381,"10.0"
"13647","Z53182",3446,138,3,135," 3.9"
"13648","Z53183",1125,41,22,19," 1.7"
"13649","Z53184",1788,145,62,83," 4.6"
"13650","Z53185",7442,452,211,241," 3.2"
"13651","Z53186",14298,550,8,542," 3.8"
"13652","Z53188",14596,501,43,458," 3.1"
"13653","Z53189",9983,194,22,172," 1.7"
"13654","Z53190",7450,1012,494,518," 7.0"
"13655","Z53191",2320,1042,822,220," 9.5"
"13656","Z53202",16971,1651,322,1329," 7.8"
"13657","Z53203",836,74,17,57," 6.8"
"13658","Z53204",14865,1795,74,1721,"11.6"
"13659","Z53205",4057,575,10,565,"13.9"
"13660","Z53206",11323,2757,22,2735,"24.2"
"13661","Z53207",17518,872,44,828," 4.7"
"13662","Z53208",14578,2289,27,2262,"15.5"
"13663","Z53209",20948,2694,159,2535,"12.1"
"13664","Z53210",11675,1997,18,1979,"17.0"
"13665","Z53211",15579,1048,72,976," 6.3"
"13666","Z53212",15183,1856,29,1827,"12.0"
"13667","Z53213",12007,567,34,533," 4.4"
"13668","Z53214",16988,1188,27,1161," 6.8"
"13669","Z53215",21383,1980,91,1889," 8.8"
"13670","Z53216",14065,1222,9,1213," 8.6"
"13671","Z53217",12020,494,115,379," 3.2"
"13672","Z53218",15624,1587,30,1557,"10.0"
"13673","Z53219",16332,789,40,749," 4.6"
"13674","Z53220",12374,685,6,679," 5.5"
"13675","Z53221",16370,878,14,864," 5.3"
"13676","Z53222",11910,663,59,604," 5.1"
"13677","Z53223",13625,1109,41,1068," 7.8"
"13678","Z53224",8705,781,25,756," 8.7"
"13679","Z53225",10635,1043,0,1043," 9.8"
"13680","Z53226",8536,385,50,335," 3.9"
"13681","Z53227",11402,753,47,706," 6.2"
"13682","Z53228",6696,366,66,300," 4.5"
"13683","Z53233",5478,863,60,803,"14.7"
"13684","Z53402",14235,1258,74,1184," 8.3"
"13685","Z53403",11881,1354,144,1210,"10.2"
"13686","Z53404",6187,887,94,793,"12.8"
"13687","Z53405",10947,1082,28,1054," 9.6"
"13688","Z53406",11644,642,175,467," 4.0"
"13689","Z53502",1045,62,28,34," 3.3"
"13690","Z53503",849,55,26,29," 3.4"
"13691","Z53504",938,116,55,61," 6.5"
"13692","Z53505",181,3,3,0," 0.0"
"13693","Z53506",610,152,111,41," 6.7"
"13694","Z53507",930,65,33,32," 3.4"
"13695","Z53508",2194,120,0,120," 5.5"
"13696","Z53510",636,27,0,27," 4.2"
"13697","Z53511",20445,1584,110,1474," 7.2"
"13698","Z53515",1011,65,11,54," 5.3"
"13699","Z53516",1005,95,22,73," 7.3"
"13700","Z53518",738,157,88,69," 9.3"
"13701","Z53520",2830,194,88,106," 3.7"
"13702","Z53521",1433,69,26,43," 3.0"
"13703","Z53522",485,70,40,30," 6.2"
"13704","Z53523",2404,410,309,101," 4.2"
"13705","Z53525",1571,83,19,64," 4.1"
"13706","Z53526",289,21,0,21," 7.3"
"13707","Z53527",3832,134,44,90," 2.3"
"13708","Z53528",2344,85,27,58," 2.5"
"13709","Z53529",896,19,0,19," 2.1"
"13710","Z53530",1936,130,37,93," 4.8"
"13711","Z53531",1742,35,0,35," 2.0"
"13712","Z53532",5624,57,13,44," 0.8"
"13713","Z53533",3128,193,48,145," 4.6"
"13714","Z53534",5685,661,480,181," 3.2"
"13715","Z53536",3579,227,12,215," 6.0"
"13716","Z53537",260,19,0,19," 7.3"
"13717","Z53538",8141,612,296,316," 3.9"
"13718","Z53541",393,54,26,28," 7.1"
"13719","Z53543",782,105,36,69," 8.8"
"13720","Z53545",10416,760,211,549," 5.3"
"13721","Z53546",12814,530,80,450," 3.5"
"13722","Z53548",7807,503,26,477," 6.1"
"13723","Z53549",4068,173,38,135," 3.3"
"13724","Z53550",464,27,0,27," 5.8"
"13725","Z53551",3736,405,291,114," 3.1"
"13726","Z53554",469,35,12,23," 4.9"
"13727","Z53555",4224,744,617,127," 3.0"
"13728","Z53556",1230,140,51,89," 7.2"
"13729","Z53558",4734,93,35,58," 1.2"
"13730","Z53559",2313,94,15,79," 3.4"
"13731","Z53560",1522,78,38,40," 2.6"
"13732","Z53562",11253,346,115,231," 2.1"
"13733","Z53563",4569,237,71,166," 3.6"
"13734","Z53565",2186,229,62,167," 7.6"
"13735","Z53566",6822,422,52,370," 5.4"
"13736","Z53569",514,65,24,41," 8.0"
"13737","Z53570",1166,65,16,49," 4.2"
"13738","Z53572",4206,161,31,130," 3.1"
"13739","Z53573",1599,271,172,99," 6.2"
"13740","Z53574",1606,89,17,72," 4.5"
"13741","Z53575",6212,366,14,352," 5.7"
"13742","Z53576",973,63,0,63," 6.5"
"13743","Z53577",641,75,38,37," 5.8"
"13744","Z53578",2694,228,134,94," 3.5"
"13745","Z53581",5115,596,369,227," 4.4"
"13746","Z53582",479,50,30,20," 4.2"
"13747","Z53583",2466,189,64,125," 5.1"
"13748","Z53585",997,123,2,121,"12.1"
"13749","Z53586",1011,65,8,57," 5.6"
"13750","Z53588",2005,303,139,164," 8.2"
"13751","Z53589",8515,395,129,266," 3.1"
"13752","Z53590",15266,692,13,679," 4.4"
"13753","Z53593",8597,345,14,331," 3.9"
"13754","Z53594",2249,175,0,175," 7.8"
"13755","Z53597",6738,174,0,174," 2.6"
"13756","Z53598",1167,74,0,74," 6.3"
"13757","Z53703",15463,1054,163,891," 5.8"
"13758","Z53704",21256,912,22,890," 4.2"
"13759","Z53705",12179,739,48,691," 5.7"
"13760","Z53711",20049,577,54,523," 2.6"
"13761","Z53713",10764,686,55,631," 5.9"
"13762","Z53714",7460,258,7,251," 3.4"
"13763","Z53715",5167,278,0,278," 5.4"
"13764","Z53716",8369,211,0,211," 2.5"
"13765","Z53717",6012,114,32,82," 1.4"
"13766","Z53718",5726,246,0,246," 4.3"
"13767","Z53719",13772,610,17,593," 4.3"
"13768","Z53726",2341,54,0,54," 2.3"
"13769","Z53801",737,336,268,68," 9.2"
"13770","Z53803",583,39,10,29," 5.0"
"13771","Z53804",587,51,6,45," 7.7"
"13772","Z53805",2348,289,152,137," 5.8"
"13773","Z53806",998,260,113,147,"14.7"
"13774","Z53807",1942,53,8,45," 2.3"
"13775","Z53808",487,7,0,7," 1.4"
"13776","Z53809",1809,244,83,161," 8.9"
"13777","Z53811",1322,88,39,49," 3.7"
"13778","Z53813",2617,219,14,205," 7.8"
"13779","Z53816",356,82,52,30," 8.4"
"13780","Z53817",87,17,0,17,"19.5"
"13781","Z53818",5333,263,36,227," 4.3"
"13782","Z53820",1165,112,60,52," 4.5"
"13783","Z53821",4112,726,475,251," 6.1"
"13784","Z53826",619,139,47,92,"14.9"
"13785","Z53901",6458,708,264,444," 6.9"
"13786","Z53910",1899,680,377,303,"16.0"
"13787","Z53911",583,32,8,24," 4.1"
"13788","Z53913",9466,905,346,559," 5.9"
"13789","Z53916",10340,1187,363,824," 8.0"
"13790","Z53919",1034,36,6,30," 2.9"
"13791","Z53920",319,145,125,20," 6.3"
"13792","Z53922",425,23,2,21," 4.9"
"13793","Z53923",788,75,18,57," 7.2"
"13794","Z53924",685,112,61,51," 7.4"
"13795","Z53925",3588,370,6,364,"10.1"
"13796","Z53926",508,67,31,36," 7.1"
"13797","Z53929",1285,225,89,136,"10.6"
"13798","Z53930",602,93,48,45," 7.5"
"13799","Z53931",96,4,0,4," 4.2"
"13800","Z53932",1101,111,20,91," 8.3"
"13801","Z53933",1658,498,359,139," 8.4"
"13802","Z53934",4036,2272,1817,455,"11.3"
"13803","Z53935",117,5,0,5," 4.3"
"13804","Z53936",1150,643,491,152,"13.2"
"13805","Z53937",439,96,65,31," 7.1"
"13806","Z53939",106,11,5,6," 5.7"
"13807","Z53941",1929,762,636,126," 6.5"
"13808","Z53943",453,53,16,37," 8.2"
"13809","Z53944",1244,407,343,64," 5.1"
"13810","Z53946",2686,803,675,128," 4.8"
"13811","Z53948",4346,1182,644,538,"12.4"
"13812","Z53949",4110,1588,1378,210," 5.1"
"13813","Z53950",2879,1026,808,218," 7.6"
"13814","Z53951",1064,184,92,92," 8.6"
"13815","Z53952",2270,905,764,141," 6.2"
"13816","Z53954",3087,295,135,160," 5.2"
"13817","Z53955",2833,509,278,231," 8.2"
"13818","Z53956",1358,178,57,121," 8.9"
"13819","Z53959",5770,312,93,219," 3.8"
"13820","Z53960",1490,81,13,68," 4.6"
"13821","Z53961",351,57,20,37,"10.5"
"13822","Z53963",5152,310,3,307," 6.0"
"13823","Z53964",2094,661,523,138," 6.6"
"13824","Z53965",6735,2798,1779,1019,"15.1"
"13825","Z53968",1132,179,52,127,"11.2"
"13826","Z54001",4291,891,693,198," 4.6"
"13827","Z54002",2754,193,0,193," 7.0"
"13828","Z54003",398,40,16,24," 6.0"
"13829","Z54005",1289,101,35,66," 5.1"
"13830","Z54006",350,38,38,0," 0.0"
"13831","Z54007",522,37,8,29," 5.6"
"13832","Z54009",1038,107,49,58," 5.6"
"13833","Z54011",2667,111,20,91," 3.4"
"13834","Z54013",1346,45,17,28," 2.1"
"13835","Z54014",910,83,48,35," 3.8"
"13836","Z54015",1313,52,0,52," 4.0"
"13837","Z54016",12557,511,94,417," 3.3"
"13838","Z54017",6572,333,141,192," 2.9"
"13839","Z54020",3223,403,143,260," 8.1"
"13840","Z54021",2592,200,65,135," 5.2"
"13841","Z54022",8674,573,116,457," 5.3"
"13842","Z54023",1495,77,0,77," 5.2"
"13843","Z54024",2790,693,505,188," 6.7"
"13844","Z54025",2696,167,42,125," 4.6"
"13845","Z54026",837,150,89,61," 7.3"
"13846","Z54027",413,45,0,45,"10.9"
"13847","Z54028",973,77,4,73," 7.5"
"13848","Z54082",706,139,0,139,"19.7"
"13849","Z54101",1120,68,39,29," 2.6"
"13850","Z54102",1375,962,888,74," 5.4"
"13851","Z54104",2608,2045,1998,47," 1.8"
"13852","Z54106",1975,145,44,101," 5.1"
"13853","Z54107",1491,134,46,88," 5.9"
"13854","Z54110",2173,169,42,127," 5.8"
"13855","Z54111",1199,267,202,65," 5.4"
"13856","Z54112",1096,100,50,50," 4.6"
"13857","Z54114",6213,3748,3370,378," 6.1"
"13858","Z54115",17305,706,178,528," 3.1"
"13859","Z54119",849,591,553,38," 4.5"
"13860","Z54121",3139,1775,1587,188," 6.0"
"13861","Z54123",115,15,0,15,"13.0"
"13862","Z54124",1899,359,207,152," 8.0"
"13863","Z54125",512,206,178,28," 5.5"
"13864","Z54126",1370,49,7,42," 3.1"
"13865","Z54128",959,257,198,59," 6.2"
"13866","Z54129",1461,170,107,63," 4.3"
"13867","Z54130",10365,479,22,457," 4.4"
"13868","Z54135",1890,1010,961,49," 2.6"
"13869","Z54136",2788,101,0,101," 3.6"
"13870","Z54137",464,31,0,31," 6.7"
"13871","Z54138",1391,973,900,73," 5.2"
"13872","Z54139",1380,141,71,70," 5.1"
"13873","Z54140",3941,332,0,332," 8.4"
"13874","Z54141",991,72,54,18," 1.8"
"13875","Z54143",7402,705,158,547," 7.4"
"13876","Z54149",1921,1276,1182,94," 4.9"
"13877","Z54151",1910,460,319,141," 7.4"
"13878","Z54153",3548,553,212,341," 9.6"
"13879","Z54154",2729,343,52,291,"10.7"
"13880","Z54155",2434,158,0,158," 6.5"
"13881","Z54156",2132,1490,1360,130," 6.1"
"13882","Z54157",2851,403,181,222," 7.8"
"13883","Z54159",846,248,185,63," 7.4"
"13884","Z54160",107,2,0,2," 1.9"
"13885","Z54161",2379,1142,1035,107," 4.5"
"13886","Z54162",3681,350,78,272," 7.4"
"13887","Z54165",3092,232,0,232," 7.5"
"13888","Z54166",8873,1591,1013,578," 6.5"
"13889","Z54169",982,17,17,0," 0.0"
"13890","Z54170",1526,130,73,57," 3.7"
"13891","Z54173",1683,171,54,117," 7.0"
"13892","Z54174",2445,1215,1020,195," 8.0"
"13893","Z54175",1929,1471,1415,56," 2.9"
"13894","Z54177",2823,1444,1310,134," 4.7"
"13895","Z54201",2756,528,339,189," 6.9"
"13896","Z54202",1757,1042,851,191,"10.9"
"13897","Z54204",1024,322,272,50," 4.9"
"13898","Z54205",909,67,12,55," 6.1"
"13899","Z54208",2552,172,34,138," 5.4"
"13900","Z54209",2114,1514,1132,382,"18.1"
"13901","Z54210",1335,899,769,130," 9.7"
"13902","Z54211",691,565,478,87,"12.6"
"13903","Z54212",1643,1172,978,194,"11.8"
"13904","Z54213",599,113,36,77,"12.9"
"13905","Z54214",120,21,0,21,"17.5"
"13906","Z54216",3076,427,164,263," 8.6"
"13907","Z54217",3069,371,235,136," 4.4"
"13908","Z54220",18695,1627,221,1406," 7.5"
"13909","Z54227",661,28,3,25," 3.8"
"13910","Z54228",1214,122,22,100," 8.2"
"13911","Z54229",1761,85,13,72," 4.1"
"13912","Z54230",1928,157,27,130," 6.7"
"13913","Z54234",2262,1485,1057,428,"18.9"
"13914","Z54235",11366,3390,2613,777," 6.8"
"13915","Z54241",6959,664,147,517," 7.4"
"13916","Z54245",1088,125,44,81," 7.4"
"13917","Z54246",1000,606,525,81," 8.1"
"13918","Z54247",1002,81,2,79," 7.9"
"13919","Z54301",10011,890,44,846," 8.5"
"13920","Z54302",13657,933,9,924," 6.8"
"13921","Z54303",12428,762,31,731," 5.9"
"13922","Z54304",13265,556,15,541," 4.1"
"13923","Z54311",13687,610,110,500," 3.7"
"13924","Z54313",14323,540,81,459," 3.2"
"13925","Z54401",13931,1015,97,918," 6.6"
"13926","Z54403",11017,943,74,869," 7.9"
"13927","Z54405",1207,69,5,64," 5.3"
"13928","Z54406",1452,124,54,70," 4.8"
"13929","Z54407",730,139,84,55," 7.5"
"13930","Z54408",476,51,22,29," 6.1"
"13931","Z54409",6277,509,159,350," 5.6"
"13932","Z54410",876,76,6,70," 8.0"
"13933","Z54411",2060,161,32,129," 6.3"
"13934","Z54412",833,57,26,31," 3.7"
"13935","Z54413",96,44,42,2," 2.1"
"13936","Z54414",1501,248,153,95," 6.3"
"13937","Z54418",538,139,110,29," 5.4"
"13938","Z54420",468,26,10,16," 3.4"
"13939","Z54421",1303,99,6,93," 7.1"
"13940","Z54423",961,81,11,70," 7.3"
"13941","Z54425",836,42,0,42," 5.0"
"13942","Z54426",1660,82,16,66," 4.0"
"13943","Z54427",485,49,26,23," 4.7"
"13944","Z54428",1390,834,749,85," 6.1"
"13945","Z54433",943,226,181,45," 4.8"
"13946","Z54435",1671,768,712,56," 3.4"
"13947","Z54436",974,185,99,86," 8.8"
"13948","Z54437",1344,180,112,68," 5.1"
"13949","Z54440",1359,122,91,31," 2.3"
"13950","Z54442",669,239,206,33," 4.9"
"13951","Z54443",982,110,57,53," 5.4"
"13952","Z54446",1204,77,7,70," 5.8"
"13953","Z54448",1732,100,30,70," 4.0"
"13954","Z54449",11871,680,88,592," 5.0"
"13955","Z54451",5793,730,480,250," 4.3"
"13956","Z54452",9087,1089,465,624," 6.9"
"13957","Z54455",7259,692,212,480," 6.6"
"13958","Z54456",3149,586,344,242," 7.7"
"13959","Z54457",6262,2682,2086,596," 9.5"
"13960","Z54460",1127,116,33,83," 7.4"
"13961","Z54462",411,256,236,20," 4.9"
"13962","Z54466",1616,409,322,87," 5.4"
"13963","Z54467",6179,529,70,459," 7.4"
"13964","Z54469",735,56,2,54," 7.3"
"13965","Z54470",1233,302,224,78," 6.3"
"13966","Z54471",762,100,12,88,"11.5"
"13967","Z54473",1286,272,186,86," 6.7"
"13968","Z54474",1768,121,19,102," 5.8"
"13969","Z54476",8258,480,5,475," 5.8"
"13970","Z54479",1677,104,26,78," 4.7"
"13971","Z54480",559,20,10,10," 1.8"
"13972","Z54481",12151,695,81,614," 5.1"
"13973","Z54484",2031,68,13,55," 2.7"
"13974","Z54485",403,267,260,7," 1.7"
"13975","Z54486",1298,290,210,80," 6.2"
"13976","Z54487",7887,3334,3019,315," 4.0"
"13977","Z54488",404,15,0,15," 3.7"
"13978","Z54489",679,80,31,49," 7.2"
"13979","Z54490",625,250,225,25," 4.0"
"13980","Z54491",1727,989,898,91," 5.3"
"13981","Z54493",553,297,231,66,"11.9"
"13982","Z54494",12479,770,62,708," 5.7"
"13983","Z54495",3729,289,94,195," 5.2"
"13984","Z54498",967,122,71,51," 5.3"
"13985","Z54499",1465,241,133,108," 7.4"
"13986","Z54501",11997,3852,2870,982," 8.2"
"13987","Z54511",1489,938,867,71," 4.8"
"13988","Z54512",1190,784,650,134,"11.3"
"13989","Z54514",1533,673,580,93," 6.1"
"13990","Z54515",375,151,141,10," 2.7"
"13991","Z54519",1521,940,857,83," 5.5"
"13992","Z54520",3271,1506,1220,286," 8.7"
"13993","Z54521",7658,3859,3385,474," 6.2"
"13994","Z54524",624,210,181,29," 4.6"
"13995","Z54526",503,139,121,18," 3.6"
"13996","Z54527",985,532,402,130,"13.2"
"13997","Z54529",1362,895,864,31," 2.3"
"13998","Z54531",1581,937,915,22," 1.4"
"13999","Z54534",1826,668,487,181," 9.9"
"14000","Z54538",3390,1895,1689,206," 6.1"
"14001","Z54540",1612,1118,1007,111," 6.9"
"14002","Z54545",1460,1008,913,95," 6.5"
"14003","Z54546",905,375,331,44," 4.9"
"14004","Z54547",2132,1452,1354,98," 4.6"
"14005","Z54548",5174,3094,2722,372," 7.2"
"14006","Z54550",419,128,118,10," 2.4"
"14007","Z54552",3550,1494,1237,257," 7.2"
"14008","Z54554",1495,942,766,176,"11.8"
"14009","Z54555",3807,1467,1215,252," 6.6"
"14010","Z54556",814,224,129,95,"11.7"
"14011","Z54557",2279,1783,1649,134," 5.9"
"14012","Z54558",2431,1390,1214,176," 7.2"
"14013","Z54560",624,408,358,50," 8.0"
"14014","Z54562",3087,2280,2190,90," 2.9"
"14015","Z54566",1353,796,643,153,"11.3"
"14016","Z54568",4081,1722,1449,273," 6.7"
"14017","Z54601",20942,1305,133,1172," 5.6"
"14018","Z54603",6698,342,64,278," 4.2"
"14019","Z54610",976,270,162,108,"11.1"
"14020","Z54612",2037,145,30,115," 5.6"
"14021","Z54613",2483,1697,1420,277,"11.2"
"14022","Z54614",1258,55,13,42," 3.3"
"14023","Z54615",4642,579,261,318," 6.9"
"14024","Z54616",1178,145,36,109," 9.3"
"14025","Z54618",1076,222,159,63," 5.9"
"14026","Z54619",1378,131,44,87," 6.3"
"14027","Z54622",1137,170,107,63," 5.5"
"14028","Z54623",854,57,14,43," 5.0"
"14029","Z54624",960,334,271,63," 6.6"
"14030","Z54627",878,91,43,48," 5.5"
"14031","Z54628",778,343,274,69," 8.9"
"14032","Z54629",1271,164,65,99," 7.8"
"14033","Z54630",1745,78,9,69," 4.0"
"14034","Z54631",927,210,116,94,"10.1"
"14035","Z54632",551,93,46,47," 8.5"
"14036","Z54634",1915,309,197,112," 5.8"
"14037","Z54635",895,151,94,57," 6.4"
"14038","Z54636",5645,259,0,259," 4.6"
"14039","Z54638",697,94,68,26," 3.7"
"14040","Z54639",1166,241,201,40," 3.4"
"14041","Z54642",934,140,105,35," 3.7"
"14042","Z54644",571,18,12,6," 1.1"
"14043","Z54646",2815,1299,979,320,"11.4"
"14044","Z54648",666,108,50,58," 8.7"
"14045","Z54650",10005,539,108,431," 4.3"
"14046","Z54651",628,141,77,64,"10.2"
"14047","Z54656",7543,490,142,348," 4.6"
"14048","Z54658",1121,92,45,47," 4.2"
"14049","Z54659",608,86,59,27," 4.4"
"14050","Z54660",7046,509,91,418," 5.9"
"14051","Z54661",1592,123,55,68," 4.3"
"14052","Z54665",3938,445,161,284," 7.2"
"14053","Z54666",1612,501,349,152," 9.4"
"14054","Z54667",1969,171,83,88," 4.5"
"14055","Z54669",3127,118,30,88," 2.8"
"14056","Z54670",625,59,26,33," 5.3"
"14057","Z54701",16772,923,12,911," 5.4"
"14058","Z54703",18341,934,171,763," 4.2"
"14059","Z54720",3060,139,0,139," 4.5"
"14060","Z54721",619,80,35,45," 7.3"
"14061","Z54722",1841,417,302,115," 6.2"
"14062","Z54723",584,42,12,30," 5.1"
"14063","Z54724",3059,275,123,152," 5.0"
"14064","Z54725",1267,111,36,75," 5.9"
"14065","Z54726",750,73,37,36," 4.8"
"14066","Z54727",2132,175,58,117," 5.5"
"14067","Z54728",3605,1019,821,198," 5.5"
"14068","Z54729",14054,704,218,486," 3.5"
"14069","Z54730",2173,233,145,88," 4.0"
"14070","Z54731",411,151,96,55,"13.4"
"14071","Z54732",1356,189,95,94," 6.9"
"14072","Z54733",519,59,31,28," 5.4"
"14073","Z54734",357,42,5,37,"10.4"
"14074","Z54736",1771,168,38,130," 7.3"
"14075","Z54737",248,26,13,13," 5.2"
"14076","Z54738",1227,68,24,44," 3.6"
"14077","Z54739",1863,111,10,101," 5.4"
"14078","Z54740",878,74,20,54," 6.2"
"14079","Z54741",807,181,108,73," 9.0"
"14080","Z54742",1775,124,61,63," 3.5"
"14081","Z54745",1511,629,569,60," 4.0"
"14082","Z54747",1245,125,36,89," 7.1"
"14083","Z54748",714,120,44,76,"10.6"
"14084","Z54749",559,68,14,54," 9.7"
"14085","Z54750",498,79,51,28," 5.6"
"14086","Z54751",10228,871,186,685," 6.7"
"14087","Z54754",1296,551,479,72," 5.6"
"14088","Z54755",3187,232,92,140," 4.4"
"14089","Z54756",488,54,30,24," 4.9"
"14090","Z54757",2100,767,717,50," 2.4"
"14091","Z54758",2067,203,79,124," 6.0"
"14092","Z54759",904,279,177,102,"11.3"
"14093","Z54760",99,9,0,9," 9.1"
"14094","Z54761",519,50,17,33," 6.4"
"14095","Z54762",606,96,45,51," 8.4"
"14096","Z54763",505,68,22,46," 9.1"
"14097","Z54767",1446,121,36,85," 5.9"
"14098","Z54768",2018,214,90,124," 6.1"
"14099","Z54771",1764,246,105,141," 8.0"
"14100","Z54772",467,72,38,34," 7.3"
"14101","Z54773",1402,107,22,85," 6.1"
"14102","Z54801",4915,1937,1714,223," 4.5"
"14103","Z54805",721,182,124,58," 8.0"
"14104","Z54806",5547,590,304,286," 5.2"
"14105","Z54810",2166,1231,1062,169," 7.8"
"14106","Z54812",2225,173,43,130," 5.8"
"14107","Z54814",1827,712,560,152," 8.3"
"14108","Z54817",2267,1236,1139,97," 4.3"
"14109","Z54819",1699,559,414,145," 8.5"
"14110","Z54820",500,175,149,26," 5.2"
"14111","Z54821",1789,1106,967,139," 7.8"
"14112","Z54822",2104,239,172,67," 3.2"
"14113","Z54824",1179,221,175,46," 3.9"
"14114","Z54826",649,347,307,40," 6.2"
"14115","Z54827",408,297,260,37," 9.1"
"14116","Z54829",3316,1045,883,162," 4.9"
"14117","Z54830",5021,3489,3369,120," 2.4"
"14118","Z54832",615,395,362,33," 5.4"
"14119","Z54835",805,378,295,83,"10.3"
"14120","Z54836",463,91,68,23," 5.0"
"14121","Z54837",2152,646,431,215,"10.0"
"14122","Z54838",1639,1042,1018,24," 1.5"
"14123","Z54840",2909,920,741,179," 6.2"
"14124","Z54841",153,24,8,16,"10.5"
"14125","Z54842",73,19,13,6," 8.2"
"14126","Z54843",9588,4601,4029,572," 6.0"
"14127","Z54847",2062,1020,865,155," 7.5"
"14128","Z54848",3133,611,402,209," 6.7"
"14129","Z54849",1284,422,389,33," 2.6"
"14130","Z54850",888,784,753,31," 3.5"
"14131","Z54853",2686,966,797,169," 6.3"
"14132","Z54854",516,127,74,53,"10.3"
"14133","Z54855",353,91,74,17," 4.8"
"14134","Z54856",1058,424,360,64," 6.0"
"14135","Z54859",2306,1529,1480,49," 2.1"
"14136","Z54862",361,218,214,4," 1.1"
"14137","Z54864",578,42,22,20," 3.5"
"14138","Z54865",467,247,234,13," 2.8"
"14139","Z54867",312,169,121,48,"15.4"
"14140","Z54868",7786,896,329,567," 7.3"
"14141","Z54870",1548,826,796,30," 1.9"
"14142","Z54871",2016,662,582,80," 4.0"
"14143","Z54872",2197,912,828,84," 3.8"
"14144","Z54873",3024,1704,1568,136," 4.5"
"14145","Z54874",1643,134,102,32," 1.9"
"14146","Z54875",835,325,311,14," 1.7"
"14147","Z54876",2064,1362,1308,54," 2.6"
"14148","Z54880",14040,1118,273,845," 6.0"
"14149","Z54888",1434,835,791,44," 3.1"
"14150","Z54889",1789,649,550,99," 5.5"
"14151","Z54891",1774,231,169,62," 3.5"
"14152","Z54893",3781,2025,1900,125," 3.3"
"14153","Z54895",690,223,188,35," 5.1"
"14154","Z54896",2189,1493,1382,111," 5.1"
"14155","Z54901",14901,1345,134,1211," 8.1"
"14156","Z54902",10974,881,113,768," 7.0"
"14157","Z54904",8990,159,37,122," 1.4"
"14158","Z54909",1103,201,137,64," 5.8"
"14159","Z54911",11295,846,20,826," 7.3"
"14160","Z54913",7927,230,27,203," 2.6"
"14161","Z54914",13665,818,51,767," 5.6"
"14162","Z54915",16637,675,81,594," 3.6"
"14163","Z54921",547,76,35,41," 7.5"
"14164","Z54922",596,50,4,46," 7.7"
"14165","Z54923",4072,331,106,225," 5.5"
"14166","Z54927",261,32,17,15," 5.7"
"14167","Z54929",4341,601,341,260," 6.0"
"14168","Z54930",1117,443,351,92," 8.2"
"14169","Z54931",105,13,0,13,"12.4"
"14170","Z54933",111,4,0,4," 3.6"
"14171","Z54934",106,9,0,9," 8.5"
"14172","Z54935",19215,1257,0,1257," 6.5"
"14173","Z54937",7755,432,179,253," 3.3"
"14174","Z54940",2077,404,281,123," 5.9"
"14175","Z54941",1943,803,613,190," 9.8"
"14176","Z54942",3346,113,21,92," 2.7"
"14177","Z54943",1526,703,611,92," 6.0"
"14178","Z54944",3320,195,84,111," 3.3"
"14179","Z54945",2019,447,382,65," 3.2"
"14180","Z54947",1336,230,195,35," 2.6"
"14181","Z54949",1578,185,83,102," 6.5"
"14182","Z54950",1491,251,122,129," 8.7"
"14183","Z54952",11413,604,34,570," 5.0"
"14184","Z54956",18848,795,108,687," 3.6"
"14185","Z54960",2217,1028,896,132," 6.0"
"14186","Z54961",6277,543,225,318," 5.1"
"14187","Z54962",588,117,108,9," 1.5"
"14188","Z54963",2813,89,54,35," 1.2"
"14189","Z54964",456,41,14,27," 5.9"
"14190","Z54965",657,96,44,52," 7.9"
"14191","Z54966",982,221,151,70," 7.1"
"14192","Z54967",215,54,35,19," 8.8"
"14193","Z54968",1713,508,323,185,"10.8"
"14194","Z54970",1832,560,357,203,"11.1"
"14195","Z54971",4768,454,179,275," 5.8"
"14196","Z54974",596,35,13,22," 3.7"
"14197","Z54977",655,107,76,31," 4.7"
"14198","Z54979",605,54,14,40," 6.6"
"14199","Z54981",8128,1845,1303,542," 6.7"
"14200","Z54982",4491,1554,1247,307," 6.8"
"14201","Z54983",2135,400,261,139," 6.5"
"14202","Z54984",2599,1251,1099,152," 5.8"
"14203","Z54986",2554,503,313,190," 7.4"
"14204","Z55001",1245,65,36,29," 2.3"
"14205","Z55003",1100,87,30,57," 5.2"
"14206","Z55005",1493,59,4,55," 3.7"
"14207","Z55006",1636,177,55,122," 7.5"
"14208","Z55007",1221,283,178,105," 8.6"
"14209","Z55008",5956,398,274,124," 2.1"
"14210","Z55009",3335,206,63,143," 4.3"
"14211","Z55011",3786,253,129,124," 3.3"
"14212","Z55012",781,80,51,29," 3.7"
"14213","Z55013",2978,205,139,66," 2.2"
"14214","Z55014",10103,253,11,242," 2.4"
"14215","Z55016",12188,480,108,372," 3.1"
"14216","Z55018",393,11,0,11," 2.8"
"14217","Z55019",778,41,0,41," 5.3"
"14218","Z55021",11892,1066,472,594," 5.0"
"14219","Z55024",11901,373,45,328," 2.8"
"14220","Z55025",9367,467,123,344," 3.7"
"14221","Z55030",693,178,127,51," 7.4"
"14222","Z55031",826,24,6,18," 2.2"
"14223","Z55032",1310,122,86,36," 2.7"
"14224","Z55033",12440,630,156,474," 3.8"
"14225","Z55038",7653,320,8,312," 4.1"
"14226","Z55040",5180,416,189,227," 4.4"
"14227","Z55041",3748,466,230,236," 6.3"
"14228","Z55042",3174,81,0,81," 2.6"
"14229","Z55043",1564,129,58,71," 4.5"
"14230","Z55044",17068,479,137,342," 2.0"
"14231","Z55045",3307,405,147,258," 7.8"
"14232","Z55046",1965,149,53,96," 4.9"
"14233","Z55049",944,45,0,45," 4.8"
"14234","Z55051",4647,922,531,391," 8.4"
"14235","Z55052",920,105,45,60," 6.5"
"14236","Z55053",403,36,4,32," 7.9"
"14237","Z55055",1481,51,0,51," 3.4"
"14238","Z55056",5143,130,43,87," 1.7"
"14239","Z55057",8584,581,88,493," 5.7"
"14240","Z55060",12291,824,76,748," 6.1"
"14241","Z55063",4812,1092,712,380," 7.9"
"14242","Z55065",436,26,0,26," 6.0"
"14243","Z55066",8576,708,78,630," 7.3"
"14244","Z55068",10103,213,8,205," 2.0"
"14245","Z55069",2070,258,177,81," 3.9"
"14246","Z55070",2863,212,4,208," 7.3"
"14247","Z55071",2171,56,0,56," 2.6"
"14248","Z55072",2442,1010,854,156," 6.4"
"14249","Z55073",1359,109,109,0," 0.0"
"14250","Z55074",898,81,20,61," 6.8"
"14251","Z55075",8880,514,0,514," 5.8"
"14252","Z55076",8980,160,15,145," 1.6"
"14253","Z55077",5050,172,0,172," 3.4"
"14254","Z55079",3107,188,56,132," 4.2"
"14255","Z55080",1113,210,189,21," 1.9"
"14256","Z55082",14373,848,387,461," 3.2"
"14257","Z55084",669,40,6,34," 5.1"
"14258","Z55088",653,32,8,24," 3.7"
"14259","Z55090",167,6,0,6," 3.6"
"14260","Z55092",4102,91,32,59," 1.4"
"14261","Z55101",4423,214,34,180," 4.1"
"14262","Z55102",9741,857,67,790," 8.1"
"14263","Z55103",5207,299,0,299," 5.7"
"14264","Z55104",18224,1034,10,1024," 5.6"
"14265","Z55105",11532,419,23,396," 3.4"
"14266","Z55106",19451,1535,57,1478," 7.6"
"14267","Z55107",5713,387,0,387," 6.8"
"14268","Z55108",6494,328,69,259," 4.0"
"14269","Z55109",13539,462,65,397," 2.9"
"14270","Z55110",16433,657,53,604," 3.7"
"14271","Z55112",17493,565,100,465," 2.7"
"14272","Z55113",18211,939,141,798," 4.4"
"14273","Z55114",1742,73,0,73," 4.2"
"14274","Z55115",3421,158,14,144," 4.2"
"14275","Z55116",11911,570,40,530," 4.4"
"14276","Z55117",17094,1050,58,992," 5.8"
"14277","Z55118",12284,517,24,493," 4.0"
"14278","Z55119",15957,686,31,655," 4.1"
"14279","Z55120",1854,34,0,34," 1.8"
"14280","Z55121",3776,138,0,138," 3.7"
"14281","Z55122",13139,324,29,295," 2.2"
"14282","Z55124",19925,512,65,447," 2.2"
"14283","Z55125",16994,515,90,425," 2.5"
"14284","Z55126",11245,264,41,223," 2.0"
"14285","Z55127",7680,264,18,246," 3.2"
"14286","Z55128",11775,314,16,298," 2.5"
"14287","Z55129",7750,170,0,170," 2.2"
"14288","Z55130",5907,580,0,580," 9.8"
"14289","Z55150",80,4,0,4," 5.0"
"14290","Z55301",3662,108,0,108," 2.9"
"14291","Z55302",3994,1194,1001,193," 4.8"
"14292","Z55303",18026,627,64,563," 3.1"
"14293","Z55304",15841,349,71,278," 1.8"
"14294","Z55305",9879,613,227,386," 3.9"
"14295","Z55306",7007,369,74,295," 4.2"
"14296","Z55307",1398,94,11,83," 5.9"
"14297","Z55308",3183,180,38,142," 4.5"
"14298","Z55309",6467,390,146,244," 3.8"
"14299","Z55310",743,144,9,135,"18.2"
"14300","Z55311",12900,218,47,171," 1.3"
"14301","Z55312",709,51,3,48," 6.8"
"14302","Z55313",8992,589,194,395," 4.4"
"14303","Z55314",561,83,16,67,"11.9"
"14304","Z55316",8903,295,0,295," 3.3"
"14305","Z55317",7621,219,11,208," 2.7"
"14306","Z55318",10095,405,81,324," 3.2"
"14307","Z55319",2240,339,245,94," 4.2"
"14308","Z55320",2083,203,136,67," 3.2"
"14309","Z55321",1971,170,56,114," 5.8"
"14310","Z55322",1207,55,3,52," 4.3"
"14311","Z55324",694,173,134,39," 5.6"
"14312","Z55325",2135,442,379,63," 3.0"
"14313","Z55328",3286,114,35,79," 2.4"
"14314","Z55329",979,151,88,63," 6.4"
"14315","Z55330",13781,683,130,553," 4.0"
"14316","Z55331",7400,592,232,360," 4.9"
"14317","Z55332",850,122,1,121,"14.2"
"14318","Z55333",409,47,7,40," 9.8"
"14319","Z55334",1321,95,18,77," 5.8"
"14320","Z55336",3458,282,4,278," 8.0"
"14321","Z55337",19095,883,21,862," 4.5"
"14322","Z55338",437,20,5,15," 3.4"
"14323","Z55339",417,26,0,26," 6.2"
"14324","Z55340",2386,26,0,26," 1.1"
"14325","Z55341",1085,36,4,32," 2.9"
"14326","Z55342",1004,178,4,174,"17.3"
"14327","Z55343",11946,633,89,544," 4.6"
"14328","Z55344",7433,289,45,244," 3.3"
"14329","Z55345",9116,185,0,185," 2.0"
"14330","Z55346",6362,65,0,65," 1.0"
"14331","Z55347",11421,420,107,313," 2.7"
"14332","Z55349",1705,198,52,146," 8.6"
"14333","Z55350",7912,360,46,314," 4.0"
"14334","Z55352",3298,73,0,73," 2.2"
"14335","Z55353",1439,158,114,44," 3.1"
"14336","Z55354",1059,43,0,43," 4.1"
"14337","Z55355",4349,452,193,259," 6.0"
"14338","Z55356",2219,131,76,55," 2.5"
"14339","Z55357",1150,17,0,17," 1.5"
"14340","Z55358",2413,460,384,76," 3.1"
"14341","Z55359",2518,128,47,81," 3.2"
"14342","Z55360",927,27,0,27," 2.9"
"14343","Z55362",7212,323,130,193," 2.7"
"14344","Z55363",1787,142,21,121," 6.8"
"14345","Z55364",6538,441,171,270," 4.1"
"14346","Z55366",206,17,0,17," 8.3"
"14347","Z55367",403,9,0,9," 2.2"
"14348","Z55368",967,55,0,55," 5.7"
"14349","Z55369",14209,409,16,393," 2.8"
"14350","Z55370",353,15,0,15," 4.2"
"14351","Z55371",6618,434,234,200," 3.0"
"14352","Z55372",11656,441,114,327," 2.8"
"14353","Z55373",2124,100,0,100," 4.7"
"14354","Z55374",4881,121,0,121," 2.5"
"14355","Z55375",1519,38,0,38," 2.5"
"14356","Z55376",5517,152,73,79," 1.4"
"14357","Z55378",9767,190,16,174," 1.8"
"14358","Z55379",14930,618,138,480," 3.2"
"14359","Z55382",2087,686,611,75," 3.6"
"14360","Z55384",1070,83,11,72," 6.7"
"14361","Z55385",572,53,6,47," 8.2"
"14362","Z55386",2441,67,0,67," 2.7"
"14363","Z55387",5060,257,69,188," 3.7"
"14364","Z55388",2411,139,0,139," 5.8"
"14365","Z55389",1038,86,49,37," 3.6"
"14366","Z55390",1071,110,44,66," 6.2"
"14367","Z55391",6902,470,110,360," 5.2"
"14368","Z55395",1190,50,0,50," 4.2"
"14369","Z55396",983,116,4,112,"11.4"
"14370","Z55398",5686,451,219,232," 4.1"
"14371","Z55401",5510,634,177,457," 8.3"
"14372","Z55403",11512,1049,82,967," 8.4"
"14373","Z55404",13431,1371,40,1331," 9.9"
"14374","Z55405",7999,441,15,426," 5.3"
"14375","Z55406",15945,842,115,727," 4.6"
"14376","Z55407",15205,774,78,696," 4.6"
"14377","Z55408",16343,1049,44,1005," 6.1"
"14378","Z55409",5053,164,15,149," 2.9"
"14379","Z55410",8913,606,135,471," 5.3"
"14380","Z55411",10358,945,14,931," 9.0"
"14381","Z55412",9239,1091,8,1083,"11.7"
"14382","Z55413",6803,514,52,462," 6.8"
"14383","Z55414",10699,726,0,726," 6.8"
"14384","Z55415",1455,177,9,168,"11.5"
"14385","Z55416",16538,1092,132,960," 5.8"
"14386","Z55417",11309,262,48,214," 1.9"
"14387","Z55418",14054,837,13,824," 5.9"
"14388","Z55419",11163,496,92,404," 3.6"
"14389","Z55420",9593,338,7,331," 3.5"
"14390","Z55421",11937,675,25,650," 5.4"
"14391","Z55422",13028,611,0,611," 4.7"
"14392","Z55423",15915,809,47,762," 4.8"
"14393","Z55424",3560,118,16,102," 2.9"
"14394","Z55425",4248,209,71,138," 3.2"
"14395","Z55426",12221,544,40,504," 4.1"
"14396","Z55427",9932,353,0,353," 3.6"
"14397","Z55428",12245,497,57,440," 3.6"
"14398","Z55429",10917,685,6,679," 6.2"
"14399","Z55430",8564,528,10,518," 6.0"
"14400","Z55431",8484,409,16,393," 4.6"
"14401","Z55432",12745,356,12,344," 2.7"
"14402","Z55433",13941,371,5,366," 2.6"
"14403","Z55434",11421,427,38,389," 3.4"
"14404","Z55435",7188,568,77,491," 6.8"
"14405","Z55436",5954,575,166,409," 6.9"
"14406","Z55437",8247,381,61,320," 3.9"
"14407","Z55438",7715,188,70,118," 1.5"
"14408","Z55439",3626,178,33,145," 4.0"
"14409","Z55441",8135,375,99,276," 3.4"
"14410","Z55442",5906,286,0,286," 4.8"
"14411","Z55443",11596,793,0,793," 6.8"
"14412","Z55444",5482,350,0,350," 6.4"
"14413","Z55445",3800,162,23,139," 3.7"
"14414","Z55446",8829,391,55,336," 3.8"
"14415","Z55447",8874,261,85,176," 2.0"
"14416","Z55448",10782,241,7,234," 2.2"
"14417","Z55449",9406,163,0,163," 1.7"
"14418","Z55454",3335,244,39,205," 6.1"
"14419","Z55603",581,326,285,41," 7.1"
"14420","Z55604",3301,1745,1596,149," 4.5"
"14421","Z55606",406,291,258,33," 8.1"
"14422","Z55607",255,196,173,23," 9.0"
"14423","Z55612",1051,608,593,15," 1.4"
"14424","Z55614",1658,399,272,127," 7.7"
"14425","Z55616",4273,1086,813,273," 6.4"
"14426","Z55702",345,144,130,14," 4.1"
"14427","Z55703",432,85,53,32," 7.4"
"14428","Z55704",609,124,79,45," 7.4"
"14429","Z55705",1700,269,99,170,"10.0"
"14430","Z55706",1192,362,251,111," 9.3"
"14431","Z55707",1721,373,304,69," 4.0"
"14432","Z55708",555,77,3,74,"13.3"
"14433","Z55709",2692,930,839,91," 3.4"
"14434","Z55713",517,24,3,21," 4.1"
"14435","Z55718",1396,165,41,124," 8.9"
"14436","Z55719",2603,256,34,222," 8.5"
"14437","Z55720",7228,643,213,430," 5.9"
"14438","Z55721",1860,470,342,128," 6.9"
"14439","Z55722",555,98,50,48," 8.6"
"14440","Z55723",2544,1479,1390,89," 3.5"
"14441","Z55726",683,256,200,56," 8.2"
"14442","Z55731",5033,2199,1907,292," 5.8"
"14443","Z55732",796,190,137,53," 6.7"
"14444","Z55733",1677,64,0,64," 3.8"
"14445","Z55734",3412,622,413,209," 6.1"
"14446","Z55735",1492,729,634,95," 6.4"
"14447","Z55736",1041,362,295,67," 6.4"
"14448","Z55741",1792,308,147,161," 9.0"
"14449","Z55744",9877,1367,1131,236," 2.4"
"14450","Z55746",8881,1188,281,907,"10.2"
"14451","Z55748",1082,437,319,118,"10.9"
"14452","Z55750",1033,153,92,61," 5.9"
"14453","Z55751",718,81,24,57," 7.9"
"14454","Z55756",357,177,143,34," 9.5"
"14455","Z55757",599,207,173,34," 5.7"
"14456","Z55760",4026,2506,2305,201," 5.0"
"14457","Z55763",810,539,483,56," 6.9"
"14458","Z55764",304,61,41,20," 6.6"
"14459","Z55767",1957,405,306,99," 5.1"
"14460","Z55768",1428,103,42,61," 4.3"
"14461","Z55769",1570,517,414,103," 6.6"
"14462","Z55771",1879,1131,1043,88," 4.7"
"14463","Z55775",770,177,136,41," 5.3"
"14464","Z55779",1733,282,212,70," 4.0"
"14465","Z55780",72,18,15,3," 4.2"
"14466","Z55781",836,519,472,47," 5.6"
"14467","Z55782",292,84,52,32,"11.0"
"14468","Z55783",1823,883,787,96," 5.3"
"14469","Z55786",130,5,0,5," 3.8"
"14470","Z55790",2445,1481,1360,121," 4.9"
"14471","Z55792",5476,713,55,658,"12.0"
"14472","Z55795",949,389,323,66," 7.0"
"14473","Z55797",682,117,83,34," 5.0"
"14474","Z55802",1651,274,83,191,"11.6"
"14475","Z55803",8335,1349,1026,323," 3.9"
"14476","Z55804",6225,444,151,293," 4.7"
"14477","Z55805",5259,462,53,409," 7.8"
"14478","Z55806",4721,542,9,533,"11.3"
"14479","Z55807",4691,330,0,330," 7.0"
"14480","Z55808",2668,140,0,140," 5.2"
"14481","Z55810",3693,92,18,74," 2.0"
"14482","Z55811",11151,833,151,682," 6.1"
"14483","Z55812",3713,285,18,267," 7.2"
"14484","Z55901",22348,1076,78,998," 4.5"
"14485","Z55902",9985,537,145,392," 3.9"
"14486","Z55904",10538,714,89,625," 5.9"
"14487","Z55906",7873,580,19,561," 7.1"
"14488","Z55909",550,47,8,39," 7.1"
"14489","Z55910",582,42,12,30," 5.2"
"14490","Z55912",12512,1188,83,1105," 8.8"
"14491","Z55917",1476,89,7,82," 5.6"
"14492","Z55918",477,25,2,23," 4.8"
"14493","Z55919",534,88,58,30," 5.6"
"14494","Z55920",2652,146,7,139," 5.2"
"14495","Z55921",2217,287,88,199," 9.0"
"14496","Z55922",369,53,13,40,"10.8"
"14497","Z55923",2033,232,59,173," 8.5"
"14498","Z55924",610,79,27,52," 8.5"
"14499","Z55925",416,44,24,20," 4.8"
"14500","Z55926",322,37,3,34,"10.6"
"14501","Z55927",1539,40,6,34," 2.2"
"14502","Z55929",500,39,0,39," 7.8"
"14503","Z55932",864,61,19,42," 4.9"
"14504","Z55933",106,18,0,18,"17.0"
"14505","Z55934",1328,67,0,67," 5.0"
"14506","Z55936",791,83,5,78," 9.9"
"14507","Z55939",906,97,51,46," 5.1"
"14508","Z55940",1135,126,0,126,"11.1"
"14509","Z55941",422,40,9,31," 7.3"
"14510","Z55943",1434,139,46,93," 6.5"
"14511","Z55944",2867,124,0,124," 4.3"
"14512","Z55945",630,93,63,30," 4.8"
"14513","Z55946",1349,77,8,69," 5.1"
"14514","Z55947",3262,103,36,67," 2.1"
"14515","Z55949",1000,247,142,105,"10.5"
"14516","Z55951",666,63,8,55," 8.3"
"14517","Z55952",924,27,0,27," 2.9"
"14518","Z55953",395,40,0,40,"10.1"
"14519","Z55954",745,162,67,95,"12.8"
"14520","Z55955",956,15,0,15," 1.6"
"14521","Z55956",818,63,14,49," 6.0"
"14522","Z55957",277,26,17,9," 3.2"
"14523","Z55959",982,139,18,121,"12.3"
"14524","Z55960",1354,120,38,82," 6.1"
"14525","Z55961",196,25,4,21,"10.7"
"14526","Z55962",358,51,30,21," 5.9"
"14527","Z55963",2087,58,12,46," 2.2"
"14528","Z55964",1833,113,14,99," 5.4"
"14529","Z55965",1186,131,60,71," 6.0"
"14530","Z55967",354,14,5,9," 2.5"
"14531","Z55970",393,16,7,9," 2.3"
"14532","Z55971",1298,65,22,43," 3.3"
"14533","Z55972",1800,117,10,107," 5.9"
"14534","Z55973",135,12,0,12," 8.9"
"14535","Z55974",998,123,32,91," 9.1"
"14536","Z55975",2022,223,34,189," 9.3"
"14537","Z55976",3142,160,11,149," 4.7"
"14538","Z55981",2219,348,227,121," 5.5"
"14539","Z55983",654,45,0,45," 6.9"
"14540","Z55985",823,74,3,71," 8.6"
"14541","Z55987",14913,1375,276,1099," 7.4"
"14542","Z55991",628,87,39,48," 7.6"
"14543","Z55992",2092,140,0,140," 6.7"
"14544","Z56001",19208,1228,38,1190," 6.2"
"14545","Z56003",6370,160,44,116," 1.8"
"14546","Z56007",9881,726,67,659," 6.7"
"14547","Z56009",682,96,2,94,"13.8"
"14548","Z56010",549,68,8,60,"10.9"
"14549","Z56011",3366,372,7,365,"10.8"
"14550","Z56013",2088,114,10,104," 5.0"
"14551","Z56014",376,55,0,55,"14.6"
"14552","Z56016",433,48,8,40," 9.2"
"14553","Z56017",881,236,207,29," 3.3"
"14554","Z56020",54,4,0,4," 7.4"
"14555","Z56021",425,17,3,14," 3.3"
"14556","Z56022",48,15,0,15,"31.2"
"14557","Z56023",248,31,7,24," 9.7"
"14558","Z56024",1100,14,0,14," 1.3"
"14559","Z56025",232,8,0,8," 3.4"
"14560","Z56026",843,109,32,77," 9.1"
"14561","Z56027",466,66,0,66,"14.2"
"14562","Z56028",723,209,187,22," 3.0"
"14563","Z56029",333,31,0,31," 9.3"
"14564","Z56031",5936,603,182,421," 7.1"
"14565","Z56033",193,38,3,35,"18.1"
"14566","Z56034",256,28,13,15," 5.9"
"14567","Z56035",172,27,0,27,"15.7"
"14568","Z56039",457,44,1,43," 9.4"
"14569","Z56042",305,35,7,28," 9.2"
"14570","Z56043",227,10,0,10," 4.4"
"14571","Z56044",875,45,10,35," 4.0"
"14572","Z56045",370,49,6,43,"11.6"
"14573","Z56047",75,7,1,6," 8.0"
"14574","Z56048",1682,130,59,71," 4.2"
"14575","Z56050",744,84,36,48," 6.5"
"14576","Z56051",364,23,1,22," 6.0"
"14577","Z56055",1748,205,12,193,"11.0"
"14578","Z56056",37,5,0,5,"13.5"
"14579","Z56057",1637,125,40,85," 5.2"
"14580","Z56058",2631,186,52,134," 5.1"
"14581","Z56062",1405,155,8,147,"10.5"
"14582","Z56063",1492,362,288,74," 5.0"
"14583","Z56065",1123,103,11,92," 8.2"
"14584","Z56068",507,52,14,38," 7.5"
"14585","Z56069",1965,143,4,139," 7.1"
"14586","Z56071",4419,269,0,269," 6.1"
"14587","Z56072",1086,186,121,65," 6.0"
"14588","Z56073",7482,423,5,418," 5.6"
"14589","Z56074",835,57,0,57," 6.8"
"14590","Z56075",108,11,0,11,"10.2"
"14591","Z56078",180,11,6,5," 2.8"
"14592","Z56080",282,11,0,11," 3.9"
"14593","Z56081",2687,276,73,203," 7.6"
"14594","Z56082",4688,215,36,179," 3.8"
"14595","Z56083",454,68,1,67,"14.8"
"14596","Z56085",2370,232,36,196," 8.3"
"14597","Z56087",1430,159,20,139," 9.7"
"14598","Z56088",937,133,8,125,"13.3"
"14599","Z56090",299,19,0,19," 6.4"
"14600","Z56091",173,25,8,17," 9.8"
"14601","Z56093",5135,324,42,282," 5.5"
"14602","Z56096",1645,439,235,204,"12.4"
"14603","Z56097",1821,174,17,157," 8.6"
"14604","Z56098",1036,129,25,104,"10.0"
"14605","Z56101",2862,388,67,321,"11.2"
"14606","Z56110",826,33,3,30," 3.6"
"14607","Z56111",181,9,1,8," 4.4"
"14608","Z56114",185,47,20,27,"14.6"
"14609","Z56115",598,130,38,92,"15.4"
"14610","Z56116",257,18,0,18," 7.0"
"14611","Z56117",145,24,8,16,"11.0"
"14612","Z56118",152,8,4,4," 2.6"
"14613","Z56119",439,32,5,27," 6.2"
"14614","Z56120",526,73,5,68,"12.9"
"14615","Z56121",302,44,11,33,"10.9"
"14616","Z56122",259,21,0,21," 8.1"
"14617","Z56123",286,61,44,17," 5.9"
"14618","Z56127",200,24,0,24,"12.0"
"14619","Z56128",866,71,36,35," 4.0"
"14620","Z56129",320,38,3,35,"10.9"
"14621","Z56131",1152,105,16,89," 7.7"
"14622","Z56136",618,149,84,65,"10.5"
"14623","Z56137",542,91,8,83,"15.3"
"14624","Z56138",374,27,2,25," 6.7"
"14625","Z56139",202,25,4,21,"10.4"
"14626","Z56142",546,100,30,70,"12.8"
"14627","Z56143",2213,252,20,232,"10.5"
"14628","Z56144",548,46,2,44," 8.0"
"14629","Z56145",282,38,0,38,"13.5"
"14630","Z56149",779,213,112,101,"13.0"
"14631","Z56150",1294,163,10,153,"11.8"
"14632","Z56151",395,57,13,44,"11.1"
"14633","Z56152",717,116,4,112,"15.6"
"14634","Z56153",113,18,0,18,"15.9"
"14635","Z56155",194,35,4,31,"16.0"
"14636","Z56156",2752,215,38,177," 6.4"
"14637","Z56157",393,74,0,74,"18.8"
"14638","Z56158",208,26,3,23,"11.1"
"14639","Z56159",1209,65,0,65," 5.4"
"14640","Z56161",167,17,3,14," 8.4"
"14641","Z56164",2742,285,1,284,"10.4"
"14642","Z56165",168,10,1,9," 5.4"
"14643","Z56169",315,35,14,21," 6.7"
"14644","Z56171",894,147,50,97,"10.9"
"14645","Z56172",1612,205,139,66," 4.1"
"14646","Z56175",1592,399,162,237,"14.9"
"14647","Z56176",522,61,17,44," 8.4"
"14648","Z56178",806,109,17,92,"11.4"
"14649","Z56180",608,100,0,100,"16.4"
"14650","Z56181",545,76,14,62,"11.4"
"14651","Z56183",645,94,31,63," 9.8"
"14652","Z56185",245,2,0,2," 0.8"
"14653","Z56186",171,13,0,13," 7.6"
"14654","Z56187",5316,429,44,385," 7.2"
"14655","Z56201",9780,674,89,585," 6.0"
"14656","Z56207",99,17,8,9," 9.1"
"14657","Z56208",1169,194,66,128,"10.9"
"14658","Z56209",1344,384,330,54," 4.0"
"14659","Z56211",399,193,135,58,"14.5"
"14660","Z56212",300,83,30,53,"17.7"
"14661","Z56214",342,30,0,30," 8.8"
"14662","Z56215",2210,231,72,159," 7.2"
"14663","Z56216",268,21,4,17," 6.3"
"14664","Z56218",295,63,15,48,"16.3"
"14665","Z56219",614,246,175,71,"11.6"
"14666","Z56220",1483,195,48,147," 9.9"
"14667","Z56221",314,39,5,34,"10.8"
"14668","Z56222",818,80,4,76," 9.3"
"14669","Z56223",681,105,22,83,"12.2"
"14670","Z56224",185,30,0,30,"16.2"
"14671","Z56225",464,160,128,32," 6.9"
"14672","Z56226",105,11,5,6," 5.7"
"14673","Z56228",456,49,2,47,"10.3"
"14674","Z56229",788,69,5,64," 8.1"
"14675","Z56230",391,54,0,54,"13.8"
"14676","Z56231",208,26,7,19," 9.1"
"14677","Z56232",1175,151,28,123,"10.5"
"14678","Z56235",260,38,9,29,"11.2"
"14679","Z56236",166,18,4,14," 8.4"
"14680","Z56240",487,83,19,64,"13.1"
"14681","Z56241",1872,233,36,197,"10.5"
"14682","Z56243",765,81,39,42," 5.5"
"14683","Z56244",568,50,2,48," 8.5"
"14684","Z56245",234,15,1,14," 6.0"
"14685","Z56251",413,13,0,13," 3.1"
"14686","Z56252",544,48,9,39," 7.2"
"14687","Z56253",654,222,174,48," 7.3"
"14688","Z56255",174,23,4,19,"10.9"
"14689","Z56256",1351,212,67,145,"10.7"
"14690","Z56257",267,67,34,33,"12.4"
"14691","Z56258",6518,560,8,552," 8.5"
"14692","Z56260",378,53,20,33," 8.7"
"14693","Z56262",344,61,23,38,"11.0"
"14694","Z56263",244,30,1,29,"11.9"
"14695","Z56264",989,105,32,73," 7.4"
"14696","Z56265",3640,373,26,347," 9.5"
"14697","Z56266",769,115,4,111,"14.4"
"14698","Z56267",2987,353,74,279," 9.3"
"14699","Z56273",2434,476,396,80," 3.3"
"14700","Z56276",163,28,12,16," 9.8"
"14701","Z56277",1427,126,11,115," 8.1"
"14702","Z56278",1700,440,325,115," 6.8"
"14703","Z56279",542,69,45,24," 4.4"
"14704","Z56280",232,20,0,20," 8.6"
"14705","Z56281",254,12,0,12," 4.7"
"14706","Z56282",585,46,0,46," 7.9"
"14707","Z56283",3061,351,33,318,"10.4"
"14708","Z56284",1028,132,9,123,"12.0"
"14709","Z56285",542,75,2,73,"13.5"
"14710","Z56288",2766,876,663,213," 7.7"
"14711","Z56289",335,68,48,20," 6.0"
"14712","Z56291",230,19,5,14," 6.1"
"14713","Z56292",253,37,7,30,"11.9"
"14714","Z56293",499,49,0,49," 9.8"
"14715","Z56295",150,16,0,16,"10.7"
"14716","Z56296",1162,246,40,206,"17.7"
"14717","Z56297",378,27,8,19," 5.0"
"14718","Z56301",12184,879,36,843," 6.9"
"14719","Z56303",11621,588,4,584," 5.0"
"14720","Z56304",6745,670,21,649," 9.6"
"14721","Z56307",2083,84,15,69," 3.3"
"14722","Z56308",13515,2771,2053,718," 5.3"
"14723","Z56309",711,228,200,28," 3.9"
"14724","Z56310",2253,279,203,76," 3.4"
"14725","Z56311",376,123,58,65,"17.3"
"14726","Z56312",1045,162,32,130,"12.4"
"14727","Z56314",517,33,22,11," 2.1"
"14728","Z56315",944,305,271,34," 3.6"
"14729","Z56316",702,143,78,65," 9.3"
"14730","Z56319",731,160,125,35," 4.8"
"14731","Z56320",3541,406,379,27," 0.8"
"14732","Z56324",635,188,136,52," 8.2"
"14733","Z56325",88,2,0,2," 2.3"
"14734","Z56326",834,221,142,79," 9.5"
"14735","Z56329",2825,146,18,128," 4.5"
"14736","Z56330",706,55,15,40," 5.7"
"14737","Z56331",735,63,28,35," 4.8"
"14738","Z56332",682,157,137,20," 2.9"
"14739","Z56334",3539,1002,777,225," 6.4"
"14740","Z56335",102,9,0,9," 8.8"
"14741","Z56336",1074,435,395,40," 3.7"
"14742","Z56338",1315,613,548,65," 4.9"
"14743","Z56339",646,143,98,45," 7.0"
"14744","Z56340",948,63,12,51," 5.4"
"14745","Z56342",2527,1309,1172,137," 5.4"
"14746","Z56343",505,108,63,45," 8.9"
"14747","Z56345",6568,365,91,274," 4.2"
"14748","Z56347",3070,404,230,174," 5.7"
"14749","Z56349",412,80,65,15," 3.6"
"14750","Z56350",530,285,280,5," 0.9"
"14751","Z56352",2485,261,110,151," 6.1"
"14752","Z56353",3693,395,65,330," 8.9"
"14753","Z56354",1030,455,426,29," 2.8"
"14754","Z56355",204,15,3,12," 5.9"
"14755","Z56356",127,1,0,1," 0.8"
"14756","Z56357",451,54,7,47,"10.4"
"14757","Z56358",1450,216,113,103," 7.1"
"14758","Z56359",2236,758,577,181," 8.1"
"14759","Z56360",2371,779,678,101," 4.3"
"14760","Z56361",1195,270,162,108," 9.0"
"14761","Z56362",3008,612,492,120," 4.0"
"14762","Z56363",60,4,0,4," 6.7"
"14763","Z56364",2248,242,137,105," 4.7"
"14764","Z56367",2645,148,52,96," 3.6"
"14765","Z56368",2403,709,675,34," 1.4"
"14766","Z56369",297,30,0,30,"10.1"
"14767","Z56373",1182,52,7,45," 3.8"
"14768","Z56374",3159,179,57,122," 3.9"
"14769","Z56375",348,9,0,9," 2.6"
"14770","Z56376",152,4,0,4," 2.6"
"14771","Z56377",7043,263,0,263," 3.7"
"14772","Z56378",3714,481,403,78," 2.1"
"14773","Z56379",6705,138,27,111," 1.7"
"14774","Z56381",1362,354,248,106," 7.8"
"14775","Z56382",700,134,67,67," 9.6"
"14776","Z56384",155,5,0,5," 3.2"
"14777","Z56385",608,246,215,31," 5.1"
"14778","Z56386",575,292,254,38," 6.6"
"14779","Z56387",3179,55,0,55," 1.7"
"14780","Z56389",57,8,0,8,"14.0"
"14781","Z56401",15033,2979,2096,883," 5.9"
"14782","Z56425",3225,116,32,84," 2.6"
"14783","Z56431",7885,3650,3426,224," 2.8"
"14784","Z56433",1410,603,541,62," 4.4"
"14785","Z56434",83,8,6,2," 2.4"
"14786","Z56435",2297,1088,978,110," 4.8"
"14787","Z56438",1437,314,191,123," 8.6"
"14788","Z56440",595,36,15,21," 3.5"
"14789","Z56441",2073,489,359,130," 6.3"
"14790","Z56442",3241,2126,2037,89," 2.7"
"14791","Z56443",1573,936,882,54," 3.4"
"14792","Z56444",2755,1396,1309,87," 3.2"
"14793","Z56446",756,115,63,52," 6.9"
"14794","Z56447",1501,978,909,69," 4.6"
"14795","Z56448",647,492,487,5," 0.8"
"14796","Z56449",901,187,149,38," 4.2"
"14797","Z56450",1186,723,655,68," 5.7"
"14798","Z56452",3303,2329,2206,123," 3.7"
"14799","Z56455",874,177,99,78," 8.9"
"14800","Z56458",262,129,118,11," 4.2"
"14801","Z56461",2066,727,592,135," 6.5"
"14802","Z56464",2586,852,751,101," 3.9"
"14803","Z56465",1687,822,783,39," 2.3"
"14804","Z56466",2081,697,615,82," 3.9"
"14805","Z56467",2393,1369,1299,70," 2.9"
"14806","Z56468",3942,1865,1717,148," 3.8"
"14807","Z56469",1211,717,642,75," 6.2"
"14808","Z56470",7419,2775,2480,295," 4.0"
"14809","Z56472",5765,2747,2546,201," 3.5"
"14810","Z56473",1817,387,331,56," 3.1"
"14811","Z56474",2632,920,750,170," 6.5"
"14812","Z56475",732,74,34,40," 5.5"
"14813","Z56477",1347,341,245,96," 7.1"
"14814","Z56479",2577,431,214,217," 8.4"
"14815","Z56481",1000,130,83,47," 4.7"
"14816","Z56482",3035,270,108,162," 5.3"
"14817","Z56484",2586,1032,931,101," 3.9"
"14818","Z56501",9659,2446,1937,509," 5.3"
"14819","Z56510",1117,201,25,176,"15.8"
"14820","Z56514",1586,154,19,135," 8.5"
"14821","Z56515",3022,1633,1504,129," 4.3"
"14822","Z56516",133,23,3,20,"15.0"
"14823","Z56520",1862,113,5,108," 5.8"
"14824","Z56521",367,56,20,36," 9.8"
"14825","Z56525",61,8,0,8,"13.1"
"14826","Z56527",392,68,26,42,"10.7"
"14827","Z56528",1695,981,921,60," 3.5"
"14828","Z56529",1741,98,11,87," 5.0"
"14829","Z56531",1116,243,122,121,"10.8"
"14830","Z56533",141,22,9,13," 9.2"
"14831","Z56534",642,134,110,24," 3.7"
"14832","Z56535",815,293,264,29," 3.6"
"14833","Z56536",233,41,9,32,"13.7"
"14834","Z56537",9054,1099,433,666," 7.4"
"14835","Z56540",965,142,56,86," 8.9"
"14836","Z56542",1407,173,70,103," 7.3"
"14837","Z56543",135,31,9,22,"16.3"
"14838","Z56544",2680,634,498,136," 5.1"
"14839","Z56545",354,60,5,55,"15.5"
"14840","Z56546",150,54,0,54,"36.0"
"14841","Z56547",1060,81,2,79," 7.5"
"14842","Z56548",367,56,18,38,"10.4"
"14843","Z56549",1972,272,120,152," 7.7"
"14844","Z56550",245,62,22,40,"16.3"
"14845","Z56551",1461,525,393,132," 9.0"
"14846","Z56552",178,30,1,29,"16.3"
"14847","Z56553",123,4,0,4," 3.3"
"14848","Z56554",1819,771,660,111," 6.1"
"14849","Z56556",535,110,33,77,"14.4"
"14850","Z56557",1232,182,61,121," 9.8"
"14851","Z56560",16883,1230,228,1002," 5.9"
"14852","Z56566",291,103,52,51,"17.5"
"14853","Z56567",1621,238,169,69," 4.3"
"14854","Z56569",849,293,235,58," 6.8"
"14855","Z56570",789,293,243,50," 6.3"
"14856","Z56571",1513,770,721,49," 3.2"
"14857","Z56572",3950,1739,1567,172," 4.4"
"14858","Z56573",3434,842,715,127," 3.7"
"14859","Z56575",598,317,262,55," 9.2"
"14860","Z56576",796,497,471,26," 3.3"
"14861","Z56578",667,347,335,12," 1.8"
"14862","Z56579",534,78,14,64,"12.0"
"14863","Z56580",464,31,10,21," 4.5"
"14864","Z56583",54,5,0,5," 9.3"
"14865","Z56584",769,160,11,149,"19.4"
"14866","Z56585",472,35,11,24," 5.1"
"14867","Z56586",1271,476,446,30," 2.4"
"14868","Z56587",1127,531,476,55," 4.9"
"14869","Z56588",430,181,165,16," 3.7"
"14870","Z56589",1490,669,597,72," 4.8"
"14871","Z56592",222,33,14,19," 8.6"
"14872","Z56594",211,33,4,29,"13.7"
"14873","Z56601",14831,2071,1267,804," 5.4"
"14874","Z56621",2372,542,356,186," 7.8"
"14875","Z56623",2053,922,737,185," 9.0"
"14876","Z56626",301,153,133,20," 6.6"
"14877","Z56627",362,212,156,56,"15.5"
"14878","Z56628",1646,907,789,118," 7.2"
"14879","Z56629",175,94,91,3," 1.7"
"14880","Z56630",1106,305,193,112,"10.1"
"14881","Z56633",2477,860,698,162," 6.5"
"14882","Z56634",810,165,73,92,"11.4"
"14883","Z56636",3257,1321,1176,145," 4.5"
"14884","Z56639",475,276,242,34," 7.2"
"14885","Z56644",544,198,127,71,"13.1"
"14886","Z56646",213,41,24,17," 8.0"
"14887","Z56647",513,171,145,26," 5.1"
"14888","Z56649",5358,952,564,388," 7.2"
"14889","Z56653",857,292,242,50," 5.8"
"14890","Z56655",2185,1427,1337,90," 4.1"
"14891","Z56662",1056,768,751,17," 1.6"
"14892","Z56668",63,20,13,7,"11.1"
"14893","Z56669",391,230,173,57,"14.6"
"14894","Z56671",1087,154,7,147,"13.5"
"14895","Z56672",2541,1603,1464,139," 5.5"
"14896","Z56673",662,360,311,49," 7.4"
"14897","Z56681",308,184,161,23," 7.5"
"14898","Z56683",429,139,100,39," 9.1"
"14899","Z56684",160,29,17,12," 7.5"
"14900","Z56685",287,235,216,19," 6.6"
"14901","Z56686",886,479,340,139,"15.7"
"14902","Z56701",5729,307,50,257," 4.5"
"14903","Z56713",448,50,9,41," 9.2"
"14904","Z56715",167,15,5,10," 6.0"
"14905","Z56716",3864,249,1,248," 6.4"
"14906","Z56721",4256,204,47,157," 3.7"
"14907","Z56722",170,7,0,7," 4.1"
"14908","Z56725",507,107,44,63,"12.4"
"14909","Z56726",792,128,43,85,"10.7"
"14910","Z56727",578,257,192,65,"11.2"
"14911","Z56728",773,203,46,157,"20.3"
"14912","Z56731",47,13,5,8,"17.0"
"14913","Z56733",250,42,12,30,"12.0"
"14914","Z56735",477,162,88,74,"15.5"
"14915","Z56736",1063,582,530,52," 4.9"
"14916","Z56737",487,117,66,51,"10.5"
"14917","Z56742",433,67,24,43," 9.9"
"14918","Z56744",265,32,8,24," 9.1"
"14919","Z56750",1139,185,24,161,"14.1"
"14920","Z56751",2519,277,91,186," 7.4"
"14921","Z56755",59,17,0,17,"28.8"
"14922","Z56756",323,65,10,55,"17.0"
"14923","Z56757",505,55,0,55,"10.9"
"14924","Z56762",1188,150,26,124,"10.4"
"14925","Z57001",710,34,11,23," 3.2"
"14926","Z57002",450,42,8,34," 7.6"
"14927","Z57004",1453,143,0,143," 9.8"
"14928","Z57005",4097,145,0,145," 3.5"
"14929","Z57006",10282,926,221,705," 6.9"
"14930","Z57010",223,6,0,6," 2.7"
"14931","Z57012",501,59,11,48," 9.6"
"14932","Z57013",1895,119,22,97," 5.1"
"14933","Z57014",685,104,5,99,"14.5"
"14934","Z57015",331,19,0,19," 5.7"
"14935","Z57016",433,151,131,20," 4.6"
"14936","Z57017",696,38,0,38," 5.5"
"14937","Z57018",601,38,10,28," 4.7"
"14938","Z57020",561,50,0,50," 8.9"
"14939","Z57022",1823,74,0,74," 4.1"
"14940","Z57025",1278,168,3,165,"12.9"
"14941","Z57026",539,43,12,31," 5.8"
"14942","Z57028",1443,72,1,71," 4.9"
"14943","Z57029",1047,158,32,126,"12.0"
"14944","Z57030",1201,80,0,80," 6.7"
"14945","Z57031",297,11,0,11," 3.7"
"14946","Z57032",2224,62,0,62," 2.8"
"14947","Z57033",1834,54,0,54," 2.9"
"14948","Z57034",350,54,15,39,"11.1"
"14949","Z57035",536,10,2,8," 1.5"
"14950","Z57036",328,29,0,29," 8.8"
"14951","Z57037",405,35,7,28," 6.9"
"14952","Z57038",676,105,0,105,"15.5"
"14953","Z57039",1440,146,0,146,"10.1"
"14954","Z57042",3832,278,127,151," 3.9"
"14955","Z57043",637,46,10,36," 5.7"
"14956","Z57045",493,50,17,33," 6.7"
"14957","Z57046",295,47,0,47,"15.9"
"14958","Z57048",425,24,13,11," 2.6"
"14959","Z57049",2791,193,13,180," 6.4"
"14960","Z57051",144,30,8,22,"15.3"
"14961","Z57053",885,95,0,95,"10.7"
"14962","Z57054",260,31,13,18," 6.9"
"14963","Z57055",426,15,0,15," 3.5"
"14964","Z57058",971,71,14,57," 5.9"
"14965","Z57059",743,134,13,121,"16.3"
"14966","Z57064",1897,42,42,0," 0.0"
"14967","Z57065",184,6,0,6," 3.3"
"14968","Z57066",696,64,25,39," 5.6"
"14969","Z57067",249,87,72,15," 6.0"
"14970","Z57068",586,3,0,3," 0.5"
"14971","Z57069",4819,310,73,237," 4.9"
"14972","Z57070",775,116,58,58," 7.5"
"14973","Z57071",1233,22,4,18," 1.5"
"14974","Z57072",268,24,4,20," 7.5"
"14975","Z57073",400,76,26,50,"12.5"
"14976","Z57075",821,371,344,27," 3.3"
"14977","Z57078",8189,638,165,473," 5.8"
"14978","Z57103",14350,694,33,661," 4.6"
"14979","Z57104",12236,1220,42,1178," 9.6"
"14980","Z57105",10097,806,125,681," 6.7"
"14981","Z57106",18615,1019,77,942," 5.1"
"14982","Z57107",3545,130,0,130," 3.7"
"14983","Z57108",7938,281,0,281," 3.5"
"14984","Z57110",5678,233,0,233," 4.1"
"14985","Z57201",11442,552,186,366," 3.2"
"14986","Z57212",1042,247,111,136,"13.1"
"14987","Z57213",272,57,38,19," 7.0"
"14988","Z57216",786,326,252,74," 9.4"
"14989","Z57218",178,21,15,6," 3.4"
"14990","Z57219",274,42,0,42,"15.3"
"14991","Z57220",365,92,64,28," 7.7"
"14992","Z57221",313,41,8,33,"10.5"
"14993","Z57223",671,147,69,78,"11.6"
"14994","Z57225",942,118,16,102,"10.8"
"14995","Z57226",964,66,7,59," 6.1"
"14996","Z57227",406,217,157,60,"14.8"
"14997","Z57231",895,97,44,53," 5.9"
"14998","Z57232",283,139,124,15," 5.3"
"14999","Z57234",687,158,143,15," 2.2"
"15000","Z57235",376,19,14,5," 1.3"
"15001","Z57237",410,130,93,37," 9.0"
"15002","Z57241",368,43,4,39,"10.6"
"15003","Z57243",352,43,4,39,"11.1"
"15004","Z57246",71,8,2,6," 8.5"
"15005","Z57248",644,233,213,20," 3.1"
"15006","Z57249",609,154,93,61,"10.0"
"15007","Z57251",73,12,0,12,"16.4"
"15008","Z57252",2215,125,0,125," 5.6"
"15009","Z57255",215,38,17,21," 9.8"
"15010","Z57257",259,23,0,23," 8.9"
"15011","Z57259",273,61,34,27," 9.9"
"15012","Z57260",534,161,96,65,"12.2"
"15013","Z57261",177,47,19,28,"15.8"
"15014","Z57262",1997,203,14,189," 9.5"
"15015","Z57263",258,32,12,20," 7.8"
"15016","Z57264",116,20,15,5," 4.3"
"15017","Z57266",329,57,15,42,"12.8"
"15018","Z57270",423,107,46,61,"14.4"
"15019","Z57271",126,27,0,27,"21.4"
"15020","Z57272",107,36,9,27,"25.2"
"15021","Z57273",874,391,299,92,"10.5"
"15022","Z57274",1574,295,74,221,"14.0"
"15023","Z57276",485,39,19,20," 4.1"
"15024","Z57278",342,25,13,12," 3.5"
"15025","Z57279",647,205,117,88,"13.6"
"15026","Z57301",8400,407,26,381," 4.5"
"15027","Z57311",541,82,38,44," 8.1"
"15028","Z57313",620,51,2,49," 7.9"
"15029","Z57314",426,65,17,48,"11.3"
"15030","Z57315",540,88,23,65,"12.0"
"15031","Z57317",335,79,40,39,"11.6"
"15032","Z57319",502,85,23,62,"12.4"
"15033","Z57323",247,136,72,64,"25.9"
"15034","Z57324",177,15,8,7," 4.0"
"15035","Z57325",1453,152,14,138," 9.5"
"15036","Z57328",486,51,6,45," 9.3"
"15037","Z57331",211,33,5,28,"13.3"
"15038","Z57332",320,42,14,28," 8.8"
"15039","Z57334",352,8,0,8," 2.3"
"15040","Z57335",218,63,30,33,"15.1"
"15041","Z57339",442,60,5,55,"12.4"
"15042","Z57342",325,106,50,56,"17.2"
"15043","Z57345",606,117,31,86,"14.2"
"15044","Z57348",223,9,4,5," 2.2"
"15045","Z57349",734,86,8,78,"10.6"
"15046","Z57350",7072,673,174,499," 7.1"
"15047","Z57355",562,118,35,83,"14.8"
"15048","Z57356",758,205,80,125,"16.5"
"15049","Z57359",348,48,17,31," 8.9"
"15050","Z57362",1210,192,45,147,"12.1"
"15051","Z57363",471,45,8,37," 7.9"
"15052","Z57365",327,51,38,13," 4.0"
"15053","Z57366",1055,94,4,90," 8.5"
"15054","Z57367",121,36,23,13,"10.7"
"15055","Z57368",512,50,16,34," 6.6"
"15056","Z57369",1155,180,75,105," 9.1"
"15057","Z57370",369,74,12,62,"16.8"
"15058","Z57375",389,50,8,42,"10.8"
"15059","Z57376",564,106,20,86,"15.2"
"15060","Z57380",1374,160,12,148,"10.8"
"15061","Z57383",395,82,26,56,"14.2"
"15062","Z57384",432,41,14,27," 6.2"
"15063","Z57401",14333,962,92,870," 6.1"
"15064","Z57420",183,141,137,4," 2.2"
"15065","Z57424",132,12,2,10," 7.6"
"15066","Z57427",333,26,0,26," 7.8"
"15067","Z57428",358,64,24,40,"11.2"
"15068","Z57430",1080,199,47,152,"14.1"
"15069","Z57432",183,24,0,24,"13.1"
"15070","Z57433",212,66,51,15," 7.1"
"15071","Z57434",245,14,9,5," 2.0"
"15072","Z57436",257,71,27,44,"17.1"
"15073","Z57437",868,289,120,169,"19.5"
"15074","Z57438",684,103,52,51," 7.5"
"15075","Z57441",340,49,13,36,"10.6"
"15076","Z57442",1234,452,348,104," 8.4"
"15077","Z57445",965,103,0,103,"10.7"
"15078","Z57446",194,28,14,14," 7.2"
"15079","Z57448",203,49,20,29,"14.3"
"15080","Z57450",316,29,6,23," 7.3"
"15081","Z57451",1013,160,58,102,"10.1"
"15082","Z57454",257,33,0,33,"12.8"
"15083","Z57455",64,32,6,26,"40.6"
"15084","Z57456",474,66,7,59,"12.4"
"15085","Z57461",164,10,0,10," 6.1"
"15086","Z57465",178,40,7,33,"18.5"
"15087","Z57466",107,23,11,12,"11.2"
"15088","Z57467",183,48,0,48,"26.2"
"15089","Z57468",114,14,5,9," 7.9"
"15090","Z57469",1699,282,114,168," 9.9"
"15091","Z57471",343,58,27,31," 9.0"
"15092","Z57472",496,61,4,57,"11.5"
"15093","Z57476",195,17,4,13," 6.7"
"15094","Z57479",257,4,0,4," 1.6"
"15095","Z57481",128,8,0,8," 6.2"
"15096","Z57501",7471,614,142,472," 6.3"
"15097","Z57522",216,40,7,33,"15.3"
"15098","Z57523",616,112,24,88,"14.3"
"15099","Z57528",441,105,32,73,"16.6"
"15100","Z57529",253,83,26,57,"22.5"
"15101","Z57531",105,9,7,2," 1.9"
"15102","Z57532",1385,187,53,134," 9.7"
"15103","Z57533",1085,151,52,99," 9.1"
"15104","Z57543",468,82,36,46," 9.8"
"15105","Z57548",387,42,5,37," 9.6"
"15106","Z57551",891,128,21,107,"12.0"
"15107","Z57552",241,34,4,30,"12.4"
"15108","Z57555",1366,175,24,151,"11.1"
"15109","Z57559",380,67,23,44,"11.6"
"15110","Z57564",510,87,12,75,"14.7"
"15111","Z57567",722,126,30,96,"13.3"
"15112","Z57568",371,100,0,100,"27.0"
"15113","Z57569",205,52,5,47,"22.9"
"15114","Z57570",643,81,39,42," 6.5"
"15115","Z57576",83,29,13,16,"19.3"
"15116","Z57580",2242,285,202,83," 3.7"
"15117","Z57601",1953,252,15,237,"12.1"
"15118","Z57620",283,72,23,49,"17.3"
"15119","Z57623",381,68,12,56,"14.7"
"15120","Z57625",1469,201,17,184,"12.5"
"15121","Z57626",545,157,53,104,"19.1"
"15122","Z57632",339,53,22,31," 9.1"
"15123","Z57633",197,45,8,37,"18.8"
"15124","Z57638",1209,317,89,228,"18.9"
"15125","Z57641",184,53,13,40,"21.7"
"15126","Z57642",698,99,17,82,"11.7"
"15127","Z57648",371,212,149,63,"17.0"
"15128","Z57656",301,57,13,44,"14.6"
"15129","Z57701",18876,1280,184,1096," 5.8"
"15130","Z57702",15745,1553,673,880," 5.6"
"15131","Z57703",5724,254,0,254," 4.4"
"15132","Z57717",3513,389,167,222," 6.3"
"15133","Z57718",2729,51,18,33," 1.2"
"15134","Z57719",2840,250,56,194," 6.8"
"15135","Z57720",387,105,67,38," 9.8"
"15136","Z57725",144,51,0,51,"35.4"
"15137","Z57730",3336,767,603,164," 4.9"
"15138","Z57732",1330,313,257,56," 4.2"
"15139","Z57735",966,276,109,167,"17.3"
"15140","Z57744",859,64,5,59," 6.9"
"15141","Z57745",1624,658,542,116," 7.1"
"15142","Z57747",3237,816,433,383,"11.8"
"15143","Z57750",165,31,19,12," 7.3"
"15144","Z57751",474,188,115,73,"15.4"
"15145","Z57752",612,155,29,126,"20.6"
"15146","Z57754",2987,1274,925,349,"11.7"
"15147","Z57756",238,65,6,59,"24.8"
"15148","Z57759",160,91,70,21,"13.1"
"15149","Z57760",729,166,61,105,"14.4"
"15150","Z57761",475,60,5,55,"11.6"
"15151","Z57762",322,20,7,13," 4.0"
"15152","Z57766",252,97,54,43,"17.1"
"15153","Z57769",1544,66,66,0," 0.0"
"15154","Z57770",1464,234,33,201,"13.7"
"15155","Z57772",465,63,0,63,"13.5"
"15156","Z57773",180,28,10,18,"10.0"
"15157","Z57779",105,25,25,0," 0.0"
"15158","Z57783",7323,873,485,388," 5.3"
"15159","Z57785",4559,284,103,181," 4.0"
"15160","Z57788",182,13,5,8," 4.4"
"15161","Z57790",625,181,76,105,"16.8"
"15162","Z57793",1028,85,66,19," 1.8"
"15163","Z58004",96,2,0,2," 2.1"
"15164","Z58005",263,6,0,6," 2.3"
"15165","Z58006",262,43,5,38,"14.5"
"15166","Z58012",1032,73,0,73," 7.1"
"15167","Z58013",75,18,3,15,"20.0"
"15168","Z58015",114,7,0,7," 6.1"
"15169","Z58016",78,24,7,17,"21.8"
"15170","Z58017",203,63,16,47,"23.2"
"15171","Z58018",157,27,19,8," 5.1"
"15172","Z58030",284,36,4,32,"11.3"
"15173","Z58031",249,37,2,35,"14.1"
"15174","Z58032",382,49,0,49,"12.8"
"15175","Z58033",194,36,15,21,"10.8"
"15176","Z58035",157,43,15,28,"17.8"
"15177","Z58041",789,114,33,81,"10.3"
"15178","Z58042",624,16,0,16," 2.6"
"15179","Z58046",384,61,24,37," 9.6"
"15180","Z58047",1351,23,4,19," 1.4"
"15181","Z58048",230,30,4,26,"11.3"
"15182","Z58049",210,30,4,26,"12.4"
"15183","Z58051",628,55,7,48," 7.6"
"15184","Z58052",249,7,0,7," 2.8"
"15185","Z58053",682,116,31,85,"12.5"
"15186","Z58054",1460,141,39,102," 7.0"
"15187","Z58058",59,9,0,9,"15.3"
"15188","Z58059",403,17,0,17," 4.2"
"15189","Z58061",165,23,3,20,"12.1"
"15190","Z58064",247,50,0,50,"20.2"
"15191","Z58071",212,12,0,12," 5.7"
"15192","Z58072",3900,186,56,130," 3.3"
"15193","Z58075",4327,500,106,394," 9.1"
"15194","Z58077",351,92,17,75,"21.4"
"15195","Z58078",12571,519,149,370," 2.9"
"15196","Z58081",425,54,0,54,"12.7"
"15197","Z58102",14859,1191,184,1007," 6.8"
"15198","Z58103",24616,1259,210,1049," 4.3"
"15199","Z58104",14603,1051,58,993," 6.8"
"15200","Z58201",17316,814,123,691," 4.0"
"15201","Z58203",8223,603,33,570," 6.9"
"15202","Z58210",236,42,6,36,"15.3"
"15203","Z58212",310,42,20,22," 7.1"
"15204","Z58214",211,61,0,61,"28.9"
"15205","Z58220",1240,196,23,173,"14.0"
"15206","Z58222",146,5,0,5," 3.4"
"15207","Z58225",519,78,19,59,"11.4"
"15208","Z58228",439,82,24,58,"13.2"
"15209","Z58230",358,52,16,36,"10.1"
"15210","Z58233",114,8,0,8," 7.0"
"15211","Z58235",232,40,20,20," 8.6"
"15212","Z58237",2587,202,14,188," 7.3"
"15213","Z58240",652,186,129,57," 8.7"
"15214","Z58243",336,67,35,32," 9.5"
"15215","Z58249",1428,304,15,289,"20.2"
"15216","Z58251",950,77,4,73," 7.7"
"15217","Z58256",373,28,11,17," 4.6"
"15218","Z58257",999,185,14,171,"17.1"
"15219","Z58259",242,52,16,36,"14.9"
"15220","Z58260",116,28,24,4," 3.4"
"15221","Z58261",483,49,4,45," 9.3"
"15222","Z58265",289,59,3,56,"19.4"
"15223","Z58267",712,147,22,125,"17.6"
"15224","Z58269",92,28,2,26,"28.3"
"15225","Z58270",933,86,0,86," 9.2"
"15226","Z58272",162,40,7,33,"20.4"
"15227","Z58273",166,23,8,15," 9.0"
"15228","Z58274",453,49,5,44," 9.7"
"15229","Z58275",291,7,0,7," 2.4"
"15230","Z58276",307,74,1,73,"23.8"
"15231","Z58277",197,53,30,23,"11.7"
"15232","Z58278",720,64,10,54," 7.5"
"15233","Z58282",741,47,0,47," 6.3"
"15234","Z58301",4843,489,209,280," 5.8"
"15235","Z58316",2350,262,24,238,"10.1"
"15236","Z58317",184,64,54,10," 5.4"
"15237","Z58318",2765,1012,885,127," 4.6"
"15238","Z58324",775,191,93,98,"12.6"
"15239","Z58329",1223,163,22,141,"11.5"
"15240","Z58330",184,42,4,38,"20.7"
"15241","Z58331",96,39,27,12,"12.5"
"15242","Z58341",1498,240,37,203,"13.6"
"15243","Z58344",514,103,21,82,"16.0"
"15244","Z58346",366,65,4,61,"16.7"
"15245","Z58348",405,88,36,52,"12.8"
"15246","Z58351",287,82,27,55,"19.2"
"15247","Z58356",969,163,35,128,"13.2"
"15248","Z58357",173,48,14,34,"19.7"
"15249","Z58366",474,48,0,48,"10.1"
"15250","Z58367",719,79,16,63," 8.8"
"15251","Z58368",2004,193,125,68," 3.4"
"15252","Z58377",155,26,2,24,"15.5"
"15253","Z58380",257,45,23,22," 8.6"
"15254","Z58381",178,72,55,17," 9.6"
"15255","Z58382",94,16,9,7," 7.4"
"15256","Z58384",317,70,38,32,"10.1"
"15257","Z58385",115,28,17,11," 9.6"
"15258","Z58401",8343,607,170,437," 5.2"
"15259","Z58413",795,264,83,181,"22.8"
"15260","Z58416",375,182,119,63,"16.8"
"15261","Z58418",221,71,15,56,"25.3"
"15262","Z58421",1396,150,14,136," 9.7"
"15263","Z58425",687,98,32,66," 9.6"
"15264","Z58426",94,21,0,21,"22.3"
"15265","Z58433",584,113,32,81,"13.9"
"15266","Z58436",1061,257,100,157,"14.8"
"15267","Z58438",363,66,7,59,"16.3"
"15268","Z58441",158,19,0,19,"12.0"
"15269","Z58442",357,114,57,57,"16.0"
"15270","Z58444",181,60,32,28,"15.5"
"15271","Z58451",123,38,9,29,"23.6"
"15272","Z58455",209,41,3,38,"18.2"
"15273","Z58456",343,127,57,70,"20.4"
"15274","Z58458",667,136,40,96,"14.4"
"15275","Z58460",181,80,36,44,"24.3"
"15276","Z58461",258,70,9,61,"23.6"
"15277","Z58466",201,34,10,24,"11.9"
"15278","Z58467",290,61,30,31,"10.7"
"15279","Z58472",195,32,13,19," 9.7"
"15280","Z58474",1244,123,20,103," 8.3"
"15281","Z58476",175,26,21,5," 2.9"
"15282","Z58480",142,30,8,22,"15.5"
"15283","Z58482",529,71,23,48," 9.1"
"15284","Z58483",217,98,43,55,"25.3"
"15285","Z58487",232,39,28,11," 4.7"
"15286","Z58490",139,14,9,5," 3.6"
"15287","Z58492",192,15,2,13," 6.8"
"15288","Z58494",183,44,10,34,"18.6"
"15289","Z58495",769,174,122,52," 6.8"
"15290","Z58497",146,16,0,16,"11.0"
"15291","Z58501",13791,541,298,243," 1.8"
"15292","Z58503",12261,426,86,340," 2.8"
"15293","Z58504",10994,451,118,333," 3.0"
"15294","Z58521",297,18,9,9," 3.0"
"15295","Z58529",387,105,25,80,"20.7"
"15296","Z58533",777,321,204,117,"15.1"
"15297","Z58540",1389,290,167,123," 8.9"
"15298","Z58541",234,18,10,8," 3.4"
"15299","Z58542",173,63,37,26,"15.0"
"15300","Z58544",340,65,18,47,"13.8"
"15301","Z58545",2049,519,352,167," 8.2"
"15302","Z58552",1148,300,189,111," 9.7"
"15303","Z58554",10985,612,194,418," 3.8"
"15304","Z58561",583,108,44,64,"11.0"
"15305","Z58568",224,54,10,44,"19.6"
"15306","Z58570",195,51,14,37,"19.0"
"15307","Z58572",167,28,17,11," 6.6"
"15308","Z58573",352,53,31,22," 6.2"
"15309","Z58575",576,158,96,62,"10.8"
"15310","Z58577",1015,160,63,97," 9.6"
"15311","Z58579",612,83,55,28," 4.6"
"15312","Z58581",181,64,38,26,"14.4"
"15313","Z58601",10967,1083,130,953," 8.7"
"15314","Z58621",713,110,36,74,"10.4"
"15315","Z58622",847,138,19,119,"14.0"
"15316","Z58623",1289,273,103,170,"13.2"
"15317","Z58626",196,40,20,20,"10.2"
"15318","Z58631",541,92,59,33," 6.1"
"15319","Z58632",114,21,0,21,"18.4"
"15320","Z58634",127,46,29,17,"13.4"
"15321","Z58636",580,246,163,83,"14.3"
"15322","Z58638",555,113,41,72,"13.0"
"15323","Z58639",1043,225,64,161,"15.4"
"15324","Z58640",773,199,73,126,"16.3"
"15325","Z58642",148,19,9,10," 6.8"
"15326","Z58646",677,168,71,97,"14.3"
"15327","Z58647",595,119,32,87,"14.6"
"15328","Z58650",255,69,35,34,"13.3"
"15329","Z58651",276,49,22,27," 9.8"
"15330","Z58652",560,55,9,46," 8.2"
"15331","Z58653",326,62,32,30," 9.2"
"15332","Z58655",213,19,3,16," 7.5"
"15333","Z58701",15623,2048,174,1874,"12.0"
"15334","Z58703",9360,1357,170,1187,"12.7"
"15335","Z58710",334,64,27,37,"11.1"
"15336","Z58716",58,5,3,2," 3.4"
"15337","Z58718",370,22,8,14," 3.8"
"15338","Z58721",355,82,30,52,"14.6"
"15339","Z58722",647,95,0,95,"14.7"
"15340","Z58730",861,214,88,126,"14.6"
"15341","Z58731",156,30,5,25,"16.0"
"15342","Z58733",169,33,8,25,"14.8"
"15343","Z58734",163,28,0,28,"17.2"
"15344","Z58736",332,71,46,25," 7.5"
"15345","Z58740",371,27,0,27," 7.3"
"15346","Z58741",277,16,14,2," 0.7"
"15347","Z58746",777,210,75,135,"17.4"
"15348","Z58748",115,53,25,28,"24.3"
"15349","Z58750",311,26,0,26," 8.4"
"15350","Z58752",91,12,0,12,"13.2"
"15351","Z58756",143,56,12,44,"30.8"
"15352","Z58757",591,324,256,68,"11.5"
"15353","Z58759",405,53,18,35," 8.6"
"15354","Z58761",484,91,63,28," 5.8"
"15355","Z58762",130,30,27,3," 2.3"
"15356","Z58763",1922,621,399,222,"11.6"
"15357","Z58769",154,66,10,56,"36.4"
"15358","Z58770",836,358,212,146,"17.5"
"15359","Z58771",334,68,11,57,"17.1"
"15360","Z58772",91,27,16,11,"12.1"
"15361","Z58773",441,84,54,30," 6.8"
"15362","Z58781",284,34,7,27," 9.5"
"15363","Z58782",204,44,28,16," 7.8"
"15364","Z58784",1325,232,83,149,"11.2"
"15365","Z58787",146,54,19,35,"24.0"
"15366","Z58789",210,69,17,52,"24.8"
"15367","Z58790",710,26,14,12," 1.7"
"15368","Z58793",325,55,32,23," 7.1"
"15369","Z58795",137,57,26,31,"22.6"
"15370","Z58801",12473,2012,701,1311,"10.5"
"15371","Z58830",124,9,0,9," 7.3"
"15372","Z58831",284,69,25,44,"15.5"
"15373","Z58835",150,30,14,16,"10.7"
"15374","Z58843",252,68,46,22," 8.7"
"15375","Z58849",493,131,77,54,"11.0"
"15376","Z58852",928,214,117,97,"10.5"
"15377","Z58853",143,30,4,26,"18.2"
"15378","Z58854",2207,315,161,154," 7.0"
"15379","Z59001",847,176,66,110,"13.0"
"15380","Z59003",511,112,0,112,"21.9"
"15381","Z59011",1549,350,201,149," 9.6"
"15382","Z59014",777,114,21,93,"12.0"
"15383","Z59015",194,27,0,27,"13.9"
"15384","Z59016",321,78,11,67,"20.9"
"15385","Z59018",319,83,43,40,"12.5"
"15386","Z59019",1977,345,84,261,"13.2"
"15387","Z59020",136,110,85,25,"18.4"
"15388","Z59022",518,78,15,63,"12.2"
"15389","Z59027",647,313,119,194,"30.0"
"15390","Z59028",358,142,90,52,"14.5"
"15391","Z59029",338,42,4,38,"11.2"
"15392","Z59030",839,221,128,93,"11.1"
"15393","Z59032",159,27,13,14," 8.8"
"15394","Z59034",1999,285,66,219,"11.0"
"15395","Z59036",911,333,73,260,"28.5"
"15396","Z59037",759,40,39,1," 0.1"
"15397","Z59038",377,82,31,51,"13.5"
"15398","Z59043",981,194,7,187,"19.1"
"15399","Z59044",4602,321,86,235," 5.1"
"15400","Z59046",224,51,24,27,"12.1"
"15401","Z59047",6485,1365,499,866,"13.4"
"15402","Z59050",587,176,33,143,"24.4"
"15403","Z59053",294,148,130,18," 6.1"
"15404","Z59054",230,86,48,38,"16.5"
"15405","Z59057",298,26,7,19," 6.4"
"15406","Z59063",794,51,0,51," 6.4"
"15407","Z59064",72,13,0,13,"18.1"
"15408","Z59068",2931,1264,951,313,"10.7"
"15409","Z59070",620,194,97,97,"15.6"
"15410","Z59072",2376,623,225,398,"16.8"
"15411","Z59074",241,85,48,37,"15.4"
"15412","Z59075",124,60,34,26,"21.0"
"15413","Z59079",1459,153,61,92," 6.3"
"15414","Z59086",522,169,87,82,"15.7"
"15415","Z59087",271,112,74,38,"14.0"
"15416","Z59088",634,122,19,103,"16.2"
"15417","Z59101",17474,1379,227,1152," 6.6"
"15418","Z59102",21946,1139,257,882," 4.0"
"15419","Z59105",12214,639,45,594," 4.9"
"15420","Z59106",5649,335,55,280," 5.0"
"15421","Z59201",1942,492,105,387,"19.9"
"15422","Z59212",212,47,15,32,"15.1"
"15423","Z59213",262,85,19,66,"25.2"
"15424","Z59215",588,114,36,78,"13.3"
"15425","Z59218",453,113,55,58,"12.8"
"15426","Z59219",117,34,32,2," 1.7"
"15427","Z59221",781,121,64,57," 7.3"
"15428","Z59222",130,64,31,33,"25.4"
"15429","Z59223",261,106,91,15," 5.7"
"15430","Z59225",219,67,21,46,"21.0"
"15431","Z59226",280,105,42,63,"22.5"
"15432","Z59230",2321,317,150,167," 7.2"
"15433","Z59231",1005,734,17,717,"71.3"
"15434","Z59241",271,72,31,41,"15.1"
"15435","Z59243",144,45,15,30,"20.8"
"15436","Z59248",422,127,96,31," 7.3"
"15437","Z59254",1143,156,51,105," 9.2"
"15438","Z59255",1264,272,61,211,"16.7"
"15439","Z59270",3770,333,69,264," 7.0"
"15440","Z59275",241,94,53,41,"17.0"
"15441","Z59301",5471,748,118,630,"11.5"
"15442","Z59313",1228,212,73,139,"11.3"
"15443","Z59315",84,30,17,13,"15.5"
"15444","Z59317",674,154,48,106,"15.7"
"15445","Z59323",936,102,52,50," 5.3"
"15446","Z59327",1496,271,31,240,"16.0"
"15447","Z59330",3894,222,44,178," 4.6"
"15448","Z59336",110,38,27,11,"10.0"
"15449","Z59337",587,277,214,63,"10.7"
"15450","Z59349",551,94,12,82,"14.9"
"15451","Z59353",558,110,12,98,"17.6"
"15452","Z59401",7132,714,42,672," 9.4"
"15453","Z59404",11019,629,151,478," 4.3"
"15454","Z59405",14242,1117,115,1002," 7.0"
"15455","Z59410",532,235,203,32," 6.0"
"15456","Z59411",507,349,309,40," 7.9"
"15457","Z59412",840,185,71,114,"13.6"
"15458","Z59416",246,13,6,7," 2.8"
"15459","Z59417",2754,392,142,250," 9.1"
"15460","Z59420",117,20,13,7," 6.0"
"15461","Z59421",1437,654,383,271,"18.9"
"15462","Z59422",1322,308,91,217,"16.4"
"15463","Z59425",1572,174,29,145," 9.2"
"15464","Z59427",1725,250,49,201,"11.7"
"15465","Z59430",228,51,19,32,"14.0"
"15466","Z59433",319,72,8,64,"20.1"
"15467","Z59436",818,103,24,79," 9.7"
"15468","Z59442",931,177,79,98,"10.5"
"15469","Z59443",288,63,0,63,"21.9"
"15470","Z59447",150,40,19,21,"14.0"
"15471","Z59450",277,64,25,39,"14.1"
"15472","Z59452",363,125,78,47,"12.9"
"15473","Z59453",214,67,33,34,"15.9"
"15474","Z59454",132,24,1,23,"17.4"
"15475","Z59457",4558,626,191,435," 9.5"
"15476","Z59463",269,213,144,69,"25.7"
"15477","Z59464",219,58,31,27,"12.3"
"15478","Z59466",50,15,0,15,"30.0"
"15479","Z59468",278,43,15,28,"10.1"
"15480","Z59469",127,54,41,13,"10.2"
"15481","Z59471",169,22,7,15," 8.9"
"15482","Z59474",1570,168,38,130," 8.3"
"15483","Z59477",190,24,13,11," 5.8"
"15484","Z59479",511,142,76,66,"12.9"
"15485","Z59480",203,33,0,33,"16.3"
"15486","Z59482",314,80,8,72,"22.9"
"15487","Z59484",70,19,0,19,"27.1"
"15488","Z59485",234,26,6,20," 8.5"
"15489","Z59486",527,97,33,64,"12.1"
"15490","Z59487",602,45,25,20," 3.3"
"15491","Z59489",178,48,9,39,"21.9"
"15492","Z59501",5762,789,160,629,"10.9"
"15493","Z59520",627,136,40,96,"15.3"
"15494","Z59521",1227,204,64,140,"11.4"
"15495","Z59522",801,188,39,149,"18.6"
"15496","Z59523",1198,247,62,185,"15.4"
"15497","Z59526",910,201,39,162,"17.8"
"15498","Z59530",83,30,12,18,"21.7"
"15499","Z59538",1508,192,116,76," 5.0"
"15500","Z59547",17,4,0,4,"23.5"
"15501","Z59601",14409,1141,237,904," 6.3"
"15502","Z59602",10638,1035,590,445," 4.2"
"15503","Z59632",901,154,59,95,"10.5"
"15504","Z59633",194,91,78,13," 6.7"
"15505","Z59634",1887,91,21,70," 3.7"
"15506","Z59635",2832,54,16,38," 1.3"
"15507","Z59639",1113,591,528,63," 5.7"
"15508","Z59640",81,24,24,0," 0.0"
"15509","Z59644",2050,240,130,110," 5.4"
"15510","Z59645",1042,401,326,75," 7.2"
"15511","Z59648",725,494,468,26," 3.6"
"15512","Z59701",16241,1601,212,1389," 8.6"
"15513","Z59710",235,104,90,14," 6.0"
"15514","Z59711",5642,1717,968,749,"13.3"
"15515","Z59714",7899,577,85,492," 6.2"
"15516","Z59715",14757,1438,432,1006," 6.8"
"15517","Z59716",3187,2328,1742,586,"18.4"
"15518","Z59718",13368,1084,255,829," 6.2"
"15519","Z59720",479,342,293,49,"10.2"
"15520","Z59721",228,41,33,8," 3.5"
"15521","Z59722",2135,286,131,155," 7.3"
"15522","Z59725",3917,470,164,306," 7.8"
"15523","Z59728",278,97,77,20," 7.2"
"15524","Z59729",1556,607,499,108," 6.9"
"15525","Z59730",1505,649,593,56," 3.7"
"15526","Z59735",202,74,44,30,"14.9"
"15527","Z59736",116,55,37,18,"15.5"
"15528","Z59741",1886,213,98,115," 6.1"
"15529","Z59745",90,34,15,19,"21.1"
"15530","Z59747",167,69,45,24,"14.4"
"15531","Z59749",980,307,200,107,"10.9"
"15532","Z59752",1589,186,40,146," 9.2"
"15533","Z59754",463,77,43,34," 7.3"
"15534","Z59758",1720,832,600,232,"13.5"
"15535","Z59759",1857,257,178,79," 4.3"
"15536","Z59761",287,145,116,29,"10.1"
"15537","Z59801",14553,919,199,720," 4.9"
"15538","Z59802",9479,497,143,354," 3.7"
"15539","Z59803",6607,172,0,172," 2.6"
"15540","Z59804",3373,248,97,151," 4.5"
"15541","Z59808",8271,452,57,395," 4.8"
"15542","Z59820",744,212,134,78,"10.5"
"15543","Z59823",758,111,77,34," 4.5"
"15544","Z59825",1151,202,118,84," 7.3"
"15545","Z59826",728,447,426,21," 2.9"
"15546","Z59827",147,33,20,13," 8.8"
"15547","Z59828",2437,358,149,209," 8.6"
"15548","Z59829",1613,629,463,166,"10.3"
"15549","Z59831",217,27,6,21," 9.7"
"15550","Z59832",532,138,62,76,"14.3"
"15551","Z59833",2154,191,42,149," 6.9"
"15552","Z59834",772,88,0,88,"11.4"
"15553","Z59837",192,29,5,24,"12.5"
"15554","Z59840",6918,909,447,462," 6.7"
"15555","Z59841",201,18,3,15," 7.5"
"15556","Z59844",359,81,64,17," 4.7"
"15557","Z59847",2198,99,2,97," 4.4"
"15558","Z59855",437,15,0,15," 3.4"
"15559","Z59858",1182,562,355,207,"17.5"
"15560","Z59859",1794,455,194,261,"14.5"
"15561","Z59860",6431,1942,1379,563," 8.8"
"15562","Z59864",2753,263,71,192," 7.0"
"15563","Z59865",1384,100,49,51," 3.7"
"15564","Z59868",1921,1179,1005,174," 9.1"
"15565","Z59870",4456,331,9,322," 7.2"
"15566","Z59871",371,279,242,37,"10.0"
"15567","Z59872",1239,363,130,233,"18.8"
"15568","Z59873",2036,450,286,164," 8.1"
"15569","Z59874",708,167,140,27," 3.8"
"15570","Z59875",1697,211,43,168," 9.9"
"15571","Z59901",22168,2478,1037,1441," 6.5"
"15572","Z59910",411,202,164,38," 9.2"
"15573","Z59911",5877,2506,2069,437," 7.4"
"15574","Z59912",6023,550,189,361," 6.0"
"15575","Z59913",336,67,53,14," 4.2"
"15576","Z59914",232,131,103,28,"12.1"
"15577","Z59916",345,295,295,0," 0.0"
"15578","Z59917",2269,525,382,143," 6.3"
"15579","Z59918",407,87,58,29," 7.1"
"15580","Z59922",1679,475,424,51," 3.0"
"15581","Z59923",5198,905,330,575,"11.1"
"15582","Z59926",191,55,34,21,"11.0"
"15583","Z59927",177,48,44,4," 2.3"
"15584","Z59934",344,113,102,11," 3.2"
"15585","Z59935",2355,678,496,182," 7.7"
"15586","Z59936",648,460,438,22," 3.4"
"15587","Z59937",8274,2702,2020,682," 8.2"
"15588","Z60002",10778,1617,909,708," 6.6"
"15589","Z60004",20409,915,138,777," 3.8"
"15590","Z60005",13289,754,233,521," 3.9"
"15591","Z60007",14036,483,26,457," 3.3"
"15592","Z60008",9105,661,0,661," 7.3"
"15593","Z60010",17294,1259,268,991," 5.7"
"15594","Z60012",4137,256,29,227," 5.5"
"15595","Z60013",9581,500,10,490," 5.1"
"15596","Z60014",18101,961,149,812," 4.5"
"15597","Z60015",9884,399,110,289," 2.9"
"15598","Z60016",24925,1531,165,1366," 5.5"
"15599","Z60018",10464,517,42,475," 4.5"
"15600","Z60020",5452,1242,830,412," 7.6"
"15601","Z60021",2011,87,0,87," 4.3"
"15602","Z60022",3077,199,0,199," 6.5"
"15603","Z60025",15539,988,5,983," 6.3"
"15604","Z60026",5466,144,40,104," 1.9"
"15605","Z60029",145,8,2,6," 4.1"
"15606","Z60030",14274,325,78,247," 1.7"
"15607","Z60031",14337,550,57,493," 3.4"
"15608","Z60033",4811,514,67,447," 9.3"
"15609","Z60034",836,128,4,124,"14.8"
"15610","Z60035",12194,812,253,559," 4.6"
"15611","Z60040",2058,64,23,41," 2.0"
"15612","Z60041",3911,207,179,28," 0.7"
"15613","Z60042",3282,44,0,44," 1.3"
"15614","Z60043",872,50,6,44," 5.0"
"15615","Z60044",3996,248,32,216," 5.4"
"15616","Z60045",7813,693,190,503," 6.4"
"15617","Z60046",12815,734,151,583," 4.5"
"15618","Z60047",14446,580,161,419," 2.9"
"15619","Z60048",10879,426,25,401," 3.7"
"15620","Z60050",12825,777,70,707," 5.5"
"15621","Z60051",9720,753,191,562," 5.8"
"15622","Z60053",8857,641,40,601," 6.8"
"15623","Z60056",22037,1393,66,1327," 6.0"
"15624","Z60060",13602,712,103,609," 4.5"
"15625","Z60061",10350,615,42,573," 5.5"
"15626","Z60062",16381,1155,354,801," 4.9"
"15627","Z60064",5839,1002,25,977,"16.7"
"15628","Z60067",16123,967,145,822," 5.1"
"15629","Z60068",14875,790,120,670," 4.5"
"15630","Z60069",3823,310,78,232," 6.1"
"15631","Z60070",6329,346,15,331," 5.2"
"15632","Z60071",1703,120,27,93," 5.5"
"15633","Z60073",19342,1191,121,1070," 5.5"
"15634","Z60074",15021,910,56,854," 5.7"
"15635","Z60076",11788,864,18,846," 7.2"
"15636","Z60077",11124,860,0,860," 7.7"
"15637","Z60081",3622,268,104,164," 4.5"
"15638","Z60083",3845,170,3,167," 4.3"
"15639","Z60084",6246,305,94,211," 3.4"
"15640","Z60085",24989,2491,20,2471," 9.9"
"15641","Z60087",10063,746,11,735," 7.3"
"15642","Z60088",1444,356,0,356,"24.7"
"15643","Z60089",16710,614,43,571," 3.4"
"15644","Z60090",15201,1069,13,1056," 6.9"
"15645","Z60091",9879,375,0,375," 3.8"
"15646","Z60093",7299,634,32,602," 8.2"
"15647","Z60096",2623,138,51,87," 3.3"
"15648","Z60097",4426,412,190,222," 5.0"
"15649","Z60098",13256,1189,71,1118," 8.4"
"15650","Z60099",11894,1353,11,1342,"11.3"
"15651","Z60101",13805,744,0,744," 5.4"
"15652","Z60102",11923,606,84,522," 4.4"
"15653","Z60103",14891,850,9,841," 5.6"
"15654","Z60104",6681,618,0,618," 9.3"
"15655","Z60106",7388,518,15,503," 6.8"
"15656","Z60107",14165,822,80,742," 5.2"
"15657","Z60108",9571,357,18,339," 3.5"
"15658","Z60109",214,10,5,5," 2.3"
"15659","Z60110",12117,945,48,897," 7.4"
"15660","Z60111",137,7,7,0," 0.0"
"15661","Z60112",1604,166,0,166,"10.3"
"15662","Z60113",161,16,7,9," 5.6"
"15663","Z60115",18170,2309,290,2019,"11.1"
"15664","Z60118",6508,347,30,317," 4.9"
"15665","Z60119",3622,140,4,136," 3.8"
"15666","Z60120",16187,1073,33,1040," 6.4"
"15667","Z60123",17352,1435,72,1363," 7.9"
"15668","Z60124",7116,113,0,113," 1.6"
"15669","Z60126",17514,1009,24,985," 5.6"
"15670","Z60130",7822,615,0,615," 7.9"
"15671","Z60131",6810,487,9,478," 7.0"
"15672","Z60133",11830,558,8,550," 4.6"
"15673","Z60134",10639,346,55,291," 2.7"
"15674","Z60135",2709,105,0,105," 3.9"
"15675","Z60137",14776,629,119,510," 3.5"
"15676","Z60139",12267,754,23,731," 6.0"
"15677","Z60140",5302,214,0,214," 4.0"
"15678","Z60142",11829,785,63,722," 6.1"
"15679","Z60143",4054,102,18,84," 2.1"
"15680","Z60145",928,55,5,50," 5.4"
"15681","Z60146",1020,97,0,97," 9.5"
"15682","Z60148",21984,1371,184,1187," 5.4"
"15683","Z60150",684,63,0,63," 9.2"
"15684","Z60151",1648,69,0,69," 4.2"
"15685","Z60152",4795,218,11,207," 4.3"
"15686","Z60153",8851,1441,6,1435,"16.2"
"15687","Z60154",7172,537,47,490," 6.8"
"15688","Z60155",3405,217,0,217," 6.4"
"15689","Z60157",906,162,0,162,"17.9"
"15690","Z60160",8427,689,82,607," 7.2"
"15691","Z60162",3252,295,11,284," 8.7"
"15692","Z60163",1842,69,0,69," 3.7"
"15693","Z60164",7147,725,91,634," 8.9"
"15694","Z60165",1421,116,0,116," 8.2"
"15695","Z60169",12628,647,12,635," 5.0"
"15696","Z60171",4364,267,0,267," 6.1"
"15697","Z60172",9504,510,51,459," 4.8"
"15698","Z60173",6506,674,55,619," 9.5"
"15699","Z60174",13272,475,45,430," 3.2"
"15700","Z60175",8376,236,0,236," 2.8"
"15701","Z60176",4753,454,35,419," 8.8"
"15702","Z60177",7556,133,0,133," 1.8"
"15703","Z60178",9030,498,0,498," 5.5"
"15704","Z60181",11091,732,42,690," 6.2"
"15705","Z60184",861,35,0,35," 4.1"
"15706","Z60185",11044,559,0,559," 5.1"
"15707","Z60187",9938,588,69,519," 5.2"
"15708","Z60188",16077,604,6,598," 3.7"
"15709","Z60189",12455,342,23,319," 2.6"
"15710","Z60190",4206,192,0,192," 4.6"
"15711","Z60191",5588,299,0,299," 5.4"
"15712","Z60192",5655,55,32,23," 0.4"
"15713","Z60193",15919,635,96,539," 3.4"
"15714","Z60194",7880,590,33,557," 7.1"
"15715","Z60195",2496,192,94,98," 3.9"
"15716","Z60201",17454,1732,74,1658," 9.5"
"15717","Z60202",14701,1160,89,1071," 7.3"
"15718","Z60203",1677,83,0,83," 4.9"
"15719","Z60301",1803,441,6,435,"24.1"
"15720","Z60302",14971,1167,159,1008," 6.7"
"15721","Z60304",6944,498,68,430," 6.2"
"15722","Z60305",4192,248,14,234," 5.6"
"15723","Z60401",3352,276,13,263," 7.8"
"15724","Z60402",23154,2166,74,2092," 9.0"
"15725","Z60403",7549,493,49,444," 5.9"
"15726","Z60404",6140,260,21,239," 3.9"
"15727","Z60406",10709,1578,0,1578,"14.7"
"15728","Z60407",737,93,6,87,"11.8"
"15729","Z60408",2362,223,16,207," 8.8"
"15730","Z60409",16201,2148,18,2130,"13.1"
"15731","Z60410",4268,213,0,213," 5.0"
"15732","Z60411",23933,3791,45,3746,"15.7"
"15733","Z60415",5582,294,0,294," 5.3"
"15734","Z60416",3471,163,0,163," 4.7"
"15735","Z60417",6658,550,10,540," 8.1"
"15736","Z60419",8864,1113,0,1113,"12.6"
"15737","Z60420",2344,234,0,234,"10.0"
"15738","Z60421",1649,136,4,132," 8.0"
"15739","Z60422",3651,195,0,195," 5.3"
"15740","Z60423",10588,516,0,516," 4.9"
"15741","Z60424",1033,118,0,118,"11.4"
"15742","Z60425",3775,527,13,514,"13.6"
"15743","Z60426",14132,3225,14,3211,"22.7"
"15744","Z60428",4917,435,0,435," 8.8"
"15745","Z60429",6458,914,9,905,"14.0"
"15746","Z60430",8083,501,0,501," 6.2"
"15747","Z60431",7722,465,82,383," 5.0"
"15748","Z60432",7083,731,35,696," 9.8"
"15749","Z60433",6288,800,0,800,"12.7"
"15750","Z60435",19869,1787,27,1760," 8.9"
"15751","Z60436",6360,491,0,491," 7.7"
"15752","Z60437",74,5,0,5," 6.8"
"15753","Z60438",12346,1223,9,1214," 9.8"
"15754","Z60439",8448,448,10,438," 5.2"
"15755","Z60440",17722,1437,36,1401," 7.9"
"15756","Z60441",12941,940,27,913," 7.1"
"15757","Z60442",3531,129,0,129," 3.7"
"15758","Z60443",8190,673,0,673," 8.2"
"15759","Z60444",728,58,0,58," 8.0"
"15760","Z60445",11158,972,0,972," 8.7"
"15761","Z60446",12953,1100,0,1100," 8.5"
"15762","Z60447",4749,271,46,225," 4.7"
"15763","Z60448",8763,351,0,351," 4.0"
"15764","Z60449",3645,276,0,276," 7.6"
"15765","Z60450",8952,847,185,662," 7.4"
"15766","Z60451",11642,308,8,300," 2.6"
"15767","Z60452",10739,470,0,470," 4.4"
"15768","Z60453",22958,1424,176,1248," 5.4"
"15769","Z60455",5798,315,0,315," 5.4"
"15770","Z60456",2107,182,52,130," 6.2"
"15771","Z60457",5350,493,7,486," 9.1"
"15772","Z60458",5679,789,26,763,"13.4"
"15773","Z60459",9335,374,8,366," 3.9"
"15774","Z60460",621,42,8,34," 5.5"
"15775","Z60461",2198,246,18,228,"10.4"
"15776","Z60462",15866,517,17,500," 3.2"
"15777","Z60463",5835,374,48,326," 5.6"
"15778","Z60464",4079,228,0,228," 5.6"
"15779","Z60465",7129,233,6,227," 3.2"
"15780","Z60466",9405,1005,0,1005,"10.7"
"15781","Z60467",9709,178,0,178," 1.8"
"15782","Z60468",2140,93,0,93," 4.3"
"15783","Z60469",1970,163,0,163," 8.3"
"15784","Z60470",242,19,0,19," 7.9"
"15785","Z60471",5903,589,0,589,"10.0"
"15786","Z60472",2221,421,0,421,"19.0"
"15787","Z60473",8027,581,9,572," 7.1"
"15788","Z60474",398,44,2,42,"10.6"
"15789","Z60475",4413,484,0,484,"11.0"
"15790","Z60476",1140,73,0,73," 6.4"
"15791","Z60477",16008,908,100,808," 5.0"
"15792","Z60478",6579,783,0,783,"11.9"
"15793","Z60479",283,42,12,30,"10.6"
"15794","Z60480",2221,96,0,96," 4.3"
"15795","Z60481",5693,1023,691,332," 5.8"
"15796","Z60482",4710,469,27,442," 9.4"
"15797","Z60487",8700,138,0,138," 1.6"
"15798","Z60490",5747,202,41,161," 2.8"
"15799","Z60491",8114,231,0,231," 2.8"
"15800","Z60501",3990,495,0,495,"12.4"
"15801","Z60502",8294,183,0,183," 2.2"
"15802","Z60503",5108,140,0,140," 2.7"
"15803","Z60504",14309,1201,0,1201," 8.4"
"15804","Z60505",22539,1988,8,1980," 8.8"
"15805","Z60506",18965,1575,149,1426," 7.5"
"15806","Z60510",11349,780,101,679," 6.0"
"15807","Z60511",640,23,0,23," 3.6"
"15808","Z60513",7460,459,40,419," 5.6"
"15809","Z60514",3964,135,0,135," 3.4"
"15810","Z60515",12115,608,49,559," 4.6"
"15811","Z60516",11534,667,72,595," 5.2"
"15812","Z60517",13529,932,0,932," 6.9"
"15813","Z60518",1697,199,0,199,"11.7"
"15814","Z60520",1123,101,3,98," 8.7"
"15815","Z60521",6195,438,45,393," 6.3"
"15816","Z60523",4825,423,32,391," 8.1"
"15817","Z60525",12396,670,90,580," 4.7"
"15818","Z60526",5578,259,11,248," 4.4"
"15819","Z60527",12290,846,41,805," 6.6"
"15820","Z60530",220,22,6,16," 7.3"
"15821","Z60531",875,146,14,132,"15.1"
"15822","Z60532",12248,658,10,648," 5.3"
"15823","Z60534",4154,180,0,180," 4.3"
"15824","Z60537",246,9,7,2," 0.8"
"15825","Z60538",9592,589,20,569," 5.9"
"15826","Z60540",16249,686,81,605," 3.7"
"15827","Z60541",1275,72,0,72," 5.6"
"15828","Z60542",6283,211,0,211," 3.4"
"15829","Z60543",12797,466,0,466," 3.6"
"15830","Z60544",9432,579,62,517," 5.5"
"15831","Z60545",4600,122,0,122," 2.7"
"15832","Z60546",6232,317,12,305," 4.9"
"15833","Z60548",4785,407,39,368," 7.7"
"15834","Z60550",669,78,0,78,"11.7"
"15835","Z60551",1562,77,0,77," 4.9"
"15836","Z60552",1869,101,37,64," 3.4"
"15837","Z60554",4291,125,24,101," 2.4"
"15838","Z60555",5406,366,118,248," 4.6"
"15839","Z60556",642,56,0,56," 8.7"
"15840","Z60558",4562,172,23,149," 3.3"
"15841","Z60559",10921,678,82,596," 5.5"
"15842","Z60560",8208,699,0,699," 8.5"
"15843","Z60561",9698,380,51,329," 3.4"
"15844","Z60563",15860,1244,132,1112," 7.0"
"15845","Z60564",13400,558,78,480," 3.6"
"15846","Z60565",14174,497,40,457," 3.2"
"15847","Z60585",7140,208,0,208," 2.9"
"15848","Z60586",13876,446,15,431," 3.1"
"15849","Z60601",9323,1661,1024,637," 6.8"
"15850","Z60602",824,118,80,38," 4.6"
"15851","Z60603",822,331,122,209,"25.4"
"15852","Z60604",490,152,94,58,"11.8"
"15853","Z60605",14738,1271,324,947," 6.4"
"15854","Z60606",2283,310,62,248,"10.9"
"15855","Z60607",13477,1463,222,1241," 9.2"
"15856","Z60608",29046,3515,65,3450,"11.9"
"15857","Z60609",24345,5061,110,4951,"20.3"
"15858","Z60610",25969,3032,1170,1862," 7.2"
"15859","Z60611",25212,5110,2959,2151," 8.5"
"15860","Z60612",15559,2051,65,1986,"12.8"
"15861","Z60613",29038,2870,322,2548," 8.8"
"15862","Z60614",36625,2920,924,1996," 5.4"
"15863","Z60615",23459,3464,70,3394,"14.5"
"15864","Z60616",25337,2993,230,2763,"10.9"
"15865","Z60617",33716,6016,58,5958,"17.7"
"15866","Z60618",39537,4107,594,3513," 8.9"
"15867","Z60619",32241,6545,41,6504,"20.2"
"15868","Z60620",30186,4733,60,4673,"15.5"
"15869","Z60621",16686,5672,15,5657,"33.9"
"15870","Z60622",25548,1916,192,1724," 6.7"
"15871","Z60623",31065,6136,263,5873,"18.9"
"15872","Z60624",15823,3960,111,3849,"24.3"
"15873","Z60625",32070,2938,168,2770," 8.6"
"15874","Z60626",25473,3433,157,3276,"12.9"
"15875","Z60628",28642,5374,38,5336,"18.6"
"15876","Z60629",34814,3974,96,3878,"11.1"
"15877","Z60630",22164,1631,8,1623," 7.3"
"15878","Z60631",12665,1172,82,1090," 8.6"
"15879","Z60632",27280,3150,205,2945,"10.8"
"15880","Z60633",5256,516,0,516," 9.8"
"15881","Z60634",27892,2429,270,2159," 7.7"
"15882","Z60636",14898,3595,11,3584,"24.1"
"15883","Z60637",24538,5726,74,5652,"23.0"
"15884","Z60638",21071,1219,50,1169," 5.5"
"15885","Z60639",28352,2947,178,2769," 9.8"
"15886","Z60640",37717,3307,118,3189," 8.5"
"15887","Z60641",27113,2427,218,2209," 8.1"
"15888","Z60643",19687,1842,27,1815," 9.2"
"15889","Z60644",19235,3141,26,3115,"16.2"
"15890","Z60645",17766,1930,64,1866,"10.5"
"15891","Z60646",11585,906,66,840," 7.3"
"15892","Z60647",37909,4045,527,3518," 9.3"
"15893","Z60649",26168,5669,6,5663,"21.6"
"15894","Z60651",22391,3274,17,3257,"14.5"
"15895","Z60652",13883,774,0,774," 5.6"
"15896","Z60653",16178,2557,31,2526,"15.6"
"15897","Z60654",12618,1558,436,1122," 8.9"
"15898","Z60655",10658,694,18,676," 6.3"
"15899","Z60656",12655,719,42,677," 5.3"
"15900","Z60657",40076,3322,582,2740," 6.8"
"15901","Z60659",14180,1959,48,1911,"13.5"
"15902","Z60660",23208,2834,269,2565,"11.1"
"15903","Z60661",6029,571,49,522," 8.7"
"15904","Z60707",16741,1266,97,1169," 7.0"
"15905","Z60712",4539,296,8,288," 6.3"
"15906","Z60714",12315,1083,0,1083," 8.8"
"15907","Z60803",8802,494,0,494," 5.6"
"15908","Z60804",24752,3031,73,2958,"12.0"
"15909","Z60805",7503,250,0,250," 3.3"
"15910","Z60827",12974,2681,0,2681,"20.7"
"15911","Z60901",14852,1919,37,1882,"12.7"
"15912","Z60910",198,32,4,28,"14.1"
"15913","Z60911",592,47,14,33," 5.6"
"15914","Z60912",274,59,23,36,"13.1"
"15915","Z60914",10593,482,55,427," 4.0"
"15916","Z60915",4420,300,0,300," 6.8"
"15917","Z60918",402,50,0,50,"12.4"
"15918","Z60919",213,8,1,7," 3.3"
"15919","Z60921",666,116,17,99,"14.9"
"15920","Z60922",1027,143,24,119,"11.6"
"15921","Z60924",838,126,16,110,"13.1"
"15922","Z60927",958,89,25,64," 6.7"
"15923","Z60928",322,7,0,7," 2.2"
"15924","Z60935",424,51,0,51,"12.0"
"15925","Z60936",1883,135,0,135," 7.2"
"15926","Z60938",880,100,0,100,"11.4"
"15927","Z60940",1327,98,0,98," 7.4"
"15928","Z60941",885,83,0,83," 9.4"
"15929","Z60942",2872,320,0,320,"11.1"
"15930","Z60945",102,16,0,16,"15.7"
"15931","Z60946",228,50,0,50,"21.9"
"15932","Z60948",823,248,131,117,"14.2"
"15933","Z60949",278,69,0,69,"24.8"
"15934","Z60950",4872,223,0,223," 4.6"
"15935","Z60953",1071,86,0,86," 8.0"
"15936","Z60954",2722,428,132,296,"10.9"
"15937","Z60957",2504,268,21,247," 9.9"
"15938","Z60959",498,62,0,62,"12.4"
"15939","Z60964",2128,196,30,166," 7.8"
"15940","Z60966",645,43,0,43," 6.7"
"15941","Z60970",3562,427,23,404,"11.3"
"15942","Z60973",220,14,0,14," 6.4"
"15943","Z61001",1189,690,616,74," 6.2"
"15944","Z61007",284,7,0,7," 2.5"
"15945","Z61008",13218,1337,47,1290," 9.8"
"15946","Z61010",3219,195,85,110," 3.4"
"15947","Z61011",951,66,0,66," 6.9"
"15948","Z61012",949,74,49,25," 2.6"
"15949","Z61013",233,14,7,7," 3.0"
"15950","Z61014",595,122,17,105,"17.6"
"15951","Z61015",330,7,0,7," 2.1"
"15952","Z61016",1965,9,0,9," 0.5"
"15953","Z61018",410,25,0,25," 6.1"
"15954","Z61019",1977,516,463,53," 2.7"
"15955","Z61020",1092,93,7,86," 7.9"
"15956","Z61021",9864,1056,199,857," 8.7"
"15957","Z61024",1046,99,6,93," 8.9"
"15958","Z61025",2139,292,61,231,"10.8"
"15959","Z61028",1202,242,183,59," 4.9"
"15960","Z61030",1000,52,0,52," 5.2"
"15961","Z61031",664,81,4,77,"11.6"
"15962","Z61032",14700,1814,121,1693,"11.5"
"15963","Z61036",5099,2228,1832,396," 7.8"
"15964","Z61039",385,37,3,34," 8.8"
"15965","Z61042",242,19,0,19," 7.9"
"15966","Z61043",38,4,0,4,"10.5"
"15967","Z61046",2080,884,767,117," 5.6"
"15968","Z61047",768,27,5,22," 2.9"
"15969","Z61048",1939,206,52,154," 7.9"
"15970","Z61052",405,5,0,5," 1.2"
"15971","Z61053",1479,235,69,166,"11.2"
"15972","Z61060",701,71,5,66," 9.4"
"15973","Z61061",3341,284,30,254," 7.6"
"15974","Z61062",833,73,0,73," 8.8"
"15975","Z61063",1836,223,63,160," 8.7"
"15976","Z61064",1613,138,4,134," 8.3"
"15977","Z61065",3675,195,0,195," 5.3"
"15978","Z61068",6096,485,7,478," 7.8"
"15979","Z61071",6690,617,67,550," 8.2"
"15980","Z61072",4510,131,0,131," 2.9"
"15981","Z61073",7393,350,75,275," 3.7"
"15982","Z61074",2274,364,134,230,"10.1"
"15983","Z61075",507,70,9,61,"12.0"
"15984","Z61078",620,46,0,46," 7.4"
"15985","Z61080",4382,349,0,349," 8.0"
"15986","Z61081",9450,851,90,761," 8.1"
"15987","Z61084",1184,84,7,77," 6.5"
"15988","Z61085",1628,142,93,49," 3.0"
"15989","Z61087",944,126,24,102,"10.8"
"15990","Z61088",2393,148,44,104," 4.3"
"15991","Z61089",362,38,4,34," 9.4"
"15992","Z61101",9156,1307,16,1291,"14.1"
"15993","Z61102",7456,983,37,946,"12.7"
"15994","Z61103",11197,1234,18,1216,"10.9"
"15995","Z61104",8930,1786,32,1754,"19.6"
"15996","Z61107",14279,1079,46,1033," 7.2"
"15997","Z61108",12548,1066,40,1026," 8.2"
"15998","Z61109",11928,1143,65,1078," 9.0"
"15999","Z61111",10370,666,40,626," 6.0"
"16000","Z61114",6649,462,75,387," 5.8"
"16001","Z61115",9163,530,61,469," 5.1"
"16002","Z61201",17296,1792,39,1753,"10.1"
"16003","Z61230",603,40,35,5," 0.8"
"16004","Z61231",2368,115,0,115," 4.9"
"16005","Z61232",601,22,0,22," 3.7"
"16006","Z61234",636,37,0,37," 5.8"
"16007","Z61235",650,24,0,24," 3.7"
"16008","Z61238",1359,83,4,79," 5.8"
"16009","Z61239",533,47,0,47," 8.8"
"16010","Z61240",2512,141,0,141," 5.6"
"16011","Z61241",2855,284,0,284," 9.9"
"16012","Z61244",10412,932,52,880," 8.5"
"16013","Z61250",1071,68,0,68," 6.3"
"16014","Z61252",2518,173,18,155," 6.2"
"16015","Z61254",4566,295,0,295," 6.5"
"16016","Z61256",847,50,10,40," 4.7"
"16017","Z61257",520,30,0,30," 5.8"
"16018","Z61260",428,31,0,31," 7.2"
"16019","Z61261",473,58,0,58,"12.3"
"16020","Z61262",523,24,0,24," 4.6"
"16021","Z61263",293,29,0,29," 9.9"
"16022","Z61264",4935,217,0,217," 4.4"
"16023","Z61265",20551,1573,9,1564," 7.6"
"16024","Z61270",2998,156,8,148," 4.9"
"16025","Z61275",1855,119,26,93," 5.0"
"16026","Z61277",1440,189,7,182,"12.6"
"16027","Z61278",144,14,6,8," 5.6"
"16028","Z61279",416,44,0,44,"10.6"
"16029","Z61281",1041,124,24,100," 9.6"
"16030","Z61283",563,30,0,30," 5.3"
"16031","Z61284",1052,49,0,49," 4.7"
"16032","Z61285",874,138,114,24," 2.7"
"16033","Z61301",5038,558,8,550,"10.9"
"16034","Z61310",1700,147,9,138," 8.1"
"16035","Z61311",131,63,0,63,"48.1"
"16036","Z61313",118,37,0,37,"31.4"
"16037","Z61314",368,43,1,42,"11.4"
"16038","Z61315",157,69,0,69,"43.9"
"16039","Z61318",376,69,32,37," 9.8"
"16040","Z61322",615,104,0,104,"16.9"
"16041","Z61326",1058,87,30,57," 5.4"
"16042","Z61327",654,85,27,58," 8.9"
"16043","Z61329",581,46,8,38," 6.5"
"16044","Z61330",581,39,11,28," 4.8"
"16045","Z61336",198,15,0,15," 7.6"
"16046","Z61337",178,10,0,10," 5.6"
"16047","Z61338",159,16,0,16,"10.1"
"16048","Z61340",132,11,0,11," 8.3"
"16049","Z61342",3722,419,50,369," 9.9"
"16050","Z61348",2176,308,0,308,"14.2"
"16051","Z61349",388,55,3,52,"13.4"
"16052","Z61350",11136,1391,52,1339,"12.0"
"16053","Z61353",591,62,4,58," 9.8"
"16054","Z61354",5109,581,60,521,"10.2"
"16055","Z61356",5448,562,67,495," 9.1"
"16056","Z61359",140,21,0,21,"15.0"
"16057","Z61360",1465,207,36,171,"11.7"
"16058","Z61361",574,104,11,93,"16.2"
"16059","Z61362",2665,205,25,180," 6.8"
"16060","Z61363",118,7,4,3," 2.5"
"16061","Z61364",9009,1088,107,981,"10.9"
"16062","Z61367",384,35,4,31," 8.1"
"16063","Z61369",756,99,6,93,"12.3"
"16064","Z61370",614,42,0,42," 6.8"
"16065","Z61372",63,2,0,2," 3.2"
"16066","Z61373",880,77,0,77," 8.8"
"16067","Z61375",865,366,276,90,"10.4"
"16068","Z61376",1077,61,7,54," 5.0"
"16069","Z61378",236,11,0,11," 4.7"
"16070","Z61379",583,56,8,48," 8.2"
"16071","Z61401",15715,1527,57,1470," 9.4"
"16072","Z61410",1654,187,27,160," 9.7"
"16073","Z61412",629,34,0,34," 5.4"
"16074","Z61413",484,60,14,46," 9.5"
"16075","Z61414",364,34,8,26," 7.1"
"16076","Z61415",810,164,29,135,"16.7"
"16077","Z61418",318,46,0,46,"14.5"
"16078","Z61419",73,4,0,4," 5.5"
"16079","Z61421",604,70,9,61,"10.1"
"16080","Z61422",1548,173,28,145," 9.4"
"16081","Z61423",296,41,0,41,"13.9"
"16082","Z61425",268,151,128,23," 8.6"
"16083","Z61427",1047,142,7,135,"12.9"
"16084","Z61428",832,423,330,93,"11.2"
"16085","Z61434",1610,218,37,181,"11.2"
"16086","Z61437",536,117,101,16," 3.0"
"16087","Z61440",330,38,5,33,"10.0"
"16088","Z61441",486,44,15,29," 6.0"
"16089","Z61443",6576,769,0,769,"11.7"
"16090","Z61447",403,37,2,35," 8.7"
"16091","Z61448",1600,85,5,80," 5.0"
"16092","Z61449",223,6,0,6," 2.7"
"16093","Z61450",847,55,7,48," 5.7"
"16094","Z61454",311,50,25,25," 8.0"
"16095","Z61455",9470,1617,28,1589,"16.8"
"16096","Z61458",392,12,2,10," 2.6"
"16097","Z61462",4940,573,109,464," 9.4"
"16098","Z61465",575,57,0,57," 9.9"
"16099","Z61467",429,22,0,22," 5.1"
"16100","Z61469",1256,250,128,122," 9.7"
"16101","Z61470",187,10,0,10," 5.3"
"16102","Z61471",56,14,0,14,"25.0"
"16103","Z61472",275,38,0,38,"13.8"
"16104","Z61473",734,79,0,79,"10.8"
"16105","Z61474",98,5,0,5," 5.1"
"16106","Z61476",217,9,0,9," 4.1"
"16107","Z61478",150,42,7,35,"23.3"
"16108","Z61479",79,12,0,12,"15.2"
"16109","Z61480",589,76,9,67,"11.4"
"16110","Z61483",872,118,0,118,"13.5"
"16111","Z61484",393,75,0,75,"19.1"
"16112","Z61486",671,84,0,84,"12.5"
"16113","Z61488",482,63,5,58,"12.0"
"16114","Z61489",428,55,17,38," 8.9"
"16115","Z61490",557,33,0,33," 5.9"
"16116","Z61491",1066,93,0,93," 8.7"
"16117","Z61516",285,8,0,8," 2.8"
"16118","Z61517",1401,138,0,138," 9.9"
"16119","Z61520",7464,692,75,617," 8.3"
"16120","Z61523",4848,306,0,306," 6.3"
"16121","Z61525",3300,162,2,160," 4.8"
"16122","Z61526",353,9,0,9," 2.5"
"16123","Z61528",1157,62,0,62," 5.4"
"16124","Z61529",1221,87,4,83," 6.8"
"16125","Z61530",2657,143,26,117," 4.4"
"16126","Z61531",1405,144,9,135," 9.6"
"16127","Z61534",740,39,0,39," 5.3"
"16128","Z61535",570,42,11,31," 5.4"
"16129","Z61536",1232,37,0,37," 3.0"
"16130","Z61537",1269,150,54,96," 7.6"
"16131","Z61540",1323,136,53,83," 6.3"
"16132","Z61542",1879,203,11,192,"10.2"
"16133","Z61544",274,40,4,36,"13.1"
"16134","Z61545",353,32,7,25," 7.1"
"16135","Z61546",1892,204,83,121," 6.4"
"16136","Z61547",1605,72,6,66," 4.1"
"16137","Z61548",4619,324,13,311," 6.7"
"16138","Z61550",7452,263,10,253," 3.4"
"16139","Z61552",103,23,0,23,"22.3"
"16140","Z61554",19015,1361,6,1355," 7.1"
"16141","Z61559",1241,85,0,85," 6.8"
"16142","Z61561",1157,95,0,95," 8.2"
"16143","Z61564",416,9,0,9," 2.2"
"16144","Z61565",653,63,13,50," 7.7"
"16145","Z61567",358,84,9,75,"20.9"
"16146","Z61568",1653,46,9,37," 2.2"
"16147","Z61570",675,59,13,46," 6.8"
"16148","Z61571",9717,387,7,380," 3.9"
"16149","Z61572",493,23,0,23," 4.7"
"16150","Z61602",678,79,0,79,"11.7"
"16151","Z61603",7655,1163,26,1137,"14.9"
"16152","Z61604",14592,1194,36,1158," 7.9"
"16153","Z61605",7042,1257,0,1257,"17.9"
"16154","Z61606",2990,645,17,628,"21.0"
"16155","Z61607",4935,240,21,219," 4.4"
"16156","Z61610",2506,229,0,229," 9.1"
"16157","Z61611",11444,852,37,815," 7.1"
"16158","Z61614",13695,802,80,722," 5.3"
"16159","Z61615",10495,500,17,483," 4.6"
"16160","Z61616",3225,419,0,419,"13.0"
"16161","Z61701",16798,1727,81,1646," 9.8"
"16162","Z61704",14823,724,53,671," 4.5"
"16163","Z61721",281,21,0,21," 7.5"
"16164","Z61723",863,74,16,58," 6.7"
"16165","Z61725",572,27,20,7," 1.2"
"16166","Z61726",1115,103,0,103," 9.2"
"16167","Z61727",4419,326,8,318," 7.2"
"16168","Z61728",597,68,8,60,"10.1"
"16169","Z61730",150,2,0,2," 1.3"
"16170","Z61732",764,12,0,12," 1.6"
"16171","Z61733",388,30,19,11," 2.8"
"16172","Z61734",1157,47,10,37," 3.2"
"16173","Z61737",249,14,14,0," 0.0"
"16174","Z61738",1694,84,1,83," 4.9"
"16175","Z61739",2022,58,0,58," 2.9"
"16176","Z61740",732,46,0,46," 6.3"
"16177","Z61741",670,29,0,29," 4.3"
"16178","Z61743",102,9,0,9," 8.8"
"16179","Z61744",801,73,0,73," 9.1"
"16180","Z61745",1590,22,0,22," 1.4"
"16181","Z61747",640,95,12,83,"13.0"
"16182","Z61748",1214,81,14,67," 5.5"
"16183","Z61752",1897,177,0,177," 9.3"
"16184","Z61753",1295,48,0,48," 3.7"
"16185","Z61754",534,49,0,49," 9.2"
"16186","Z61755",2070,186,12,174," 8.4"
"16187","Z61756",986,104,11,93," 9.4"
"16188","Z61759",703,48,0,48," 6.8"
"16189","Z61760",1021,45,16,29," 2.8"
"16190","Z61761",21030,1876,62,1814," 8.6"
"16191","Z61764",5720,432,32,400," 7.0"
"16192","Z61770",459,61,0,61,"13.3"
"16193","Z61771",366,34,0,34," 9.3"
"16194","Z61774",398,43,0,43,"10.8"
"16195","Z61777",408,48,0,48,"11.8"
"16196","Z61778",423,63,13,50,"11.8"
"16197","Z61802",9737,1340,40,1300,"13.4"
"16198","Z61810",166,51,4,47,"28.3"
"16199","Z61811",290,49,27,22," 7.6"
"16200","Z61813",843,68,0,68," 8.1"
"16201","Z61815",95,1,0,1," 1.1"
"16202","Z61816",221,11,0,11," 5.0"
"16203","Z61817",1125,97,0,97," 8.6"
"16204","Z61818",697,66,0,66," 9.5"
"16205","Z61820",15438,2002,54,1948,"12.6"
"16206","Z61821",14451,1295,64,1231," 8.5"
"16207","Z61822",10303,651,59,592," 5.7"
"16208","Z61830",130,6,0,6," 4.6"
"16209","Z61832",17484,2623,20,2603,"14.9"
"16210","Z61833",996,48,0,48," 4.8"
"16211","Z61834",2708,189,0,189," 7.0"
"16212","Z61839",295,33,0,33,"11.2"
"16213","Z61842",1390,138,21,117," 8.4"
"16214","Z61843",910,23,0,23," 2.5"
"16215","Z61844",398,64,0,64,"16.1"
"16216","Z61846",2266,284,31,253,"11.2"
"16217","Z61847",518,70,0,70,"13.5"
"16218","Z61849",772,67,0,67," 8.7"
"16219","Z61852",120,21,0,21,"17.5"
"16220","Z61853",5178,157,0,157," 3.0"
"16221","Z61856",3263,260,19,241," 7.4"
"16222","Z61858",1350,91,0,91," 6.7"
"16223","Z61859",486,18,0,18," 3.7"
"16224","Z61862",220,16,0,16," 7.3"
"16225","Z61864",705,21,9,12," 1.7"
"16226","Z61865",536,31,0,31," 5.8"
"16227","Z61866",6601,1175,32,1143,"17.3"
"16228","Z61870",604,76,0,76,"12.6"
"16229","Z61871",110,9,3,6," 5.5"
"16230","Z61873",2400,105,0,105," 4.4"
"16231","Z61874",3303,163,23,140," 4.2"
"16232","Z61875",352,48,0,48,"13.6"
"16233","Z61876",346,47,0,47,"13.6"
"16234","Z61877",733,41,0,41," 5.6"
"16235","Z61878",756,40,0,40," 5.3"
"16236","Z61880",1645,166,0,166,"10.1"
"16237","Z61882",344,50,1,49,"14.2"
"16238","Z61883",1879,148,0,148," 7.9"
"16239","Z61910",1661,109,0,109," 6.6"
"16240","Z61911",1594,19,0,19," 1.2"
"16241","Z61913",727,74,0,74,"10.2"
"16242","Z61914",813,51,2,49," 6.0"
"16243","Z61919",385,23,0,23," 6.0"
"16244","Z61920",10336,1021,4,1017," 9.8"
"16245","Z61924",1147,133,14,119,"10.4"
"16246","Z61925",232,16,0,16," 6.9"
"16247","Z61928",358,28,0,28," 7.8"
"16248","Z61929",315,29,2,27," 8.6"
"16249","Z61930",220,31,0,31,"14.1"
"16250","Z61931",493,32,0,32," 6.5"
"16251","Z61932",240,24,0,24,"10.0"
"16252","Z61933",522,98,2,96,"18.4"
"16253","Z61937",907,129,14,115,"12.7"
"16254","Z61938",10523,1124,0,1124,"10.7"
"16255","Z61942",556,64,0,64,"11.5"
"16256","Z61943",775,112,0,112,"14.5"
"16257","Z61944",6080,717,42,675,"11.1"
"16258","Z61951",3578,298,60,238," 6.7"
"16259","Z61953",2779,278,10,268," 9.6"
"16260","Z61956",1308,149,7,142,"10.9"
"16261","Z61957",969,90,19,71," 7.3"
"16262","Z62002",15956,2062,109,1953,"12.2"
"16263","Z62006",289,58,28,30,"10.4"
"16264","Z62009",828,80,11,69," 8.3"
"16265","Z62010",4694,299,64,235," 5.0"
"16266","Z62011",122,38,0,38,"31.1"
"16267","Z62012",2639,172,15,157," 5.9"
"16268","Z62013",346,117,75,42,"12.1"
"16269","Z62014",1860,155,28,127," 6.8"
"16270","Z62015",206,44,0,44,"21.4"
"16271","Z62016",1767,132,62,70," 4.0"
"16272","Z62018",1467,55,13,42," 2.9"
"16273","Z62021",442,78,0,78,"17.6"
"16274","Z62022",450,22,0,22," 4.9"
"16275","Z62025",13058,957,184,773," 5.9"
"16276","Z62031",548,160,121,39," 7.1"
"16277","Z62032",317,59,0,59,"18.6"
"16278","Z62033",2236,298,97,201," 9.0"
"16279","Z62034",5804,463,0,463," 8.0"
"16280","Z62035",7006,480,30,450," 6.4"
"16281","Z62037",998,206,75,131,"13.1"
"16282","Z62040",19799,2194,71,2123,"10.7"
"16283","Z62044",1027,150,45,105,"10.2"
"16284","Z62046",289,13,0,13," 4.5"
"16285","Z62047",876,130,2,128,"14.6"
"16286","Z62048",782,57,20,37," 4.7"
"16287","Z62049",2577,360,20,340,"13.2"
"16288","Z62050",194,27,0,27,"13.9"
"16289","Z62051",410,41,0,41,"10.0"
"16290","Z62052",5675,507,33,474," 8.4"
"16291","Z62053",338,123,82,41,"12.1"
"16292","Z62056",4842,475,87,388," 8.0"
"16293","Z62058",385,32,8,24," 6.2"
"16294","Z62059",436,72,0,72,"16.5"
"16295","Z62060",2585,597,51,546,"21.1"
"16296","Z62061",769,33,0,33," 4.3"
"16297","Z62062",3373,150,0,150," 4.4"
"16298","Z62063",477,52,12,40," 8.4"
"16299","Z62067",1150,56,0,56," 4.9"
"16300","Z62069",1489,220,45,175,"11.8"
"16301","Z62074",557,101,40,61,"11.0"
"16302","Z62075",1616,257,5,252,"15.6"
"16303","Z62080",1222,197,30,167,"13.7"
"16304","Z62082",1424,303,15,288,"20.2"
"16305","Z62084",739,91,0,91,"12.3"
"16306","Z62086",631,78,17,61," 9.7"
"16307","Z62088",3388,381,50,331," 9.8"
"16308","Z62089",180,24,0,24,"13.3"
"16309","Z62090",567,101,0,101,"17.8"
"16310","Z62092",1270,144,31,113," 8.9"
"16311","Z62094",463,80,0,80,"17.3"
"16312","Z62095",5270,500,97,403," 7.6"
"16313","Z62097",1136,33,0,33," 2.9"
"16314","Z62201",2975,415,0,415,"13.9"
"16315","Z62203",3400,681,0,681,"20.0"
"16316","Z62204",4673,1300,12,1288,"27.6"
"16317","Z62205",4677,1095,0,1095,"23.4"
"16318","Z62206",7190,1788,10,1778,"24.7"
"16319","Z62207",4051,732,0,732,"18.1"
"16320","Z62208",8181,948,53,895,"10.9"
"16321","Z62214",552,107,26,81,"14.7"
"16322","Z62215",633,48,10,38," 6.0"
"16323","Z62216",1048,19,8,11," 1.0"
"16324","Z62218",635,33,3,30," 4.7"
"16325","Z62219",396,18,0,18," 4.5"
"16326","Z62220",9376,1607,0,1607,"17.1"
"16327","Z62221",12659,1424,16,1408,"11.1"
"16328","Z62223",7854,841,32,809,"10.3"
"16329","Z62225",1528,201,50,151," 9.9"
"16330","Z62226",13622,1477,109,1368,"10.0"
"16331","Z62230",2646,216,37,179," 6.8"
"16332","Z62231",3606,689,401,288," 8.0"
"16333","Z62232",2933,358,0,358,"12.2"
"16334","Z62233",3185,429,121,308," 9.7"
"16335","Z62234",14690,1450,175,1275," 8.7"
"16336","Z62236",5291,144,24,120," 2.3"
"16337","Z62238",311,80,3,77,"24.8"
"16338","Z62239",2332,309,0,309,"13.3"
"16339","Z62240",810,152,7,145,"17.9"
"16340","Z62241",576,109,0,109,"18.9"
"16341","Z62242",605,112,66,46," 7.6"
"16342","Z62243",2449,88,38,50," 2.0"
"16343","Z62244",500,66,14,52,"10.4"
"16344","Z62245",698,63,9,54," 7.7"
"16345","Z62246",3752,481,19,462,"12.3"
"16346","Z62248",140,20,4,16,"11.4"
"16347","Z62249",6438,401,66,335," 5.2"
"16348","Z62250",173,5,0,5," 2.9"
"16349","Z62253",444,108,68,40," 9.0"
"16350","Z62254",2449,340,101,239," 9.8"
"16351","Z62257",1457,211,32,179,"12.3"
"16352","Z62258",3780,377,42,335," 8.9"
"16353","Z62260",2810,147,31,116," 4.1"
"16354","Z62262",881,137,13,124,"14.1"
"16355","Z62263",2366,296,60,236,"10.0"
"16356","Z62264",1416,181,0,181,"12.8"
"16357","Z62265",1795,142,23,119," 6.6"
"16358","Z62268",313,16,9,7," 2.2"
"16359","Z62269",12351,723,109,614," 5.0"
"16360","Z62271",971,136,45,91," 9.4"
"16361","Z62272",754,108,8,100,"13.3"
"16362","Z62273",173,24,5,19,"11.0"
"16363","Z62274",2918,407,66,341,"11.7"
"16364","Z62275",1475,81,15,66," 4.5"
"16365","Z62277",677,141,4,137,"20.2"
"16366","Z62278",2805,242,74,168," 6.0"
"16367","Z62281",798,76,4,72," 9.0"
"16368","Z62282",229,30,0,30,"13.1"
"16369","Z62285",1662,27,0,27," 1.6"
"16370","Z62286",2860,342,35,307,"10.7"
"16371","Z62288",1342,159,0,159,"11.8"
"16372","Z62289",151,14,0,14," 9.3"
"16373","Z62292",360,52,0,52,"14.4"
"16374","Z62293",1909,114,13,101," 5.3"
"16375","Z62294",5226,131,0,131," 2.5"
"16376","Z62295",657,92,17,75,"11.4"
"16377","Z62298",6744,545,19,526," 7.8"
"16378","Z62301",15666,1826,5,1821,"11.6"
"16379","Z62305",7810,503,99,404," 5.2"
"16380","Z62311",388,80,10,70,"18.0"
"16381","Z62312",1091,141,12,129,"11.8"
"16382","Z62313",126,10,0,10," 7.9"
"16383","Z62314",368,128,54,74,"20.1"
"16384","Z62320",815,75,0,75," 9.2"
"16385","Z62321",1997,236,23,213,"10.7"
"16386","Z62324",515,82,0,82,"15.9"
"16387","Z62326",1189,159,0,159,"13.4"
"16388","Z62330",964,212,34,178,"18.5"
"16389","Z62334",64,8,0,8,"12.5"
"16390","Z62338",517,109,0,109,"21.1"
"16391","Z62339",391,33,2,31," 7.9"
"16392","Z62340",758,79,7,72," 9.5"
"16393","Z62341",1577,124,0,124," 7.9"
"16394","Z62343",308,60,26,34,"11.0"
"16395","Z62351",796,49,6,43," 5.4"
"16396","Z62352",126,29,0,29,"23.0"
"16397","Z62353",1705,197,72,125," 7.3"
"16398","Z62354",981,289,125,164,"16.7"
"16399","Z62355",476,111,35,76,"16.0"
"16400","Z62358",372,24,0,24," 6.5"
"16401","Z62360",758,48,0,48," 6.3"
"16402","Z62362",240,58,14,44,"18.3"
"16403","Z62363",2662,191,52,139," 5.2"
"16404","Z62365",287,34,22,12," 4.2"
"16405","Z62366",832,210,77,133,"16.0"
"16406","Z62374",150,46,0,46,"30.7"
"16407","Z62376",537,55,32,23," 4.3"
"16408","Z62378",524,84,41,43," 8.2"
"16409","Z62379",989,166,34,132,"13.3"
"16410","Z62401",8506,886,249,637," 7.5"
"16411","Z62410",456,57,12,45," 9.9"
"16412","Z62411",1809,171,7,164," 9.1"
"16413","Z62414",887,146,25,121,"13.6"
"16414","Z62417",1101,221,8,213,"19.3"
"16415","Z62418",967,259,32,227,"23.5"
"16416","Z62420",2198,306,32,274,"12.5"
"16417","Z62421",316,40,0,40,"12.7"
"16418","Z62422",506,53,15,38," 7.5"
"16419","Z62424",895,55,0,55," 6.1"
"16420","Z62426",508,110,21,89,"17.5"
"16421","Z62427",708,82,54,28," 4.0"
"16422","Z62428",1435,129,51,78," 5.4"
"16423","Z62431",483,61,18,43," 8.9"
"16424","Z62433",432,49,0,49,"11.3"
"16425","Z62434",171,9,5,4," 2.3"
"16426","Z62439",3620,456,46,410,"11.3"
"16427","Z62440",646,119,0,119,"18.4"
"16428","Z62441",3299,408,118,290," 8.8"
"16429","Z62442",1315,239,93,146,"11.1"
"16430","Z62443",659,32,0,32," 4.9"
"16431","Z62444",175,48,23,25,"14.3"
"16432","Z62445",408,14,0,14," 3.4"
"16433","Z62447",1697,315,216,99," 5.8"
"16434","Z62448",2712,361,8,353,"13.0"
"16435","Z62449",1386,150,51,99," 7.1"
"16436","Z62450",5904,775,127,648,"11.0"
"16437","Z62451",965,88,10,78," 8.1"
"16438","Z62452",181,23,0,23,"12.7"
"16439","Z62454",5026,678,38,640,"12.7"
"16440","Z62458",914,126,0,126,"13.8"
"16441","Z62459",147,21,0,21,"14.3"
"16442","Z62460",455,108,22,86,"18.9"
"16443","Z62462",389,24,4,20," 5.1"
"16444","Z62463",564,53,0,53," 9.4"
"16445","Z62465",391,18,7,11," 2.8"
"16446","Z62466",736,121,0,121,"16.4"
"16447","Z62467",1410,63,0,63," 4.5"
"16448","Z62468",1062,66,3,63," 5.9"
"16449","Z62471",3759,551,18,533,"14.2"
"16450","Z62473",575,55,0,55," 9.6"
"16451","Z62474",451,39,6,33," 7.3"
"16452","Z62475",147,8,8,0," 0.0"
"16453","Z62476",926,141,3,138,"14.9"
"16454","Z62477",471,58,5,53,"11.3"
"16455","Z62478",180,17,0,17," 9.4"
"16456","Z62479",324,21,5,16," 4.9"
"16457","Z62481",182,38,0,38,"20.9"
"16458","Z62501",1202,85,19,66," 5.5"
"16459","Z62510",869,47,9,38," 4.4"
"16460","Z62513",753,122,0,122,"16.2"
"16461","Z62515",513,51,0,51," 9.9"
"16462","Z62520",672,37,10,27," 4.0"
"16463","Z62521",16726,1700,228,1472," 8.8"
"16464","Z62522",7371,1129,35,1094,"14.8"
"16465","Z62523",476,91,0,91,"19.1"
"16466","Z62526",16140,1858,136,1722,"10.7"
"16467","Z62530",673,30,0,30," 4.5"
"16468","Z62531",876,49,6,43," 4.9"
"16469","Z62532",41,6,0,6,"14.6"
"16470","Z62533",411,46,26,20," 4.9"
"16471","Z62534",578,48,17,31," 5.4"
"16472","Z62535",1415,34,0,34," 2.4"
"16473","Z62538",165,19,0,19,"11.5"
"16474","Z62539",537,29,0,29," 5.4"
"16475","Z62543",209,34,0,34,"16.3"
"16476","Z62544",881,75,0,75," 8.5"
"16477","Z62546",658,128,39,89,"13.5"
"16478","Z62547",339,38,3,35,"10.3"
"16479","Z62548",860,111,0,111,"12.9"
"16480","Z62549",2537,147,13,134," 5.3"
"16481","Z62550",1246,172,42,130,"10.4"
"16482","Z62553",190,6,0,6," 3.2"
"16483","Z62554",656,12,0,12," 1.8"
"16484","Z62555",212,27,12,15," 7.1"
"16485","Z62557",3968,687,186,501,"12.6"
"16486","Z62558",1507,81,10,71," 4.7"
"16487","Z62560",567,76,3,73,"12.9"
"16488","Z62561",2101,110,0,110," 5.2"
"16489","Z62563",2257,73,0,73," 3.2"
"16490","Z62565",3697,498,142,356," 9.6"
"16491","Z62567",480,41,0,41," 8.5"
"16492","Z62568",6898,484,40,444," 6.4"
"16493","Z62570",256,46,0,46,"18.0"
"16494","Z62571",565,54,2,52," 9.2"
"16495","Z62572",238,19,4,15," 6.3"
"16496","Z62611",524,72,24,48," 9.2"
"16497","Z62612",852,87,0,87,"10.2"
"16498","Z62613",1510,84,9,75," 5.0"
"16499","Z62615",2172,126,0,126," 5.8"
"16500","Z62617",524,215,94,121,"23.1"
"16501","Z62618",3280,307,4,303," 9.2"
"16502","Z62621",560,38,10,28," 5.0"
"16503","Z62625",336,9,0,9," 2.7"
"16504","Z62626",3756,451,10,441,"11.7"
"16505","Z62627",500,82,40,42," 8.4"
"16506","Z62629",5364,221,0,221," 4.1"
"16507","Z62633",294,24,0,24," 8.2"
"16508","Z62635",268,35,0,35,"13.1"
"16509","Z62638",564,59,0,59,"10.5"
"16510","Z62640",1782,286,109,177," 9.9"
"16511","Z62642",749,116,31,85,"11.3"
"16512","Z62643",211,22,5,17," 8.1"
"16513","Z62644",2591,333,101,232," 9.0"
"16514","Z62649",218,38,0,38,"17.4"
"16515","Z62650",11635,1171,109,1062," 9.1"
"16516","Z62655",271,22,0,22," 8.1"
"16517","Z62656",8023,552,61,491," 6.1"
"16518","Z62661",597,82,0,82,"13.7"
"16519","Z62664",1404,77,6,71," 5.1"
"16520","Z62665",749,138,33,105,"14.0"
"16521","Z62666",255,25,2,23," 9.0"
"16522","Z62667",152,12,0,12," 7.9"
"16523","Z62668",640,81,0,81,"12.7"
"16524","Z62670",1293,94,3,91," 7.0"
"16525","Z62671",213,48,0,48,"22.5"
"16526","Z62673",240,2,0,2," 0.8"
"16527","Z62674",640,55,7,48," 7.5"
"16528","Z62675",2891,261,89,172," 5.9"
"16529","Z62677",1095,86,12,74," 6.8"
"16530","Z62681",2495,264,48,216," 8.7"
"16531","Z62682",374,46,0,46,"12.3"
"16532","Z62684",2134,52,0,52," 2.4"
"16533","Z62685",836,61,27,34," 4.1"
"16534","Z62689",242,8,0,8," 3.3"
"16535","Z62690",1850,231,24,207,"11.2"
"16536","Z62691",987,93,4,89," 9.0"
"16537","Z62692",916,126,19,107,"11.7"
"16538","Z62693",584,22,0,22," 3.8"
"16539","Z62694",1373,163,11,152,"11.1"
"16540","Z62701",672,55,0,55," 8.2"
"16541","Z62702",18032,2173,28,2145,"11.9"
"16542","Z62703",13976,1651,66,1585,"11.3"
"16543","Z62704",20744,2027,145,1882," 9.1"
"16544","Z62707",3077,117,0,117," 3.8"
"16545","Z62711",6914,279,0,279," 4.0"
"16546","Z62712",4225,145,69,76," 1.8"
"16547","Z62801",10175,1488,158,1330,"13.1"
"16548","Z62803",392,25,0,25," 6.4"
"16549","Z62806",1572,160,18,142," 9.0"
"16550","Z62807",443,98,38,60,"13.5"
"16551","Z62812",5241,608,42,566,"10.8"
"16552","Z62814",833,89,0,89,"10.7"
"16553","Z62817",271,51,0,51,"18.8"
"16554","Z62818",121,7,0,7," 5.8"
"16555","Z62820",91,22,0,22,"24.2"
"16556","Z62821",3747,504,77,427,"11.4"
"16557","Z62822",1563,267,14,253,"16.2"
"16558","Z62823",830,91,12,79," 9.5"
"16559","Z62824",823,123,24,99,"12.0"
"16560","Z62828",637,76,5,71,"11.1"
"16561","Z62831",255,43,4,39,"15.3"
"16562","Z62832",4452,696,88,608,"13.7"
"16563","Z62835",493,59,5,54,"11.0"
"16564","Z62837",4429,481,24,457,"10.3"
"16565","Z62838",774,125,0,125,"16.1"
"16566","Z62839",3028,428,0,428,"14.1"
"16567","Z62842",367,37,5,32," 8.7"
"16568","Z62844",1039,187,57,130,"12.5"
"16569","Z62848",336,27,0,27," 8.0"
"16570","Z62849",986,128,38,90," 9.1"
"16571","Z62858",1376,122,11,111," 8.1"
"16572","Z62859",2790,418,153,265," 9.5"
"16573","Z62863",4703,546,94,452," 9.6"
"16574","Z62864",11365,1058,208,850," 7.5"
"16575","Z62865",892,97,14,83," 9.3"
"16576","Z62868",680,114,9,105,"15.4"
"16577","Z62869",1305,150,59,91," 7.0"
"16578","Z62870",881,80,11,69," 7.8"
"16579","Z62871",334,24,0,24," 7.2"
"16580","Z62875",509,62,7,55,"10.8"
"16581","Z62880",236,24,19,5," 2.1"
"16582","Z62881",5206,590,114,476," 9.1"
"16583","Z62882",998,110,19,91," 9.1"
"16584","Z62884",1308,160,39,121," 9.3"
"16585","Z62885",372,10,0,10," 2.7"
"16586","Z62886",192,37,5,32,"16.7"
"16587","Z62888",922,119,16,103,"11.2"
"16588","Z62890",1328,221,33,188,"14.2"
"16589","Z62892",186,65,16,49,"26.3"
"16590","Z62894",372,37,12,25," 6.7"
"16591","Z62895",896,64,11,53," 5.9"
"16592","Z62896",5748,656,56,600,"10.4"
"16593","Z62897",179,35,17,18,"10.1"
"16594","Z62898",852,35,0,35," 4.1"
"16595","Z62901",13043,2869,86,2783,"21.3"
"16596","Z62902",2309,230,28,202," 8.7"
"16597","Z62903",1352,306,9,297,"22.0"
"16598","Z62905",362,74,6,68,"18.8"
"16599","Z62906",3062,384,11,373,"12.2"
"16600","Z62907",1006,134,8,126,"12.5"
"16601","Z62910",1361,299,73,226,"16.6"
"16602","Z62912",557,93,33,60,"10.8"
"16603","Z62914",1915,646,53,593,"31.0"
"16604","Z62917",1246,135,15,120," 9.6"
"16605","Z62918",4570,613,9,604,"13.2"
"16606","Z62920",1449,217,40,177,"12.2"
"16607","Z62922",1566,366,226,140," 8.9"
"16608","Z62924",1326,153,19,134,"10.1"
"16609","Z62926",1034,142,22,120,"11.6"
"16610","Z62928",166,65,33,32,"19.3"
"16611","Z62930",2742,414,19,395,"14.4"
"16612","Z62931",885,222,131,91,"10.3"
"16613","Z62932",775,98,13,85,"11.0"
"16614","Z62933",605,49,11,38," 6.3"
"16615","Z62935",908,231,115,116,"12.8"
"16616","Z62938",1599,623,310,313,"19.6"
"16617","Z62939",1563,292,86,206,"13.2"
"16618","Z62942",356,81,14,67,"18.8"
"16619","Z62946",6146,761,158,603," 9.8"
"16620","Z62947",346,129,112,17," 4.9"
"16621","Z62948",6203,788,0,788,"12.7"
"16622","Z62951",2390,336,0,336,"14.1"
"16623","Z62952",1561,293,31,262,"16.8"
"16624","Z62956",496,152,19,133,"26.8"
"16625","Z62957",483,130,35,95,"19.7"
"16626","Z62959",12427,1417,233,1184," 9.5"
"16627","Z62960",5440,819,46,773,"14.2"
"16628","Z62963",265,46,6,40,"15.1"
"16629","Z62964",720,145,0,145,"20.1"
"16630","Z62966",7402,1258,0,1258,"17.0"
"16631","Z62969",349,160,21,139,"39.8"
"16632","Z62972",690,245,156,89,"12.9"
"16633","Z62977",326,67,10,57,"17.5"
"16634","Z62979",615,72,14,58," 9.4"
"16635","Z62982",607,158,60,98,"16.1"
"16636","Z62983",666,65,9,56," 8.4"
"16637","Z62984",952,130,32,98,"10.3"
"16638","Z62987",533,131,101,30," 5.6"
"16639","Z62988",750,223,11,212,"28.3"
"16640","Z62990",437,146,16,130,"29.7"
"16641","Z62992",485,140,14,126,"26.0"
"16642","Z62995",1937,355,74,281,"14.5"
"16643","Z62996",271,67,28,39,"14.4"
"16644","Z62999",839,189,11,178,"21.2"
"16645","Z63005",6537,383,38,345," 5.3"
"16646","Z63010",14841,1099,64,1035," 7.0"
"16647","Z63011",14639,691,27,664," 4.5"
"16648","Z63012",3804,19,0,19," 0.5"
"16649","Z63013",677,44,15,29," 4.3"
"16650","Z63014",301,49,28,21," 7.0"
"16651","Z63015",925,44,0,44," 4.8"
"16652","Z63016",3104,409,93,316,"10.2"
"16653","Z63017",17320,694,148,546," 3.2"
"16654","Z63019",1840,157,0,157," 8.5"
"16655","Z63020",8335,720,121,599," 7.2"
"16656","Z63021",22207,1021,158,863," 3.9"
"16657","Z63023",2412,175,30,145," 6.0"
"16658","Z63025",4945,314,97,217," 4.4"
"16659","Z63026",17361,952,14,938," 5.4"
"16660","Z63028",10885,686,91,595," 5.5"
"16661","Z63031",20021,1564,267,1297," 6.5"
"16662","Z63033",18865,1789,218,1571," 8.3"
"16663","Z63034",6775,237,39,198," 2.9"
"16664","Z63036",1326,901,875,26," 2.0"
"16665","Z63037",1412,219,87,132," 9.3"
"16666","Z63038",2538,29,0,29," 1.1"
"16667","Z63040",3162,252,13,239," 7.6"
"16668","Z63042",9176,429,0,429," 4.7"
"16669","Z63043",9456,323,52,271," 2.9"
"16670","Z63044",4614,340,0,340," 7.4"
"16671","Z63048",1309,88,13,75," 5.7"
"16672","Z63049",6624,482,33,449," 6.8"
"16673","Z63050",6281,447,290,157," 2.5"
"16674","Z63051",5618,472,74,398," 7.1"
"16675","Z63052",9640,774,0,774," 8.0"
"16676","Z63056",893,201,88,113,"12.7"
"16677","Z63060",960,60,60,0," 0.0"
"16678","Z63068",2200,325,44,281,"12.8"
"16679","Z63069",6198,534,42,492," 7.9"
"16680","Z63070",3332,247,12,235," 7.1"
"16681","Z63072",1239,137,23,114," 9.2"
"16682","Z63074",7767,810,0,810,"10.4"
"16683","Z63077",5531,980,230,750,"13.6"
"16684","Z63080",6212,792,223,569," 9.2"
"16685","Z63084",7376,452,82,370," 5.0"
"16686","Z63087",370,27,0,27," 7.3"
"16687","Z63088",4227,329,40,289," 6.8"
"16688","Z63089",2211,39,0,39," 1.8"
"16689","Z63090",9084,317,0,317," 3.5"
"16690","Z63091",547,60,24,36," 6.6"
"16691","Z63101",2268,438,49,389,"17.2"
"16692","Z63102",1205,131,13,118," 9.8"
"16693","Z63103",5784,1803,56,1747,"30.2"
"16694","Z63104",10977,1614,104,1510,"13.8"
"16695","Z63105",7503,1044,159,885,"11.8"
"16696","Z63106",6011,1369,0,1369,"22.8"
"16697","Z63107",7016,2870,26,2844,"40.5"
"16698","Z63108",12394,2064,121,1943,"15.7"
"16699","Z63109",14962,1457,37,1420," 9.5"
"16700","Z63110",9451,1569,77,1492,"15.8"
"16701","Z63111",10872,2374,10,2364,"21.7"
"16702","Z63112",11412,2925,48,2877,"25.2"
"16703","Z63113",7134,2456,0,2456,"34.4"
"16704","Z63114",16819,2076,165,1911,"11.4"
"16705","Z63115",11304,3470,34,3436,"30.4"
"16706","Z63116",21995,2641,39,2602,"11.8"
"16707","Z63117",4907,527,14,513,"10.5"
"16708","Z63118",15153,4117,85,4032,"26.6"
"16709","Z63119",14746,885,68,817," 5.5"
"16710","Z63120",5040,1734,22,1712,"34.0"
"16711","Z63121",13378,2611,68,2543,"19.0"
"16712","Z63122",17028,905,121,784," 4.6"
"16713","Z63123",23330,1045,42,1003," 4.3"
"16714","Z63124",4609,206,25,181," 3.9"
"16715","Z63125",14863,1286,3,1283," 8.6"
"16716","Z63126",6529,281,12,269," 4.1"
"16717","Z63127",1990,128,0,128," 6.4"
"16718","Z63128",13100,775,30,745," 5.7"
"16719","Z63129",22404,623,10,613," 2.7"
"16720","Z63131",6582,273,36,237," 3.6"
"16721","Z63132",6608,897,10,887,"13.4"
"16722","Z63133",4067,830,32,798,"19.6"
"16723","Z63134",6091,744,0,744,"12.2"
"16724","Z63135",10087,1252,9,1243,"12.3"
"16725","Z63136",22000,4452,52,4400,"20.0"
"16726","Z63137",8571,1055,23,1032,"12.0"
"16727","Z63138",9152,1463,87,1376,"15.0"
"16728","Z63139",12368,1164,18,1146," 9.3"
"16729","Z63140",228,108,0,108,"47.4"
"16730","Z63141",8507,415,41,374," 4.4"
"16731","Z63143",5824,614,0,614,"10.5"
"16732","Z63144",4616,485,33,452," 9.8"
"16733","Z63146",15011,1206,144,1062," 7.1"
"16734","Z63147",5011,1136,60,1076,"21.5"
"16735","Z63301",20511,1484,183,1301," 6.3"
"16736","Z63303",19697,765,197,568," 2.9"
"16737","Z63304",15404,717,168,549," 3.6"
"16738","Z63332",662,118,32,86,"13.0"
"16739","Z63333",359,78,45,33," 9.2"
"16740","Z63334",2845,219,16,203," 7.1"
"16741","Z63336",666,118,58,60," 9.0"
"16742","Z63341",1382,85,33,52," 3.8"
"16743","Z63343",2003,408,125,283,"14.1"
"16744","Z63347",1249,213,56,157,"12.6"
"16745","Z63348",2478,143,9,134," 5.4"
"16746","Z63349",771,107,0,107,"13.9"
"16747","Z63351",658,70,0,70,"10.6"
"16748","Z63352",531,79,0,79,"14.9"
"16749","Z63353",2198,395,22,373,"17.0"
"16750","Z63357",2388,447,184,263,"11.0"
"16751","Z63359",640,167,115,52," 8.1"
"16752","Z63361",2223,374,127,247,"11.1"
"16753","Z63362",2466,220,0,220," 8.9"
"16754","Z63363",1023,226,202,24," 2.3"
"16755","Z63366",18638,633,11,622," 3.3"
"16756","Z63367",8162,432,130,302," 3.7"
"16757","Z63368",16269,673,29,644," 4.0"
"16758","Z63369",918,135,28,107,"11.7"
"16759","Z63373",260,50,32,18," 6.9"
"16760","Z63376",28564,780,31,749," 2.6"
"16761","Z63377",1099,219,45,174,"15.8"
"16762","Z63379",9162,933,41,892," 9.7"
"16763","Z63382",1719,257,0,257,"15.0"
"16764","Z63383",6166,787,198,589," 9.6"
"16765","Z63384",948,222,21,201,"21.2"
"16766","Z63385",13959,842,47,795," 5.7"
"16767","Z63386",307,74,41,33,"10.7"
"16768","Z63389",2561,298,47,251," 9.8"
"16769","Z63390",5735,1593,1097,496," 8.6"
"16770","Z63401",9927,1324,61,1263,"12.7"
"16771","Z63430",229,23,11,12," 5.2"
"16772","Z63432",291,123,3,120,"41.2"
"16773","Z63434",317,51,32,19," 6.0"
"16774","Z63435",1875,305,83,222,"11.8"
"16775","Z63436",609,134,71,63,"10.3"
"16776","Z63437",783,158,26,132,"16.9"
"16777","Z63438",262,41,0,41,"15.6"
"16778","Z63440",550,82,31,51," 9.3"
"16779","Z63441",703,202,56,146,"20.8"
"16780","Z63445",1794,281,34,247,"13.8"
"16781","Z63447",590,138,17,121,"20.5"
"16782","Z63453",205,39,8,31,"15.1"
"16783","Z63454",310,12,0,12," 3.9"
"16784","Z63456",2385,591,307,284,"11.9"
"16785","Z63458",111,29,13,16,"14.4"
"16786","Z63459",1838,181,60,121," 6.6"
"16787","Z63460",162,22,2,20,"12.3"
"16788","Z63461",2604,352,68,284,"10.9"
"16789","Z63462",924,350,243,107,"11.6"
"16790","Z63465",231,40,17,23,"10.0"
"16791","Z63468",1275,335,148,187,"14.7"
"16792","Z63472",276,43,0,43,"15.6"
"16793","Z63474",262,74,8,66,"25.2"
"16794","Z63501",9443,1303,195,1108,"11.7"
"16795","Z63530",503,76,12,64,"12.7"
"16796","Z63532",750,161,44,117,"15.6"
"16797","Z63533",354,34,16,18," 5.1"
"16798","Z63534",452,132,40,92,"20.4"
"16799","Z63536",400,113,4,109,"27.3"
"16800","Z63537",995,247,83,164,"16.5"
"16801","Z63543",187,71,15,56,"29.9"
"16802","Z63545",628,144,24,120,"19.1"
"16803","Z63548",586,62,14,48," 8.2"
"16804","Z63549",1245,279,39,240,"19.3"
"16805","Z63552",3470,346,49,297," 8.6"
"16806","Z63555",1537,235,37,198,"12.9"
"16807","Z63556",1648,367,66,301,"18.3"
"16808","Z63561",572,118,37,81,"14.2"
"16809","Z63563",248,30,12,18," 7.3"
"16810","Z63565",2278,598,378,220," 9.7"
"16811","Z63601",7612,914,38,876,"11.5"
"16812","Z63623",384,109,75,34," 8.9"
"16813","Z63624",1994,334,108,226,"11.3"
"16814","Z63625",207,57,44,13," 6.3"
"16815","Z63626",560,26,0,26," 4.6"
"16816","Z63627",1245,132,46,86," 6.9"
"16817","Z63628",6142,1094,680,414," 6.7"
"16818","Z63629",635,93,29,64,"10.1"
"16819","Z63630",1647,342,71,271,"16.5"
"16820","Z63631",474,82,14,68,"14.3"
"16821","Z63637",679,46,46,0," 0.0"
"16822","Z63638",1547,415,247,168,"10.9"
"16823","Z63640",11621,1008,212,796," 6.8"
"16824","Z63645",5465,1095,576,519," 9.5"
"16825","Z63648",628,68,39,29," 4.6"
"16826","Z63650",2038,484,146,338,"16.6"
"16827","Z63653",597,92,10,82,"13.7"
"16828","Z63655",694,173,106,67," 9.7"
"16829","Z63660",1352,178,0,178,"13.2"
"16830","Z63662",609,123,87,36," 5.9"
"16831","Z63663",326,40,0,40,"12.3"
"16832","Z63664",3766,540,177,363," 9.6"
"16833","Z63670",5432,976,559,417," 7.7"
"16834","Z63701",15992,1455,254,1201," 7.5"
"16835","Z63703",4422,684,76,608,"13.7"
"16836","Z63730",1604,256,70,186,"11.6"
"16837","Z63732",387,55,26,29," 7.5"
"16838","Z63735",364,39,13,26," 7.1"
"16839","Z63736",1370,87,7,80," 5.8"
"16840","Z63740",2343,357,82,275,"11.7"
"16841","Z63747",219,22,0,22,"10.0"
"16842","Z63751",574,100,70,30," 5.2"
"16843","Z63755",9817,647,17,630," 6.4"
"16844","Z63760",288,47,13,34,"11.8"
"16845","Z63764",2656,511,177,334,"12.6"
"16846","Z63766",590,52,33,19," 3.2"
"16847","Z63771",1145,173,8,165,"14.4"
"16848","Z63775",7448,1087,319,768,"10.3"
"16849","Z63780",2756,173,42,131," 4.8"
"16850","Z63781",551,55,39,16," 2.9"
"16851","Z63785",419,74,7,67,"16.0"
"16852","Z63787",359,93,52,41,"11.4"
"16853","Z63801",10326,1048,59,989," 9.6"
"16854","Z63821",427,54,12,42," 9.8"
"16855","Z63822",1391,183,53,130," 9.3"
"16856","Z63825",1880,235,0,235,"12.5"
"16857","Z63827",402,79,2,77,"19.2"
"16858","Z63829",558,110,12,98,"17.6"
"16859","Z63830",3330,288,0,288," 8.6"
"16860","Z63834",2441,241,136,105," 4.3"
"16861","Z63841",6191,518,7,511," 8.3"
"16862","Z63845",2403,195,14,181," 7.5"
"16863","Z63846",692,107,0,107,"15.5"
"16864","Z63848",660,107,11,96,"14.5"
"16865","Z63851",1841,349,51,298,"16.2"
"16866","Z63852",612,118,6,112,"18.3"
"16867","Z63855",531,87,28,59,"11.1"
"16868","Z63857",5836,657,17,640,"11.0"
"16869","Z63862",796,128,3,125,"15.7"
"16870","Z63863",2804,221,8,213," 7.6"
"16871","Z63867",486,26,0,26," 5.3"
"16872","Z63868",357,55,5,50,"14.0"
"16873","Z63869",1724,368,47,321,"18.6"
"16874","Z63870",572,157,0,157,"27.4"
"16875","Z63873",2135,202,2,200," 9.4"
"16876","Z63876",1061,161,21,140,"13.2"
"16877","Z63877",1640,280,0,280,"17.1"
"16878","Z63901",15609,2157,183,1974,"12.6"
"16879","Z63932",670,77,7,70,"10.4"
"16880","Z63933",1696,171,0,171,"10.1"
"16881","Z63935",4605,858,359,499,"10.8"
"16882","Z63937",1357,290,19,271,"20.0"
"16883","Z63940",639,80,0,80,"12.5"
"16884","Z63941",194,61,17,44,"22.7"
"16885","Z63942",382,75,9,66,"17.3"
"16886","Z63944",1183,430,295,135,"11.4"
"16887","Z63945",472,32,0,32," 6.8"
"16888","Z63952",272,60,39,21," 7.7"
"16889","Z63953",918,128,46,82," 8.9"
"16890","Z63954",605,176,0,176,"29.1"
"16891","Z63956",562,112,45,67,"11.9"
"16892","Z63957",3404,1010,620,390,"11.5"
"16893","Z63960",1378,199,71,128," 9.3"
"16894","Z63961",792,111,12,99,"12.5"
"16895","Z63964",401,97,72,25," 6.2"
"16896","Z63965",1610,365,267,98," 6.1"
"16897","Z63966",2077,962,730,232,"11.2"
"16898","Z64001",299,36,0,36,"12.0"
"16899","Z64011",1598,38,0,38," 2.4"
"16900","Z64012",11137,1107,144,963," 8.6"
"16901","Z64014",9320,303,0,303," 3.3"
"16902","Z64015",12087,675,29,646," 5.3"
"16903","Z64016",1857,150,0,150," 8.1"
"16904","Z64017",193,21,0,21,"10.9"
"16905","Z64018",342,14,1,13," 3.8"
"16906","Z64019",1109,90,17,73," 6.6"
"16907","Z64020",1545,194,32,162,"10.5"
"16908","Z64021",239,31,0,31,"13.0"
"16909","Z64024",6923,670,30,640," 9.2"
"16910","Z64029",6394,268,0,268," 4.2"
"16911","Z64030",10893,1238,11,1227,"11.3"
"16912","Z64034",2889,122,18,104," 3.6"
"16913","Z64036",147,31,0,31,"21.1"
"16914","Z64037",2827,409,0,409,"14.5"
"16915","Z64040",2704,240,40,200," 7.4"
"16916","Z64048",1558,113,0,113," 7.3"
"16917","Z64050",10408,1395,18,1377,"13.2"
"16918","Z64052",10220,1122,24,1098,"10.7"
"16919","Z64053",2697,602,12,590,"21.9"
"16920","Z64054",1926,231,27,204,"10.6"
"16921","Z64055",15652,1105,16,1089," 7.0"
"16922","Z64056",6389,412,0,412," 6.4"
"16923","Z64057",6327,322,34,288," 4.6"
"16924","Z64058",2527,201,0,201," 8.0"
"16925","Z64060",5005,310,0,310," 6.2"
"16926","Z64061",1342,78,30,48," 3.6"
"16927","Z64062",2285,117,57,60," 2.6"
"16928","Z64063",8126,590,0,590," 7.3"
"16929","Z64064",6498,487,0,487," 7.5"
"16930","Z64067",2477,142,13,129," 5.2"
"16931","Z64068",14601,982,98,884," 6.1"
"16932","Z64070",1253,68,13,55," 4.4"
"16933","Z64074",317,13,0,13," 4.1"
"16934","Z64075",4423,295,19,276," 6.2"
"16935","Z64076",4059,447,10,437,"10.8"
"16936","Z64077",752,102,12,90,"12.0"
"16937","Z64078",3663,134,0,134," 3.7"
"16938","Z64079",5187,290,6,284," 5.5"
"16939","Z64080",5050,195,4,191," 3.8"
"16940","Z64081",9607,402,0,402," 4.2"
"16941","Z64082",5148,110,0,110," 2.1"
"16942","Z64083",8269,224,0,224," 2.7"
"16943","Z64084",687,108,53,55," 8.0"
"16944","Z64085",3881,697,168,529,"13.6"
"16945","Z64086",8939,802,370,432," 4.8"
"16946","Z64089",4782,246,26,220," 4.6"
"16947","Z64093",11384,993,123,870," 7.6"
"16948","Z64096",472,97,0,97,"20.6"
"16949","Z64097",642,90,0,90,"14.0"
"16950","Z64098",1305,129,32,97," 7.4"
"16951","Z64105",3288,481,52,429,"13.0"
"16952","Z64106",4066,562,72,490,"12.1"
"16953","Z64108",4546,699,23,676,"14.9"
"16954","Z64109",6270,1981,0,1981,"31.6"
"16955","Z64110",7976,1658,20,1638,"20.5"
"16956","Z64111",11430,1847,81,1766,"15.5"
"16957","Z64112",5712,841,136,705,"12.3"
"16958","Z64113",5081,241,24,217," 4.3"
"16959","Z64114",13124,934,16,918," 7.0"
"16960","Z64116",8166,1045,0,1045,"12.8"
"16961","Z64118",18195,1263,120,1143," 6.3"
"16962","Z64119",11554,977,88,889," 7.7"
"16963","Z64120",224,80,15,65,"29.0"
"16964","Z64123",4393,1122,0,1122,"25.5"
"16965","Z64124",5446,1635,0,1635,"30.0"
"16966","Z64125",908,294,0,294,"32.4"
"16967","Z64126",2880,673,17,656,"22.8"
"16968","Z64127",9285,2719,0,2719,"29.3"
"16969","Z64129",4299,606,22,584,"13.6"
"16970","Z64130",11506,3075,14,3061,"26.6"
"16971","Z64131",11334,1367,10,1357,"12.0"
"16972","Z64132",7018,1480,43,1437,"20.5"
"16973","Z64133",15516,1374,32,1342," 8.6"
"16974","Z64134",9623,1316,26,1290,"13.4"
"16975","Z64136",1042,54,0,54," 5.2"
"16976","Z64137",5037,473,23,450," 8.9"
"16977","Z64138",11153,1009,0,1009," 9.0"
"16978","Z64139",480,16,16,0," 0.0"
"16979","Z64145",2360,151,0,151," 6.4"
"16980","Z64146",679,98,0,98,"14.4"
"16981","Z64150",1451,166,0,166,"11.4"
"16982","Z64151",11416,546,7,539," 4.7"
"16983","Z64152",10798,425,44,381," 3.5"
"16984","Z64153",2587,274,72,202," 7.8"
"16985","Z64154",4497,266,9,257," 5.7"
"16986","Z64155",8536,322,9,313," 3.7"
"16987","Z64156",2610,273,0,273,"10.5"
"16988","Z64157",5922,132,31,101," 1.7"
"16989","Z64158",2162,72,0,72," 3.3"
"16990","Z64161",163,14,0,14," 8.6"
"16991","Z64401",648,50,0,50," 7.7"
"16992","Z64402",1215,145,0,145,"11.9"
"16993","Z64422",113,25,0,25,"22.1"
"16994","Z64423",384,24,0,24," 6.2"
"16995","Z64424",2114,313,60,253,"12.0"
"16996","Z64426",192,38,7,31,"16.1"
"16997","Z64428",440,102,13,89,"20.2"
"16998","Z64429",4456,558,110,448,"10.1"
"16999","Z64430",300,30,11,19," 6.3"
"17000","Z64431",200,26,0,26,"13.0"
"17001","Z64434",211,21,2,19," 9.0"
"17002","Z64436",298,30,6,24," 8.1"
"17003","Z64439",679,85,10,75,"11.0"
"17004","Z64440",272,19,1,18," 6.6"
"17005","Z64442",381,59,7,52,"13.6"
"17006","Z64446",560,92,4,88,"15.7"
"17007","Z64448",456,56,0,56,"12.3"
"17008","Z64451",268,44,0,44,"16.4"
"17009","Z64453",114,38,14,24,"21.1"
"17010","Z64454",1007,79,9,70," 7.0"
"17011","Z64455",209,43,5,38,"18.2"
"17012","Z64456",830,244,75,169,"20.4"
"17013","Z64459",253,35,13,22," 8.7"
"17014","Z64463",811,137,9,128,"15.8"
"17015","Z64465",2040,168,64,104," 5.1"
"17016","Z64466",271,50,8,42,"15.5"
"17017","Z64468",6153,405,0,405," 6.6"
"17018","Z64469",1068,156,0,156,"14.6"
"17019","Z64470",878,127,42,85," 9.7"
"17020","Z64471",240,68,0,68,"28.3"
"17021","Z64473",719,81,7,74,"10.3"
"17022","Z64475",191,53,1,52,"27.2"
"17023","Z64476",182,17,0,17," 9.3"
"17024","Z64477",1560,161,4,157,"10.1"
"17025","Z64479",411,30,0,30," 7.3"
"17026","Z64481",550,86,4,82,"14.9"
"17027","Z64482",1071,103,0,103," 9.6"
"17028","Z64483",262,22,0,22," 8.4"
"17029","Z64484",447,85,14,71,"15.9"
"17030","Z64485",3361,144,0,144," 4.3"
"17031","Z64486",302,61,15,46,"15.2"
"17032","Z64487",383,69,0,69,"18.0"
"17033","Z64489",870,89,10,79," 9.1"
"17034","Z64490",961,62,0,62," 6.5"
"17035","Z64491",1009,170,0,170,"16.8"
"17036","Z64492",754,14,2,12," 1.6"
"17037","Z64496",52,23,0,23,"44.2"
"17038","Z64498",250,80,17,63,"25.2"
"17039","Z64501",5980,1556,26,1530,"25.6"
"17040","Z64503",5771,781,13,768,"13.3"
"17041","Z64504",4658,703,12,691,"14.8"
"17042","Z64505",5690,691,29,662,"11.6"
"17043","Z64506",9720,524,5,519," 5.3"
"17044","Z64507",5824,820,44,776,"13.3"
"17045","Z64601",5220,712,102,610,"11.7"
"17046","Z64620",308,128,56,72,"23.4"
"17047","Z64623",334,122,69,53,"15.9"
"17048","Z64624",778,147,29,118,"15.2"
"17049","Z64628",3043,786,73,713,"23.4"
"17050","Z64631",515,161,28,133,"25.8"
"17051","Z64633",2588,546,136,410,"15.8"
"17052","Z64635",285,74,0,74,"26.0"
"17053","Z64637",348,117,16,101,"29.0"
"17054","Z64640",1705,463,237,226,"13.3"
"17055","Z64641",391,129,19,110,"28.1"
"17056","Z64642",531,105,16,89,"16.8"
"17057","Z64643",596,114,26,88,"14.8"
"17058","Z64644",1434,219,2,217,"15.1"
"17059","Z64648",830,141,4,137,"16.5"
"17060","Z64649",272,19,0,19," 7.0"
"17061","Z64650",303,54,6,48,"15.8"
"17062","Z64652",243,65,5,60,"24.7"
"17063","Z64653",328,54,10,44,"13.4"
"17064","Z64658",1552,327,68,259,"16.7"
"17065","Z64659",389,62,12,50,"12.9"
"17066","Z64660",240,57,28,29,"12.1"
"17067","Z64664",220,12,0,12," 5.5"
"17068","Z64668",737,121,49,72," 9.8"
"17069","Z64670",531,115,21,94,"17.7"
"17070","Z64671",1141,309,126,183,"16.0"
"17071","Z64673",1199,281,67,214,"17.8"
"17072","Z64682",157,24,6,18,"11.5"
"17073","Z64683",3998,711,190,521,"13.0"
"17074","Z64689",306,80,0,80,"26.1"
"17075","Z64701",6019,350,124,226," 3.8"
"17076","Z64720",1697,183,10,173,"10.2"
"17077","Z64722",184,36,0,36,"19.6"
"17078","Z64723",296,40,5,35,"11.8"
"17079","Z64724",1031,227,9,218,"21.1"
"17080","Z64726",230,74,0,74,"32.2"
"17081","Z64730",3337,485,48,437,"13.1"
"17082","Z64733",541,39,0,39," 7.2"
"17083","Z64735",6467,656,257,399," 6.2"
"17084","Z64738",513,62,39,23," 4.5"
"17085","Z64739",341,18,0,18," 5.3"
"17086","Z64740",1140,305,129,176,"15.4"
"17087","Z64742",1043,96,3,93," 8.9"
"17088","Z64744",4020,648,156,492,"12.2"
"17089","Z64746",683,106,38,68,"10.0"
"17090","Z64747",1661,171,0,171,"10.3"
"17091","Z64748",672,107,24,83,"12.4"
"17092","Z64752",339,61,10,51,"15.0"
"17093","Z64755",1042,76,30,46," 4.4"
"17094","Z64759",3716,363,28,335," 9.0"
"17095","Z64761",651,71,0,71,"10.9"
"17096","Z64762",779,91,0,91,"11.7"
"17097","Z64763",914,306,150,156,"17.1"
"17098","Z64769",253,39,1,38,"15.0"
"17099","Z64770",572,111,19,92,"16.1"
"17100","Z64772",6247,783,51,732,"11.7"
"17101","Z64776",2401,813,419,394,"16.4"
"17102","Z64778",264,33,9,24," 9.1"
"17103","Z64779",1191,190,20,170,"14.3"
"17104","Z64784",622,118,0,118,"19.0"
"17105","Z64788",700,65,0,65," 9.3"
"17106","Z64801",17309,2277,86,2191,"12.7"
"17107","Z64804",16095,1729,19,1710,"10.6"
"17108","Z64830",314,32,0,32,"10.2"
"17109","Z64831",2652,356,37,319,"12.0"
"17110","Z64834",3636,130,0,130," 3.6"
"17111","Z64835",764,99,0,99,"13.0"
"17112","Z64836",9504,951,22,929," 9.8"
"17113","Z64840",1377,111,0,111," 8.1"
"17114","Z64841",203,18,0,18," 8.9"
"17115","Z64843",1303,206,0,206,"15.8"
"17116","Z64844",1966,236,29,207,"10.5"
"17117","Z64850",9691,789,88,701," 7.2"
"17118","Z64854",1907,488,66,422,"22.1"
"17119","Z64855",972,63,0,63," 6.5"
"17120","Z64861",686,92,0,92,"13.4"
"17121","Z64862",1273,206,46,160,"12.6"
"17122","Z64863",649,134,24,110,"16.9"
"17123","Z64865",2327,129,5,124," 5.3"
"17124","Z64866",575,42,0,42," 7.3"
"17125","Z64870",6146,485,0,485," 7.9"
"17126","Z64873",559,101,29,72,"12.9"
"17127","Z64874",341,67,0,67,"19.6"
"17128","Z65001",182,17,4,13," 7.1"
"17129","Z65010",2550,34,0,34," 1.3"
"17130","Z65011",1284,589,395,194,"15.1"
"17131","Z65013",1763,386,144,242,"13.7"
"17132","Z65014",1196,336,194,142,"11.9"
"17133","Z65016",605,83,39,44," 7.3"
"17134","Z65017",720,279,65,214,"29.7"
"17135","Z65018",3251,233,8,225," 6.9"
"17136","Z65020",9534,4214,3395,819," 8.6"
"17137","Z65023",768,191,45,146,"19.0"
"17138","Z65024",642,146,93,53," 8.3"
"17139","Z65025",356,83,0,83,"23.3"
"17140","Z65026",5517,1065,439,626,"11.3"
"17141","Z65032",666,15,0,15," 2.3"
"17142","Z65034",200,14,0,14," 7.0"
"17143","Z65035",765,71,45,26," 3.4"
"17144","Z65037",5477,3482,3087,395," 7.2"
"17145","Z65040",617,119,48,71,"11.5"
"17146","Z65041",3228,853,405,448,"13.9"
"17147","Z65043",4334,348,0,348," 8.0"
"17148","Z65047",804,249,237,12," 1.5"
"17149","Z65049",8920,6345,5754,591," 6.6"
"17150","Z65050",264,22,0,22," 8.3"
"17151","Z65051",2249,404,87,317,"14.1"
"17152","Z65052",2080,710,441,269,"12.9"
"17153","Z65053",646,132,5,127,"19.7"
"17154","Z65054",380,91,33,58,"15.3"
"17155","Z65059",343,89,73,16," 4.7"
"17156","Z65063",1466,103,36,67," 4.6"
"17157","Z65064",204,26,0,26,"12.7"
"17158","Z65065",8711,6072,5176,896,"10.3"
"17159","Z65066",3525,775,377,398,"11.3"
"17160","Z65067",262,86,34,52,"19.8"
"17161","Z65068",383,83,22,61,"15.9"
"17162","Z65069",449,130,45,85,"18.9"
"17163","Z65072",2831,2192,2051,141," 5.0"
"17164","Z65074",1303,153,7,146,"11.2"
"17165","Z65076",280,14,4,10," 3.6"
"17166","Z65078",2790,1417,1131,286,"10.3"
"17167","Z65079",6359,4648,4440,208," 3.3"
"17168","Z65080",430,89,0,89,"20.7"
"17169","Z65081",1274,129,0,129,"10.1"
"17170","Z65084",3316,626,349,277," 8.4"
"17171","Z65085",577,126,108,18," 3.1"
"17172","Z65101",12264,1588,243,1345,"11.0"
"17173","Z65109",17255,1115,192,923," 5.3"
"17174","Z65201",16298,1556,358,1198," 7.4"
"17175","Z65202",20862,1620,245,1375," 6.6"
"17176","Z65203",24716,1526,264,1262," 5.1"
"17177","Z65230",368,46,7,39,"10.6"
"17178","Z65231",1455,185,111,74," 5.1"
"17179","Z65233",4863,580,147,433," 8.9"
"17180","Z65236",744,190,18,172,"23.1"
"17181","Z65237",422,83,6,77,"18.2"
"17182","Z65239",657,211,139,72,"11.0"
"17183","Z65240",3491,196,0,196," 5.6"
"17184","Z65243",879,115,14,101,"11.5"
"17185","Z65248",1894,432,39,393,"20.7"
"17186","Z65251",8438,1145,462,683," 8.1"
"17187","Z65254",846,145,29,116,"13.7"
"17188","Z65255",1530,68,0,68," 4.4"
"17189","Z65256",723,53,11,42," 5.8"
"17190","Z65257",869,254,16,238,"27.4"
"17191","Z65259",1176,259,56,203,"17.3"
"17192","Z65261",704,293,188,105,"14.9"
"17193","Z65262",364,30,19,11," 3.0"
"17194","Z65264",295,48,4,44,"14.9"
"17195","Z65265",7031,1054,32,1022,"14.5"
"17196","Z65270",7228,1331,188,1143,"15.8"
"17197","Z65274",876,83,0,83," 9.5"
"17198","Z65275",1448,389,179,210,"14.5"
"17199","Z65279",770,110,44,66," 8.6"
"17200","Z65281",1496,341,40,301,"20.1"
"17201","Z65283",427,197,144,53,"12.4"
"17202","Z65284",1004,86,6,80," 8.0"
"17203","Z65285",334,69,9,60,"18.0"
"17204","Z65301",15144,1754,158,1596,"10.5"
"17205","Z65305",797,20,0,20," 2.5"
"17206","Z65321",192,12,0,12," 6.2"
"17207","Z65323",434,79,0,79,"18.2"
"17208","Z65324",1851,1185,973,212,"11.5"
"17209","Z65325",1626,236,33,203,"12.5"
"17210","Z65326",2279,1490,1210,280,"12.3"
"17211","Z65327",98,4,0,4," 4.1"
"17212","Z65332",578,55,3,52," 9.0"
"17213","Z65334",347,9,0,9," 2.6"
"17214","Z65336",2530,207,0,207," 8.2"
"17215","Z65337",799,141,0,141,"17.6"
"17216","Z65338",1768,639,395,244,"13.8"
"17217","Z65340",6444,547,13,534," 8.3"
"17218","Z65348",630,61,0,61," 9.7"
"17219","Z65349",1255,289,27,262,"20.9"
"17220","Z65350",688,47,24,23," 3.3"
"17221","Z65351",1134,182,13,169,"14.9"
"17222","Z65355",8719,3938,3074,864," 9.9"
"17223","Z65360",2142,287,39,248,"11.6"
"17224","Z65401",13947,2079,371,1708,"12.2"
"17225","Z65438",1361,221,6,215,"15.8"
"17226","Z65441",2640,608,255,353,"13.4"
"17227","Z65444",452,93,14,79,"17.5"
"17228","Z65446",276,112,83,29,"10.5"
"17229","Z65452",1362,267,23,244,"17.9"
"17230","Z65453",4089,869,401,468,"11.4"
"17231","Z65459",3366,616,173,443,"13.2"
"17232","Z65462",770,165,77,88,"11.4"
"17233","Z65463",517,94,38,56,"10.8"
"17234","Z65466",941,270,158,112,"11.9"
"17235","Z65470",473,96,20,76,"16.1"
"17236","Z65473",2772,282,13,269," 9.7"
"17237","Z65483",2236,543,90,453,"20.3"
"17238","Z65486",1440,243,165,78," 5.4"
"17239","Z65501",86,5,0,5," 5.8"
"17240","Z65536",12992,1759,364,1395,"10.7"
"17241","Z65542",2614,541,106,435,"16.6"
"17242","Z65548",2484,295,62,233," 9.4"
"17243","Z65552",1015,307,13,294,"29.0"
"17244","Z65556",2351,265,43,222," 9.4"
"17245","Z65559",3975,564,204,360," 9.1"
"17246","Z65560",6816,1304,690,614," 9.0"
"17247","Z65565",2673,598,297,301,"11.3"
"17248","Z65566",368,88,17,71,"19.3"
"17249","Z65567",614,73,4,69,"11.2"
"17250","Z65570",282,36,10,26," 9.2"
"17251","Z65571",1056,243,13,230,"21.8"
"17252","Z65582",1065,296,125,171,"16.1"
"17253","Z65583",5017,893,7,886,"17.7"
"17254","Z65584",4774,769,0,769,"16.1"
"17255","Z65590",589,84,28,56," 9.5"
"17256","Z65604",1751,239,48,191,"10.9"
"17257","Z65605",5304,682,48,634,"12.0"
"17258","Z65606",1628,245,80,165,"10.1"
"17259","Z65608",4561,782,229,553,"12.1"
"17260","Z65609",381,66,22,44,"11.5"
"17261","Z65610",2337,161,0,161," 6.9"
"17262","Z65611",1433,637,298,339,"23.7"
"17263","Z65613",7464,722,28,694," 9.3"
"17264","Z65614",294,59,10,49,"16.7"
"17265","Z65616",16029,5891,4816,1075," 6.7"
"17266","Z65617",557,8,0,8," 1.4"
"17267","Z65619",3145,146,0,146," 4.6"
"17268","Z65622",3809,561,52,509,"13.4"
"17269","Z65624",1094,304,248,56," 5.1"
"17270","Z65625",3764,768,387,381,"10.1"
"17271","Z65626",840,156,25,131,"15.6"
"17272","Z65630",132,4,0,4," 3.0"
"17273","Z65631",1956,167,0,167," 8.5"
"17274","Z65632",1096,168,0,168,"15.3"
"17275","Z65633",1827,167,0,167," 9.1"
"17276","Z65634",416,85,38,47,"11.3"
"17277","Z65637",650,84,39,45," 6.9"
"17278","Z65641",957,498,379,119,"12.4"
"17279","Z65646",1015,171,26,145,"14.3"
"17280","Z65647",1042,198,52,146,"14.0"
"17281","Z65648",2679,307,0,307,"11.5"
"17282","Z65649",704,131,20,111,"15.8"
"17283","Z65652",1439,107,44,63," 4.4"
"17284","Z65653",2861,456,165,291,"10.2"
"17285","Z65655",1630,155,26,129," 7.9"
"17286","Z65656",2571,579,315,264,"10.3"
"17287","Z65658",1055,335,232,103," 9.8"
"17288","Z65661",1366,286,124,162,"11.9"
"17289","Z65662",653,149,0,149,"22.8"
"17290","Z65663",997,117,0,117,"11.7"
"17291","Z65664",51,9,0,9,"17.6"
"17292","Z65667",1597,286,76,210,"13.1"
"17293","Z65668",1297,467,232,235,"18.1"
"17294","Z65672",4854,1273,820,453," 9.3"
"17295","Z65674",1252,185,43,142,"11.3"
"17296","Z65679",1226,181,36,145,"11.8"
"17297","Z65681",1658,890,774,116," 7.0"
"17298","Z65682",1033,166,46,120,"11.6"
"17299","Z65685",332,73,31,42,"12.7"
"17300","Z65686",3390,1444,1221,223," 6.6"
"17301","Z65689",2228,467,101,366,"16.4"
"17302","Z65692",594,76,19,57," 9.6"
"17303","Z65702",233,35,21,14," 6.0"
"17304","Z65704",1714,315,55,260,"15.2"
"17305","Z65705",1797,165,15,150," 8.3"
"17306","Z65706",6159,690,101,589," 9.6"
"17307","Z65707",1089,221,52,169,"15.5"
"17308","Z65708",5188,671,73,598,"11.5"
"17309","Z65711",4634,605,101,504,"10.9"
"17310","Z65712",3671,404,33,371,"10.1"
"17311","Z65713",1138,211,88,123,"10.8"
"17312","Z65714",12383,930,37,893," 7.2"
"17313","Z65717",1111,174,45,129,"11.6"
"17314","Z65720",211,23,20,3," 1.4"
"17315","Z65721",12073,968,36,932," 7.7"
"17316","Z65722",563,66,0,66,"11.7"
"17317","Z65723",1471,150,0,150,"10.2"
"17318","Z65724",1485,760,494,266,"17.9"
"17319","Z65725",1235,135,0,135,"10.9"
"17320","Z65729",358,212,174,38,"10.6"
"17321","Z65733",716,320,278,42," 5.9"
"17322","Z65734",1306,184,0,184,"14.1"
"17323","Z65737",5593,2227,1705,522," 9.3"
"17324","Z65738",7359,521,38,483," 6.6"
"17325","Z65740",1779,423,164,259,"14.6"
"17326","Z65742",4952,423,97,326," 6.6"
"17327","Z65745",1188,190,11,179,"15.1"
"17328","Z65746",2759,290,53,237," 8.6"
"17329","Z65747",3362,1700,1358,342,"10.2"
"17330","Z65753",2184,201,0,201," 9.2"
"17331","Z65754",451,114,0,114,"25.3"
"17332","Z65757",2851,134,0,134," 4.7"
"17333","Z65759",649,117,22,95,"14.6"
"17334","Z65761",973,435,314,121,"12.4"
"17335","Z65767",1121,398,132,266,"23.7"
"17336","Z65769",1133,55,3,52," 4.6"
"17337","Z65770",1287,115,8,107," 8.3"
"17338","Z65771",635,99,59,40," 6.3"
"17339","Z65774",572,188,52,136,"23.8"
"17340","Z65775",11257,1008,211,797," 7.1"
"17341","Z65779",1513,601,405,196,"13.0"
"17342","Z65781",3305,221,45,176," 5.3"
"17343","Z65785",2646,472,240,232," 8.8"
"17344","Z65786",1047,192,66,126,"12.0"
"17345","Z65787",1471,851,808,43," 2.9"
"17346","Z65789",842,145,23,122,"14.5"
"17347","Z65791",2306,530,71,459,"19.9"
"17348","Z65793",2857,346,43,303,"10.6"
"17349","Z65802",19926,2139,47,2092,"10.5"
"17350","Z65803",19165,1945,11,1934,"10.1"
"17351","Z65804",19344,1425,56,1369," 7.1"
"17352","Z65806",5871,746,5,741,"12.6"
"17353","Z65807",25878,1969,5,1964," 7.6"
"17354","Z65809",4777,219,19,200," 4.2"
"17355","Z65810",9339,308,0,308," 3.3"
"17356","Z66002",5374,660,0,660,"12.3"
"17357","Z66006",2893,196,48,148," 5.1"
"17358","Z66007",2263,134,0,134," 5.9"
"17359","Z66008",100,16,5,11,"11.0"
"17360","Z66010",404,111,2,109,"27.0"
"17361","Z66012",4504,318,5,313," 6.9"
"17362","Z66013",746,13,0,13," 1.7"
"17363","Z66015",400,53,3,50,"12.5"
"17364","Z66018",2387,183,0,183," 7.7"
"17365","Z66020",574,47,4,43," 7.5"
"17366","Z66021",961,144,11,133,"13.8"
"17367","Z66023",695,131,9,122,"17.6"
"17368","Z66024",412,55,11,44,"10.7"
"17369","Z66025",3145,319,0,319,"10.1"
"17370","Z66027",1710,173,0,173,"10.1"
"17371","Z66030",8371,521,102,419," 5.0"
"17372","Z66032",2318,218,22,196," 8.5"
"17373","Z66033",315,24,9,15," 4.8"
"17374","Z66035",484,121,24,97,"20.0"
"17375","Z66039",359,83,24,59,"16.4"
"17376","Z66040",2031,501,276,225,"11.1"
"17377","Z66041",317,31,0,31," 9.8"
"17378","Z66043",3153,164,0,164," 5.2"
"17379","Z66044",11610,1167,131,1036," 8.9"
"17380","Z66046",8806,932,12,920,"10.4"
"17381","Z66047",8574,595,42,553," 6.4"
"17382","Z66048",14317,1441,144,1297," 9.1"
"17383","Z66049",11976,806,92,714," 6.0"
"17384","Z66052",1011,53,0,53," 5.2"
"17385","Z66053",3041,111,0,111," 3.7"
"17386","Z66054",1380,78,0,78," 5.7"
"17387","Z66056",1024,348,145,203,"19.8"
"17388","Z66060",469,74,2,72,"15.4"
"17389","Z66061",21842,1147,16,1131," 5.2"
"17390","Z66062",27682,840,47,793," 2.9"
"17391","Z66064",2577,281,0,281,"10.9"
"17392","Z66066",1142,155,0,155,"13.6"
"17393","Z66067",7021,825,29,796,"11.3"
"17394","Z66070",1111,102,24,78," 7.0"
"17395","Z66071",5027,240,0,240," 4.8"
"17396","Z66072",505,27,0,27," 5.3"
"17397","Z66073",1013,44,7,37," 3.7"
"17398","Z66075",1115,193,35,158,"14.2"
"17399","Z66078",419,16,0,16," 3.8"
"17400","Z66080",386,36,16,20," 5.2"
"17401","Z66083",3360,133,0,133," 4.0"
"17402","Z66085",2998,232,0,232," 7.7"
"17403","Z66086",3948,205,0,205," 5.2"
"17404","Z66087",949,89,32,57," 6.0"
"17405","Z66088",1048,72,0,72," 6.9"
"17406","Z66090",1188,121,0,121,"10.2"
"17407","Z66091",109,47,25,22,"20.2"
"17408","Z66092",1605,139,0,139," 8.7"
"17409","Z66101",5923,1292,37,1255,"21.2"
"17410","Z66102",11619,1613,55,1558,"13.4"
"17411","Z66103",6998,940,0,940,"13.4"
"17412","Z66104",11457,2157,35,2122,"18.5"
"17413","Z66105",993,200,17,183,"18.4"
"17414","Z66106",9167,661,0,661," 7.2"
"17415","Z66109",8381,381,32,349," 4.2"
"17416","Z66111",3917,323,58,265," 6.8"
"17417","Z66112",5576,361,0,361," 6.5"
"17418","Z66202",8590,742,80,662," 7.7"
"17419","Z66203",8830,514,19,495," 5.6"
"17420","Z66204",9759,717,63,654," 6.7"
"17421","Z66205",6659,377,35,342," 5.1"
"17422","Z66206",4142,185,47,138," 3.3"
"17423","Z66207",6087,301,64,237," 3.9"
"17424","Z66208",9753,477,15,462," 4.7"
"17425","Z66209",8546,152,39,113," 1.3"
"17426","Z66210",8888,432,11,421," 4.7"
"17427","Z66211",2281,132,0,132," 5.8"
"17428","Z66212",15457,783,35,748," 4.8"
"17429","Z66213",11593,348,98,250," 2.2"
"17430","Z66214",5562,224,44,180," 3.2"
"17431","Z66215",11143,582,0,582," 5.2"
"17432","Z66216",9603,511,25,486," 5.1"
"17433","Z66217",2384,149,57,92," 3.9"
"17434","Z66218",2566,21,0,21," 0.8"
"17435","Z66219",4910,196,30,166," 3.4"
"17436","Z66220",2721,43,0,43," 1.6"
"17437","Z66221",5795,305,32,273," 4.7"
"17438","Z66223",9119,674,121,553," 6.1"
"17439","Z66224",4194,146,82,64," 1.5"
"17440","Z66226",4240,108,20,88," 2.1"
"17441","Z66227",1820,12,0,12," 0.7"
"17442","Z66401",1078,349,255,94," 8.7"
"17443","Z66402",1248,52,0,52," 4.2"
"17444","Z66403",308,13,0,13," 4.2"
"17445","Z66406",237,16,0,16," 6.8"
"17446","Z66408",231,31,10,21," 9.1"
"17447","Z66409",1267,65,0,65," 5.1"
"17448","Z66411",568,86,40,46," 8.1"
"17449","Z66413",933,193,18,175,"18.8"
"17450","Z66414",1246,154,13,141,"11.3"
"17451","Z66415",382,43,13,30," 7.9"
"17452","Z66417",128,18,0,18,"14.1"
"17453","Z66423",395,59,2,57,"14.4"
"17454","Z66425",198,17,0,17," 8.6"
"17455","Z66427",655,108,37,71,"10.8"
"17456","Z66428",223,22,0,22," 9.9"
"17457","Z66431",248,5,0,5," 2.0"
"17458","Z66432",190,41,0,41,"21.6"
"17459","Z66434",2398,315,21,294,"12.3"
"17460","Z66436",2498,180,0,180," 7.2"
"17461","Z66439",1379,233,25,208,"15.1"
"17462","Z66440",739,52,0,52," 7.0"
"17463","Z66441",12541,2011,187,1824,"14.5"
"17464","Z66442",3559,361,68,293," 8.2"
"17465","Z66449",342,78,14,64,"18.7"
"17466","Z66451",800,125,35,90,"11.2"
"17467","Z66502",20021,1775,316,1459," 7.3"
"17468","Z66503",6517,664,174,490," 7.5"
"17469","Z66507",463,40,11,29," 6.3"
"17470","Z66508",2123,201,15,186," 8.8"
"17471","Z66510",358,55,22,33," 9.2"
"17472","Z66512",1405,127,0,127," 9.0"
"17473","Z66517",1037,225,31,194,"18.7"
"17474","Z66520",293,75,28,47,"16.0"
"17475","Z66523",1760,161,16,145," 8.2"
"17476","Z66524",1129,115,8,107," 9.5"
"17477","Z66526",316,45,26,19," 6.0"
"17478","Z66528",449,59,0,59,"13.1"
"17479","Z66531",604,74,2,72,"11.9"
"17480","Z66533",654,57,0,57," 8.7"
"17481","Z66534",1679,141,17,124," 7.4"
"17482","Z66535",1160,68,0,68," 5.9"
"17483","Z66536",1245,60,24,36," 2.9"
"17484","Z66537",523,36,0,36," 6.9"
"17485","Z66538",1456,21,16,5," 0.3"
"17486","Z66539",1107,33,11,22," 2.0"
"17487","Z66540",243,40,0,40,"16.5"
"17488","Z66541",121,15,0,15,"12.4"
"17489","Z66546",502,21,0,21," 4.2"
"17490","Z66547",3156,133,1,132," 4.2"
"17491","Z66548",478,96,31,65,"13.6"
"17492","Z66549",767,101,53,48," 6.3"
"17493","Z66552",248,14,2,12," 4.8"
"17494","Z66554",292,33,29,4," 1.4"
"17495","Z66603",1139,402,0,402,"35.3"
"17496","Z66604",11173,1332,7,1325,"11.9"
"17497","Z66605",7975,762,18,744," 9.3"
"17498","Z66606",5787,581,27,554," 9.6"
"17499","Z66607",3981,975,19,956,"24.0"
"17500","Z66608",2714,546,0,546,"20.1"
"17501","Z66609",3361,193,0,193," 5.7"
"17502","Z66610",3480,33,0,33," 0.9"
"17503","Z66611",4956,487,6,481," 9.7"
"17504","Z66612",1739,417,0,417,"24.0"
"17505","Z66614",14876,1233,87,1146," 7.7"
"17506","Z66615",1499,141,0,141," 9.4"
"17507","Z66616",2571,137,0,137," 5.3"
"17508","Z66617",3638,239,4,235," 6.5"
"17509","Z66618",3567,156,0,156," 4.4"
"17510","Z66619",1024,151,0,151,"14.7"
"17511","Z66701",5815,1071,373,698,"12.0"
"17512","Z66711",388,133,25,108,"27.8"
"17513","Z66712",898,145,9,136,"15.1"
"17514","Z66713",2514,496,57,439,"17.5"
"17515","Z66720",5465,824,230,594,"10.9"
"17516","Z66724",499,59,9,50,"10.0"
"17517","Z66725",2877,419,0,419,"14.6"
"17518","Z66733",990,186,21,165,"16.7"
"17519","Z66734",138,8,8,0," 0.0"
"17520","Z66736",1940,396,150,246,"12.7"
"17521","Z66739",2426,535,84,451,"18.6"
"17522","Z66740",177,24,0,24,"13.6"
"17523","Z66743",1891,372,41,331,"17.5"
"17524","Z66748",1220,213,47,166,"13.6"
"17525","Z66749",3661,481,175,306," 8.4"
"17526","Z66751",475,81,22,59,"12.4"
"17527","Z66755",602,155,83,72,"12.0"
"17528","Z66756",443,87,0,87,"19.6"
"17529","Z66757",1625,275,51,224,"13.8"
"17530","Z66758",99,21,0,21,"21.2"
"17531","Z66762",11297,1711,152,1559,"13.8"
"17532","Z66763",1389,104,0,104," 7.5"
"17533","Z66767",205,25,0,25,"12.2"
"17534","Z66770",522,59,0,59,"11.3"
"17535","Z66771",425,63,14,49,"11.5"
"17536","Z66773",395,80,0,80,"20.3"
"17537","Z66776",533,90,7,83,"15.6"
"17538","Z66780",323,104,51,53,"16.4"
"17539","Z66781",659,207,0,207,"31.4"
"17540","Z66783",1259,223,62,161,"12.8"
"17541","Z66801",12858,1669,45,1624,"12.6"
"17542","Z66834",344,27,0,27," 7.8"
"17543","Z66835",565,69,2,67,"11.9"
"17544","Z66840",373,50,0,50,"13.4"
"17545","Z66842",214,85,52,33,"15.4"
"17546","Z66845",534,73,16,57,"10.7"
"17547","Z66846",2107,665,493,172," 8.2"
"17548","Z66851",331,58,0,58,"17.5"
"17549","Z66852",274,25,4,21," 7.7"
"17550","Z66853",242,79,35,44,"18.2"
"17551","Z66854",418,53,31,22," 5.3"
"17552","Z66856",716,60,22,38," 5.3"
"17553","Z66859",91,2,0,2," 2.2"
"17554","Z66860",823,189,39,150,"18.2"
"17555","Z66861",1673,416,241,175,"10.5"
"17556","Z66864",200,40,0,40,"20.0"
"17557","Z66865",527,22,10,12," 2.3"
"17558","Z66866",794,135,9,126,"15.9"
"17559","Z66868",362,38,0,38,"10.5"
"17560","Z66870",108,57,21,36,"33.3"
"17561","Z66871",618,54,5,49," 7.9"
"17562","Z66873",168,49,1,48,"28.6"
"17563","Z66901",3008,329,9,320,"10.6"
"17564","Z66935",1328,208,38,170,"12.8"
"17565","Z66938",549,86,3,83,"15.1"
"17566","Z66940",253,99,15,84,"33.2"
"17567","Z66943",249,22,0,22," 8.8"
"17568","Z66945",470,78,14,64,"13.6"
"17569","Z66948",293,67,13,54,"18.4"
"17570","Z66949",424,72,11,61,"14.4"
"17571","Z66951",445,108,24,84,"18.9"
"17572","Z66952",321,118,23,95,"29.6"
"17573","Z66953",310,40,18,22," 7.1"
"17574","Z66956",618,98,8,90,"14.6"
"17575","Z66959",168,35,5,30,"17.9"
"17576","Z66962",158,36,4,32,"20.3"
"17577","Z66964",155,66,2,64,"41.3"
"17578","Z66966",357,67,0,67,"18.8"
"17579","Z66967",1133,248,53,195,"17.2"
"17580","Z66968",827,69,14,55," 6.7"
"17581","Z67001",456,17,0,17," 3.7"
"17582","Z67002",5427,278,0,278," 5.1"
"17583","Z67003",1440,275,23,252,"17.5"
"17584","Z67004",397,91,11,80,"20.2"
"17585","Z67005",7396,1098,60,1038,"14.0"
"17586","Z67008",257,47,16,31,"12.1"
"17587","Z67009",432,77,27,50,"11.6"
"17588","Z67010",5593,306,22,284," 5.1"
"17589","Z67013",1196,148,2,146,"12.2"
"17590","Z67016",199,20,4,16," 8.0"
"17591","Z67017",909,69,0,69," 7.6"
"17592","Z67019",507,98,0,98,"19.3"
"17593","Z67024",492,160,12,148,"30.1"
"17594","Z67025",1492,139,29,110," 7.4"
"17595","Z67026",1871,114,20,94," 5.0"
"17596","Z67029",525,91,9,82,"15.6"
"17597","Z67030",923,20,0,20," 2.2"
"17598","Z67031",1014,92,0,92," 9.1"
"17599","Z67035",466,50,13,37," 7.9"
"17600","Z67037",11272,748,0,748," 6.6"
"17601","Z67038",294,51,14,37,"12.6"
"17602","Z67039",1448,171,0,171,"11.8"
"17603","Z67041",106,1,0,1," 0.9"
"17604","Z67042",7027,681,23,658," 9.4"
"17605","Z67045",1941,460,117,343,"17.7"
"17606","Z67050",648,42,29,13," 2.0"
"17607","Z67052",2844,164,26,138," 4.9"
"17608","Z67053",270,28,7,21," 7.8"
"17609","Z67054",622,57,6,51," 8.2"
"17610","Z67056",1189,115,4,111," 9.3"
"17611","Z67058",1021,242,28,214,"21.0"
"17612","Z67059",450,67,10,57,"12.7"
"17613","Z67060",5616,464,0,464," 8.3"
"17614","Z67063",1589,284,45,239,"15.0"
"17615","Z67067",650,19,0,19," 2.9"
"17616","Z67068",2150,476,58,418,"19.4"
"17617","Z67070",661,207,32,175,"26.5"
"17618","Z67074",767,47,0,47," 6.1"
"17619","Z67101",1165,27,0,27," 2.3"
"17620","Z67104",1453,407,169,238,"16.4"
"17621","Z67107",1227,97,0,97," 7.9"
"17622","Z67108",659,74,1,73,"11.1"
"17623","Z67109",210,40,9,31,"14.8"
"17624","Z67110",3380,314,0,314," 9.3"
"17625","Z67114",9438,700,4,696," 7.4"
"17626","Z67117",694,45,0,45," 6.5"
"17627","Z67119",716,124,0,124,"17.3"
"17628","Z67120",603,37,22,15," 2.5"
"17629","Z67123",329,44,1,43,"13.1"
"17630","Z67124",3780,425,29,396,"10.5"
"17631","Z67127",385,89,7,82,"21.3"
"17632","Z67133",2517,193,19,174," 6.9"
"17633","Z67135",1354,139,0,139,"10.3"
"17634","Z67137",474,186,87,99,"20.9"
"17635","Z67138",162,47,10,37,"22.8"
"17636","Z67140",382,73,1,72,"18.8"
"17637","Z67144",1092,90,0,90," 8.2"
"17638","Z67146",839,64,0,64," 7.6"
"17639","Z67147",3981,448,97,351," 8.8"
"17640","Z67149",377,35,0,35," 9.3"
"17641","Z67152",4304,617,45,572,"13.3"
"17642","Z67156",6367,860,39,821,"12.9"
"17643","Z67159",108,41,11,30,"27.8"
"17644","Z67202",1166,254,31,223,"19.1"
"17645","Z67203",14837,1814,0,1814,"12.2"
"17646","Z67204",8716,906,28,878,"10.1"
"17647","Z67205",5819,361,0,361," 6.2"
"17648","Z67206",7566,597,0,597," 7.9"
"17649","Z67207",12439,1170,0,1170," 9.4"
"17650","Z67208",8169,859,0,859,"10.5"
"17651","Z67209",5448,288,11,277," 5.1"
"17652","Z67211",10082,1859,6,1853,"18.4"
"17653","Z67212",18850,708,19,689," 3.7"
"17654","Z67213",9719,1191,20,1171,"12.0"
"17655","Z67214",8052,1904,20,1884,"23.4"
"17656","Z67215",2044,34,0,34," 1.7"
"17657","Z67216",10204,1093,0,1093,"10.7"
"17658","Z67217",12160,1120,13,1107," 9.1"
"17659","Z67218",11539,1896,29,1867,"16.2"
"17660","Z67219",4965,642,0,642,"12.9"
"17661","Z67220",6304,472,0,472," 7.5"
"17662","Z67223",199,10,0,10," 5.0"
"17663","Z67226",8214,405,9,396," 4.8"
"17664","Z67230",3579,189,21,168," 4.7"
"17665","Z67235",4097,91,0,91," 2.2"
"17666","Z67301",6197,1200,84,1116,"18.0"
"17667","Z67330",728,83,8,75,"10.3"
"17668","Z67335",1627,280,12,268,"16.5"
"17669","Z67336",864,202,20,182,"21.1"
"17670","Z67337",6273,1156,44,1112,"17.7"
"17671","Z67344",451,120,34,86,"19.1"
"17672","Z67346",251,95,36,59,"23.5"
"17673","Z67349",639,137,41,96,"15.0"
"17674","Z67351",239,18,3,15," 6.3"
"17675","Z67352",356,113,44,69,"19.4"
"17676","Z67354",367,86,0,86,"23.4"
"17677","Z67356",1310,227,12,215,"16.4"
"17678","Z67357",6140,1023,75,948,"15.4"
"17679","Z67361",1097,248,29,219,"20.0"
"17680","Z67401",22303,1588,100,1488," 6.7"
"17681","Z67410",4658,529,51,478,"10.3"
"17682","Z67420",2271,368,21,347,"15.3"
"17683","Z67422",528,39,18,21," 4.0"
"17684","Z67425",382,85,38,47,"12.3"
"17685","Z67427",253,44,22,22," 8.7"
"17686","Z67428",656,51,11,40," 6.1"
"17687","Z67431",1043,63,12,51," 4.9"
"17688","Z67432",2956,524,0,524,"17.7"
"17689","Z67437",651,86,17,69,"10.6"
"17690","Z67438",151,19,8,11," 7.3"
"17691","Z67439",1439,100,0,100," 6.9"
"17692","Z67441",483,56,31,25," 5.2"
"17693","Z67443",745,87,6,81,"10.9"
"17694","Z67445",359,96,21,75,"20.9"
"17695","Z67446",359,68,37,31," 8.6"
"17696","Z67449",1667,428,60,368,"22.1"
"17697","Z67450",307,68,0,68,"22.1"
"17698","Z67451",457,83,4,79,"17.3"
"17699","Z67454",284,51,0,51,"18.0"
"17700","Z67455",1084,282,56,226,"20.8"
"17701","Z67456",1930,169,0,169," 8.8"
"17702","Z67457",399,59,14,45,"11.3"
"17703","Z67460",6766,430,30,400," 5.9"
"17704","Z67464",686,248,161,87,"12.7"
"17705","Z67466",449,86,7,79,"17.6"
"17706","Z67467",1199,83,0,83," 6.9"
"17707","Z67468",86,15,5,10,"11.6"
"17708","Z67470",258,51,0,51,"19.8"
"17709","Z67473",1000,190,25,165,"16.5"
"17710","Z67474",142,34,6,28,"19.7"
"17711","Z67480",870,128,33,95,"10.9"
"17712","Z67484",408,58,4,54,"13.2"
"17713","Z67485",184,41,9,32,"17.4"
"17714","Z67487",608,75,5,70,"11.5"
"17715","Z67490",544,83,15,68,"12.5"
"17716","Z67491",203,6,0,6," 3.0"
"17717","Z67492",105,4,3,1," 1.0"
"17718","Z67501",11500,1886,92,1794,"15.6"
"17719","Z67502",10681,464,0,464," 4.3"
"17720","Z67505",1191,84,0,84," 7.1"
"17721","Z67511",198,20,2,18," 9.1"
"17722","Z67512",97,14,0,14,"14.4"
"17723","Z67514",359,30,0,30," 8.4"
"17724","Z67516",242,55,14,41,"16.9"
"17725","Z67520",192,45,14,31,"16.1"
"17726","Z67522",837,49,3,46," 5.5"
"17727","Z67524",317,45,2,43,"13.6"
"17728","Z67525",555,126,11,115,"20.7"
"17729","Z67526",1309,61,0,61," 4.7"
"17730","Z67529",213,59,0,59,"27.7"
"17731","Z67530",8826,863,41,822," 9.3"
"17732","Z67544",1468,185,29,156,"10.6"
"17733","Z67546",1199,158,11,147,"12.3"
"17734","Z67547",963,215,26,189,"19.6"
"17735","Z67548",759,79,4,75," 9.9"
"17736","Z67550",2596,446,102,344,"13.3"
"17737","Z67552",330,58,5,53,"16.1"
"17738","Z67554",1894,274,32,242,"12.8"
"17739","Z67556",197,51,2,49,"24.9"
"17740","Z67560",921,139,29,110,"11.9"
"17741","Z67561",671,120,0,120,"17.9"
"17742","Z67563",195,50,14,36,"18.5"
"17743","Z67564",129,15,0,15,"11.6"
"17744","Z67565",281,71,10,61,"21.7"
"17745","Z67567",262,58,26,32,"12.2"
"17746","Z67570",599,36,3,33," 5.5"
"17747","Z67572",265,60,24,36,"13.6"
"17748","Z67574",134,28,6,22,"16.4"
"17749","Z67575",238,41,3,38,"16.0"
"17750","Z67576",967,190,14,176,"18.2"
"17751","Z67578",826,224,15,209,"25.3"
"17752","Z67579",1292,188,25,163,"12.6"
"17753","Z67581",244,123,10,113,"46.3"
"17754","Z67584",179,35,4,31,"17.3"
"17755","Z67601",10760,948,296,652," 6.1"
"17756","Z67621",221,53,19,34,"15.4"
"17757","Z67631",123,18,5,13,"10.6"
"17758","Z67632",128,27,20,7," 5.5"
"17759","Z67637",1282,109,62,47," 3.7"
"17760","Z67638",165,48,2,46,"27.9"
"17761","Z67640",275,30,0,30,"10.9"
"17762","Z67642",884,110,20,90,"10.2"
"17763","Z67643",147,34,6,28,"19.0"
"17764","Z67645",374,87,38,49,"13.1"
"17765","Z67646",398,90,19,71,"17.8"
"17766","Z67648",325,64,12,52,"16.0"
"17767","Z67649",215,71,31,40,"18.6"
"17768","Z67651",315,83,21,62,"19.7"
"17769","Z67654",1639,243,0,243,"14.8"
"17770","Z67661",1742,370,35,335,"19.2"
"17771","Z67663",1350,209,71,138,"10.2"
"17772","Z67664",174,13,0,13," 7.5"
"17773","Z67665",2606,325,114,211," 8.1"
"17774","Z67669",933,200,58,142,"15.2"
"17775","Z67671",811,84,15,69," 8.5"
"17776","Z67672",1286,207,6,201,"15.6"
"17777","Z67701",2960,283,82,201," 6.8"
"17778","Z67730",891,124,44,80," 9.0"
"17779","Z67735",2926,321,25,296,"10.1"
"17780","Z67737",266,33,2,31,"11.7"
"17781","Z67739",178,67,32,35,"19.7"
"17782","Z67740",837,80,11,69," 8.2"
"17783","Z67741",129,23,5,18,"14.0"
"17784","Z67744",118,23,17,6," 5.1"
"17785","Z67745",172,18,5,13," 7.6"
"17786","Z67747",100,1,0,1," 1.0"
"17787","Z67748",1164,146,8,138,"11.9"
"17788","Z67749",1381,234,57,177,"12.8"
"17789","Z67752",620,66,0,66,"10.6"
"17790","Z67756",1139,176,28,148,"13.0"
"17791","Z67758",565,159,39,120,"21.2"
"17792","Z67761",105,18,0,18,"17.1"
"17793","Z67762",164,17,9,8," 4.9"
"17794","Z67801",10491,691,68,623," 5.9"
"17795","Z67831",567,105,0,105,"18.5"
"17796","Z67834",438,59,9,50,"11.4"
"17797","Z67835",1070,85,7,78," 7.3"
"17798","Z67837",386,66,19,47,"12.2"
"17799","Z67838",386,27,0,27," 7.0"
"17800","Z67839",764,125,24,101,"13.2"
"17801","Z67842",214,30,0,30,"14.0"
"17802","Z67844",363,55,0,55,"15.2"
"17803","Z67846",12198,615,70,545," 4.5"
"17804","Z67849",194,33,3,30,"15.5"
"17805","Z67850",199,22,8,14," 7.0"
"17806","Z67851",906,75,0,75," 8.3"
"17807","Z67853",370,30,7,23," 6.2"
"17808","Z67854",776,181,42,139,"17.9"
"17809","Z67855",848,147,26,121,"14.3"
"17810","Z67860",1129,138,0,138,"12.2"
"17811","Z67861",720,65,24,41," 5.7"
"17812","Z67864",1026,142,7,135,"13.2"
"17813","Z67865",546,109,0,109,"20.0"
"17814","Z67867",637,44,10,34," 5.3"
"17815","Z67869",591,50,0,50," 8.5"
"17816","Z67871",2406,184,62,122," 5.1"
"17817","Z67876",484,35,0,35," 7.2"
"17818","Z67877",972,149,5,144,"14.8"
"17819","Z67878",1026,140,0,140,"13.6"
"17820","Z67879",588,101,27,74,"12.6"
"17821","Z67880",2963,227,11,216," 7.3"
"17822","Z67901",7758,577,27,550," 7.1"
"17823","Z67950",1099,173,2,171,"15.6"
"17824","Z67951",1999,233,42,191," 9.6"
"17825","Z67952",267,41,0,41,"15.4"
"17826","Z67953",90,32,0,32,"35.6"
"17827","Z67954",311,74,0,74,"23.8"
"17828","Z68001",72,9,0,9,"12.5"
"17829","Z68002",873,72,48,24," 2.7"
"17830","Z68003",2155,393,294,99," 4.6"
"17831","Z68004",444,93,0,93,"20.9"
"17832","Z68005",10242,670,41,629," 6.1"
"17833","Z68007",3168,132,49,83," 2.6"
"17834","Z68008",5123,187,0,187," 3.7"
"17835","Z68014",145,15,5,10," 6.9"
"17836","Z68015",491,47,9,38," 7.7"
"17837","Z68016",347,154,140,14," 4.0"
"17838","Z68017",678,73,12,61," 9.0"
"17839","Z68018",240,6,0,6," 2.5"
"17840","Z68020",474,138,80,58,"12.2"
"17841","Z68022",7203,202,65,137," 1.9"
"17842","Z68023",975,12,0,12," 1.2"
"17843","Z68025",13665,1297,704,593," 4.3"
"17844","Z68028",4081,158,33,125," 3.1"
"17845","Z68029",442,60,0,60,"13.6"
"17846","Z68030",375,29,9,20," 5.3"
"17847","Z68031",873,90,0,90,"10.3"
"17848","Z68033",160,5,0,5," 3.1"
"17849","Z68034",355,4,0,4," 1.1"
"17850","Z68037",869,141,25,116,"13.3"
"17851","Z68038",676,97,4,93,"13.8"
"17852","Z68041",427,27,0,27," 6.3"
"17853","Z68045",838,109,0,109,"13.0"
"17854","Z68046",9893,301,33,268," 2.7"
"17855","Z68047",746,63,2,61," 8.2"
"17856","Z68048",5414,545,115,430," 7.9"
"17857","Z68050",378,91,36,55,"14.6"
"17858","Z68057",798,77,9,68," 8.5"
"17859","Z68059",1178,39,13,26," 2.2"
"17860","Z68061",1115,183,64,119,"10.7"
"17861","Z68063",159,41,0,41,"25.8"
"17862","Z68064",1672,157,110,47," 2.8"
"17863","Z68065",637,71,34,37," 5.8"
"17864","Z68066",2282,130,26,104," 4.6"
"17865","Z68069",1402,219,145,74," 5.3"
"17866","Z68070",287,31,4,27," 9.4"
"17867","Z68071",605,94,5,89,"14.7"
"17868","Z68073",734,46,30,16," 2.2"
"17869","Z68102",3743,812,75,737,"19.7"
"17870","Z68104",15203,1516,0,1516,"10.0"
"17871","Z68105",11088,1584,15,1569,"14.2"
"17872","Z68106",9932,438,0,438," 4.4"
"17873","Z68107",10276,922,18,904," 8.8"
"17874","Z68108",5764,693,14,679,"11.8"
"17875","Z68110",3371,480,0,480,"14.2"
"17876","Z68111",9491,1453,0,1453,"15.3"
"17877","Z68112",4703,465,14,451," 9.6"
"17878","Z68113",234,41,0,41,"17.5"
"17879","Z68114",8701,581,44,537," 6.2"
"17880","Z68116",10878,522,61,461," 4.2"
"17881","Z68117",3219,87,0,87," 2.7"
"17882","Z68118",3439,130,0,130," 3.8"
"17883","Z68122",4346,274,32,242," 5.6"
"17884","Z68123",11918,774,126,648," 5.4"
"17885","Z68124",6907,394,30,364," 5.3"
"17886","Z68127",10196,492,17,475," 4.7"
"17887","Z68128",7627,151,0,151," 2.0"
"17888","Z68130",7649,429,63,366," 4.8"
"17889","Z68131",6587,1077,15,1062,"16.1"
"17890","Z68132",6745,471,27,444," 6.6"
"17891","Z68133",3384,19,0,19," 0.6"
"17892","Z68134",13178,858,0,858," 6.5"
"17893","Z68135",9214,246,15,231," 2.5"
"17894","Z68136",5311,187,0,187," 3.5"
"17895","Z68137",10559,396,15,381," 3.6"
"17896","Z68138",4812,206,64,142," 3.0"
"17897","Z68144",10423,220,50,170," 1.6"
"17898","Z68147",4098,317,0,317," 7.7"
"17899","Z68152",2574,119,21,98," 3.8"
"17900","Z68154",10382,396,12,384," 3.7"
"17901","Z68157",2229,32,0,32," 1.4"
"17902","Z68164",12015,575,50,525," 4.4"
"17903","Z68301",563,52,10,42," 7.5"
"17904","Z68305",2116,384,68,316,"14.9"
"17905","Z68307",231,93,0,93,"40.3"
"17906","Z68310",6920,811,117,694,"10.0"
"17907","Z68314",276,24,0,24," 8.7"
"17908","Z68315",67,12,7,5," 7.5"
"17909","Z68316",199,12,12,0," 0.0"
"17910","Z68317",661,56,4,52," 7.9"
"17911","Z68319",244,16,0,16," 6.6"
"17912","Z68320",180,31,0,31,"17.2"
"17913","Z68322",210,23,4,19," 9.0"
"17914","Z68325",164,70,37,33,"20.1"
"17915","Z68326",121,12,0,12," 9.9"
"17916","Z68327",171,26,4,22,"12.9"
"17917","Z68328",225,24,9,15," 6.7"
"17918","Z68331",399,39,0,39," 9.8"
"17919","Z68333",3293,272,53,219," 6.7"
"17920","Z68337",170,19,4,15," 8.8"
"17921","Z68338",179,39,0,39,"21.8"
"17922","Z68339",474,31,26,5," 1.1"
"17923","Z68341",437,51,5,46,"10.5"
"17924","Z68342",211,29,2,27,"12.8"
"17925","Z68343",429,62,0,62,"14.5"
"17926","Z68344",217,44,4,40,"18.4"
"17927","Z68345",157,34,21,13," 8.3"
"17928","Z68346",196,14,0,14," 7.1"
"17929","Z68347",891,48,0,48," 5.4"
"17930","Z68348",148,9,1,8," 5.4"
"17931","Z68349",503,61,0,61,"12.1"
"17932","Z68351",453,89,17,72,"15.9"
"17933","Z68352",2749,365,44,321,"11.7"
"17934","Z68354",437,70,21,49,"11.2"
"17935","Z68355",2607,286,20,266,"10.2"
"17936","Z68357",167,14,0,14," 8.4"
"17937","Z68358",638,54,0,54," 8.5"
"17938","Z68359",715,109,2,107,"15.0"
"17939","Z68361",1213,137,54,83," 6.8"
"17940","Z68364",50,7,0,7,"14.0"
"17941","Z68366",445,15,0,15," 3.4"
"17942","Z68367",216,44,0,44,"20.4"
"17943","Z68368",222,32,0,32,"14.4"
"17944","Z68370",1136,87,4,83," 7.3"
"17945","Z68371",692,59,0,59," 8.5"
"17946","Z68372",1126,35,4,31," 2.8"
"17947","Z68376",854,200,35,165,"19.3"
"17948","Z68377",219,34,12,22,"10.0"
"17949","Z68378",342,53,5,48,"14.0"
"17950","Z68402",504,36,4,32," 6.3"
"17951","Z68403",88,21,0,21,"23.9"
"17952","Z68405",1384,165,56,109," 7.9"
"17953","Z68406",313,84,7,77,"24.6"
"17954","Z68409",327,34,0,34,"10.4"
"17955","Z68410",3935,325,37,288," 7.3"
"17956","Z68413",251,12,0,12," 4.8"
"17957","Z68415",279,10,0,10," 3.6"
"17958","Z68420",732,111,43,68," 9.3"
"17959","Z68422",214,12,0,12," 5.6"
"17960","Z68423",425,48,0,48,"11.3"
"17961","Z68424",356,34,4,30," 8.4"
"17962","Z68428",487,32,0,32," 6.6"
"17963","Z68430",625,75,70,5," 0.8"
"17964","Z68431",193,13,5,8," 4.1"
"17965","Z68434",3333,241,5,236," 7.1"
"17966","Z68436",282,26,0,26," 9.2"
"17967","Z68441",149,43,1,42,"28.2"
"17968","Z68442",193,31,0,31,"16.1"
"17969","Z68446",1242,90,0,90," 7.2"
"17970","Z68447",261,19,9,10," 3.8"
"17971","Z68448",179,19,0,19,"10.6"
"17972","Z68450",1151,133,12,121,"10.5"
"17973","Z68454",235,7,0,7," 3.0"
"17974","Z68455",463,171,130,41," 8.9"
"17975","Z68456",480,24,0,24," 5.0"
"17976","Z68460",352,3,0,3," 0.9"
"17977","Z68462",1580,90,11,79," 5.0"
"17978","Z68463",660,43,0,43," 6.5"
"17979","Z68465",930,122,7,115,"12.4"
"17980","Z68466",940,142,20,122,"13.0"
"17981","Z68467",4257,458,13,445,"10.5"
"17982","Z68502",11708,664,32,632," 5.4"
"17983","Z68503",6649,571,0,571," 8.6"
"17984","Z68504",8247,561,0,561," 6.8"
"17985","Z68505",7144,233,15,218," 3.1"
"17986","Z68506",13276,357,27,330," 2.5"
"17987","Z68507",6201,255,25,230," 3.7"
"17988","Z68508",5290,720,47,673,"12.7"
"17989","Z68510",10017,495,0,495," 4.9"
"17990","Z68512",4966,83,11,72," 1.4"
"17991","Z68516",16235,563,36,527," 3.2"
"17992","Z68520",576,18,5,13," 2.3"
"17993","Z68521",13205,549,12,537," 4.1"
"17994","Z68522",4386,79,0,79," 1.8"
"17995","Z68523",551,58,0,58,"10.5"
"17996","Z68524",2099,117,0,117," 5.6"
"17997","Z68526",2033,79,0,79," 3.9"
"17998","Z68527",309,12,12,0," 0.0"
"17999","Z68528",2750,167,15,152," 5.5"
"18000","Z68601",12204,1048,497,551," 4.5"
"18001","Z68620",1357,216,48,168,"12.4"
"18002","Z68622",167,24,16,8," 4.8"
"18003","Z68626",320,24,8,16," 5.0"
"18004","Z68627",331,81,2,79,"23.9"
"18005","Z68628",544,178,104,74,"13.6"
"18006","Z68629",701,98,2,96,"13.7"
"18007","Z68631",186,6,0,6," 3.2"
"18008","Z68632",1744,94,22,72," 4.1"
"18009","Z68633",600,93,11,82,"13.7"
"18010","Z68636",621,88,22,66,"10.6"
"18011","Z68637",283,126,106,20," 7.1"
"18012","Z68638",936,162,17,145,"15.5"
"18013","Z68640",664,65,32,33," 5.0"
"18014","Z68641",457,42,8,34," 7.4"
"18015","Z68642",727,62,11,51," 7.0"
"18016","Z68643",463,36,4,32," 6.9"
"18017","Z68647",239,10,0,10," 4.2"
"18018","Z68649",907,154,105,49," 5.4"
"18019","Z68651",685,93,16,77,"11.2"
"18020","Z68652",344,21,0,21," 6.1"
"18021","Z68653",309,32,2,30," 9.7"
"18022","Z68654",296,69,0,69,"23.3"
"18023","Z68655",78,20,11,9,"11.5"
"18024","Z68658",293,13,5,8," 2.7"
"18025","Z68660",577,62,9,53," 9.2"
"18026","Z68661",2452,266,119,147," 6.0"
"18027","Z68662",569,54,0,54," 9.5"
"18028","Z68663",355,43,5,38,"10.7"
"18029","Z68664",166,25,0,25,"15.1"
"18030","Z68665",448,68,23,45,"10.0"
"18031","Z68666",686,82,32,50," 7.3"
"18032","Z68669",216,30,0,30,"13.9"
"18033","Z68701",12953,711,26,685," 5.3"
"18034","Z68710",344,51,11,40,"11.6"
"18035","Z68713",1041,117,25,92," 8.8"
"18036","Z68714",748,185,91,94,"12.6"
"18037","Z68715",597,45,0,45," 7.5"
"18038","Z68716",496,88,0,88,"17.7"
"18039","Z68717",129,40,4,36,"27.9"
"18040","Z68718",983,141,36,105,"10.7"
"18041","Z68720",142,18,2,16,"11.3"
"18042","Z68722",309,50,20,30," 9.7"
"18043","Z68723",243,34,0,34,"14.0"
"18044","Z68725",301,75,23,52,"17.3"
"18045","Z68726",373,38,14,24," 6.4"
"18046","Z68727",401,62,18,44,"11.0"
"18047","Z68729",913,79,0,79," 8.7"
"18048","Z68730",1075,345,259,86," 8.0"
"18049","Z68732",92,14,0,14,"15.2"
"18050","Z68735",454,73,24,49,"10.8"
"18051","Z68736",243,12,0,12," 4.9"
"18052","Z68739",1346,141,8,133," 9.9"
"18053","Z68740",356,50,12,38,"10.7"
"18054","Z68743",303,62,0,62,"20.5"
"18055","Z68745",738,63,22,41," 5.6"
"18056","Z68748",1272,147,10,137,"10.8"
"18057","Z68749",38,11,0,11,"28.9"
"18058","Z68752",399,47,15,32," 8.0"
"18059","Z68755",201,88,35,53,"26.4"
"18060","Z68756",999,153,0,153,"15.3"
"18061","Z68757",464,129,84,45," 9.7"
"18062","Z68758",638,153,9,144,"22.6"
"18063","Z68761",206,37,2,35,"17.0"
"18064","Z68763",2388,244,82,162," 6.8"
"18065","Z68764",371,67,4,63,"17.0"
"18066","Z68765",622,41,4,37," 5.9"
"18067","Z68767",1380,73,0,73," 5.3"
"18068","Z68768",298,49,17,32,"10.7"
"18069","Z68769",875,138,7,131,"15.0"
"18070","Z68770",676,58,0,58," 8.6"
"18071","Z68771",696,103,5,98,"14.1"
"18072","Z68774",165,20,20,0," 0.0"
"18073","Z68776",5382,267,0,267," 5.0"
"18074","Z68777",428,90,21,69,"16.1"
"18075","Z68778",329,91,36,55,"16.7"
"18076","Z68779",1215,202,0,202,"16.6"
"18077","Z68780",542,108,34,74,"13.7"
"18078","Z68781",707,37,0,37," 5.2"
"18079","Z68783",530,96,32,64,"12.1"
"18080","Z68784",842,73,9,64," 7.6"
"18081","Z68786",498,52,16,36," 7.2"
"18082","Z68787",2620,174,8,166," 6.3"
"18083","Z68788",2169,188,0,188," 8.7"
"18084","Z68790",340,44,0,44,"12.9"
"18085","Z68791",854,109,50,59," 6.9"
"18086","Z68792",297,126,99,27," 9.1"
"18087","Z68801",11625,571,6,565," 4.9"
"18088","Z68803",9896,793,43,750," 7.6"
"18089","Z68810",402,29,0,29," 7.2"
"18090","Z68812",305,38,0,38,"12.5"
"18091","Z68813",295,39,5,34,"11.5"
"18092","Z68814",510,99,25,74,"14.5"
"18093","Z68817",207,52,16,36,"17.4"
"18094","Z68818",2318,164,0,164," 7.1"
"18095","Z68821",99,44,17,27,"27.3"
"18096","Z68822",2269,254,46,208," 9.2"
"18097","Z68823",1449,438,260,178,"12.3"
"18098","Z68824",543,56,7,49," 9.0"
"18099","Z68825",524,63,0,63,"12.0"
"18100","Z68826",1858,90,35,55," 3.0"
"18101","Z68827",271,17,0,17," 6.3"
"18102","Z68831",370,60,19,41,"11.1"
"18103","Z68832",820,38,14,24," 2.9"
"18104","Z68834",217,78,12,66,"30.4"
"18105","Z68835",263,29,7,22," 8.4"
"18106","Z68836",634,26,6,20," 3.2"
"18107","Z68838",184,73,1,72,"39.1"
"18108","Z68840",1183,73,16,57," 4.8"
"18109","Z68842",318,91,36,55,"17.3"
"18110","Z68843",355,33,0,33," 9.3"
"18111","Z68845",7830,325,29,296," 3.8"
"18112","Z68846",143,3,0,3," 2.1"
"18113","Z68847",7518,464,105,359," 4.8"
"18114","Z68850",4261,334,39,295," 6.9"
"18115","Z68853",1097,407,257,150,"13.7"
"18116","Z68854",475,122,113,9," 1.9"
"18117","Z68855",211,26,9,17," 8.1"
"18118","Z68858",145,18,0,18,"12.4"
"18119","Z68860",154,17,0,17,"11.0"
"18120","Z68862",1559,221,72,149," 9.6"
"18121","Z68863",494,42,5,37," 7.5"
"18122","Z68864",602,116,8,108,"17.9"
"18123","Z68865",415,52,11,41," 9.9"
"18124","Z68866",356,18,0,18," 5.1"
"18125","Z68869",980,146,3,143,"14.6"
"18126","Z68870",221,30,0,30,"13.6"
"18127","Z68873",1570,186,16,170,"10.8"
"18128","Z68874",527,93,0,93,"17.6"
"18129","Z68875",336,72,4,68,"20.2"
"18130","Z68876",693,75,8,67," 9.7"
"18131","Z68883",970,86,8,78," 8.0"
"18132","Z68901",11285,666,23,643," 5.7"
"18133","Z68920",735,81,29,52," 7.1"
"18134","Z68922",595,47,3,44," 7.4"
"18135","Z68924",491,18,0,18," 3.7"
"18136","Z68925",237,25,0,25,"10.5"
"18137","Z68926",563,122,10,112,"19.9"
"18138","Z68927",577,44,0,44," 7.6"
"18139","Z68928",223,49,3,46,"20.6"
"18140","Z68930",614,46,12,34," 5.5"
"18141","Z68932",206,39,2,37,"18.0"
"18142","Z68933",448,42,0,42," 9.4"
"18143","Z68934",67,18,8,10,"14.9"
"18144","Z68935",394,101,38,63,"16.0"
"18145","Z68937",1419,731,669,62," 4.4"
"18146","Z68938",276,58,2,56,"20.3"
"18147","Z68939",672,133,27,106,"15.8"
"18148","Z68940",282,29,9,20," 7.1"
"18149","Z68943",151,42,0,42,"27.8"
"18150","Z68944",522,91,8,83,"15.9"
"18151","Z68945",141,17,0,17,"12.1"
"18152","Z68947",347,48,3,45,"13.0"
"18153","Z68948",183,51,0,51,"27.9"
"18154","Z68949",2996,369,39,330,"11.0"
"18155","Z68950",204,18,0,18," 8.8"
"18156","Z68955",881,127,34,93,"10.6"
"18157","Z68956",580,79,4,75,"12.9"
"18158","Z68957",331,24,0,24," 7.3"
"18159","Z68958",262,10,2,8," 3.1"
"18160","Z68959",1812,86,24,62," 3.4"
"18161","Z68961",417,82,14,68,"16.3"
"18162","Z68966",379,105,16,89,"23.5"
"18163","Z68967",592,35,2,33," 5.6"
"18164","Z68970",815,174,25,149,"18.3"
"18165","Z68971",828,604,575,29," 3.5"
"18166","Z68973",191,16,5,11," 5.8"
"18167","Z68977",165,26,5,21,"12.7"
"18168","Z68978",1232,131,11,120," 9.7"
"18169","Z68979",847,76,16,60," 7.1"
"18170","Z68982",332,24,0,24," 7.2"
"18171","Z69001",4512,524,156,368," 8.2"
"18172","Z69020",224,57,0,57,"25.4"
"18173","Z69021",769,144,24,120,"15.6"
"18174","Z69022",949,218,170,48," 5.1"
"18175","Z69024",634,67,9,58," 9.1"
"18176","Z69025",564,101,0,101,"17.9"
"18177","Z69028",329,50,6,44,"13.4"
"18178","Z69029",201,49,14,35,"17.4"
"18179","Z69030",199,50,20,30,"15.1"
"18180","Z69032",257,9,7,2," 0.8"
"18181","Z69033",1223,122,30,92," 7.5"
"18182","Z69034",472,69,14,55,"11.7"
"18183","Z69038",265,48,5,43,"16.2"
"18184","Z69040",402,78,12,66,"16.4"
"18185","Z69044",553,204,115,89,"16.1"
"18186","Z69045",567,76,33,43," 7.6"
"18187","Z69101",13680,1198,245,953," 7.0"
"18188","Z69120",505,66,7,59,"11.7"
"18189","Z69122",339,30,5,25," 7.4"
"18190","Z69127",587,165,112,53," 9.0"
"18191","Z69129",662,137,37,100,"15.1"
"18192","Z69130",2505,385,75,310,"12.4"
"18193","Z69131",265,55,0,55,"20.8"
"18194","Z69133",263,72,20,52,"19.8"
"18195","Z69134",184,41,4,37,"20.1"
"18196","Z69138",2120,270,14,256,"12.1"
"18197","Z69140",920,129,22,107,"11.6"
"18198","Z69143",620,84,0,84,"13.5"
"18199","Z69144",75,8,8,0," 0.0"
"18200","Z69145",1584,252,52,200,"12.6"
"18201","Z69147",1008,695,593,102,"10.1"
"18202","Z69149",342,50,38,12," 3.5"
"18203","Z69150",223,36,5,31,"13.9"
"18204","Z69151",406,30,5,25," 6.2"
"18205","Z69152",523,156,63,93,"17.8"
"18206","Z69153",2930,248,131,117," 4.0"
"18207","Z69154",713,171,15,156,"21.9"
"18208","Z69155",480,59,30,29," 6.0"
"18209","Z69156",296,50,16,34,"11.5"
"18210","Z69162",3909,367,37,330," 8.4"
"18211","Z69163",424,52,17,35," 8.3"
"18212","Z69165",805,72,32,40," 5.0"
"18213","Z69166",333,46,19,27," 8.1"
"18214","Z69167",188,33,9,24,"12.8"
"18215","Z69169",288,37,4,33,"11.5"
"18216","Z69201",2127,296,59,237,"11.1"
"18217","Z69210",1432,161,65,96," 6.7"
"18218","Z69211",183,38,22,16," 8.7"
"18219","Z69214",125,41,6,35,"28.0"
"18220","Z69217",335,166,96,70,"20.9"
"18221","Z69301",4817,513,69,444," 9.2"
"18222","Z69334",1026,180,23,157,"15.3"
"18223","Z69336",1236,205,19,186,"15.0"
"18224","Z69337",3015,359,0,359,"11.9"
"18225","Z69339",1053,230,27,203,"19.3"
"18226","Z69341",4719,441,76,365," 7.7"
"18227","Z69343",1333,280,68,212,"15.9"
"18228","Z69346",414,163,56,107,"25.8"
"18229","Z69347",704,169,13,156,"22.2"
"18230","Z69348",810,180,5,175,"21.6"
"18231","Z69350",261,90,29,61,"23.4"
"18232","Z69352",338,41,1,40,"11.8"
"18233","Z69355",54,2,0,2," 3.7"
"18234","Z69356",990,204,63,141,"14.2"
"18235","Z69357",1486,69,4,65," 4.4"
"18236","Z69358",893,142,15,127,"14.2"
"18237","Z69360",720,138,8,130,"18.1"
"18238","Z69361",7987,706,19,687," 8.6"
"18239","Z70001",18879,1560,89,1471," 7.8"
"18240","Z70002",9080,746,73,673," 7.4"
"18241","Z70003",17150,1287,62,1225," 7.1"
"18242","Z70005",12562,1222,175,1047," 8.3"
"18243","Z70006",6752,534,38,496," 7.3"
"18244","Z70036",530,112,83,29," 5.5"
"18245","Z70037",6401,467,34,433," 6.8"
"18246","Z70038",221,45,36,9," 4.1"
"18247","Z70039",1012,240,0,240,"23.7"
"18248","Z70040",460,76,0,76,"16.5"
"18249","Z70041",1159,122,86,36," 3.1"
"18250","Z70043",8077,833,77,756," 9.4"
"18251","Z70047",4883,366,0,366," 7.5"
"18252","Z70049",1032,88,0,88," 8.5"
"18253","Z70051",974,196,0,196,"20.1"
"18254","Z70052",1425,119,43,76," 5.3"
"18255","Z70053",7394,1118,54,1064,"14.4"
"18256","Z70056",15093,1333,76,1257," 8.3"
"18257","Z70058",15408,2008,22,1986,"12.9"
"18258","Z70062",7278,1019,62,957,"13.1"
"18259","Z70065",22437,2902,55,2847,"12.7"
"18260","Z70067",1037,118,19,99," 9.5"
"18261","Z70068",12676,1454,0,1454,"11.5"
"18262","Z70070",4722,341,55,286," 6.1"
"18263","Z70071",1616,162,0,162,"10.0"
"18264","Z70072",21173,1766,72,1694," 8.0"
"18265","Z70075",1782,170,11,159," 8.9"
"18266","Z70079",1261,124,0,124," 9.8"
"18267","Z70080",542,42,0,42," 7.7"
"18268","Z70082",156,30,15,15," 9.6"
"18269","Z70083",1207,372,259,113," 9.4"
"18270","Z70084",2987,425,20,405,"13.6"
"18271","Z70085",2148,591,327,264,"12.3"
"18272","Z70086",834,129,4,125,"15.0"
"18273","Z70087",3145,236,0,236," 7.5"
"18274","Z70090",3141,278,7,271," 8.6"
"18275","Z70091",180,87,76,11," 6.1"
"18276","Z70092",2833,379,15,364,"12.8"
"18277","Z70094",12918,1840,146,1694,"13.1"
"18278","Z70112",2702,1208,389,819,"30.3"
"18279","Z70113",4861,1324,33,1291,"26.6"
"18280","Z70114",12054,2298,62,2236,"18.5"
"18281","Z70115",19152,3229,843,2386,"12.5"
"18282","Z70116",9535,3300,1190,2110,"22.1"
"18283","Z70117",13598,3109,330,2779,"20.4"
"18284","Z70118",16353,3141,376,2765,"16.9"
"18285","Z70119",20861,4554,288,4266,"20.4"
"18286","Z70121",6255,630,82,548," 8.8"
"18287","Z70122",16712,3175,182,2993,"17.9"
"18288","Z70123",13149,1193,91,1102," 8.4"
"18289","Z70124",9480,1093,303,790," 8.3"
"18290","Z70125",7618,1610,54,1556,"20.4"
"18291","Z70126",12249,3117,144,2973,"24.3"
"18292","Z70127",10328,1310,51,1259,"12.2"
"18293","Z70128",7889,853,41,812,"10.3"
"18294","Z70129",3985,774,265,509,"12.8"
"18295","Z70130",10823,2762,1298,1464,"13.5"
"18296","Z70131",13751,1954,80,1874,"13.6"
"18297","Z70301",17769,1342,232,1110," 6.2"
"18298","Z70339",3462,925,697,228," 6.6"
"18299","Z70341",1823,317,48,269,"14.8"
"18300","Z70342",1861,63,0,63," 3.4"
"18301","Z70344",2466,409,159,250,"10.1"
"18302","Z70346",4207,524,95,429,"10.2"
"18303","Z70353",721,269,114,155,"21.5"
"18304","Z70354",1936,323,52,271,"14.0"
"18305","Z70355",437,61,0,61,"14.0"
"18306","Z70356",945,125,10,115,"12.2"
"18307","Z70357",1529,528,225,303,"19.8"
"18308","Z70358",2068,1671,1460,211,"10.2"
"18309","Z70359",3423,202,9,193," 5.6"
"18310","Z70360",11337,1036,227,809," 7.1"
"18311","Z70363",9342,738,19,719," 7.7"
"18312","Z70364",12006,840,0,840," 7.0"
"18313","Z70372",1050,166,31,135,"12.9"
"18314","Z70373",2839,244,92,152," 5.4"
"18315","Z70374",2918,277,97,180," 6.2"
"18316","Z70377",1782,231,70,161," 9.0"
"18317","Z70380",10195,1370,144,1226,"12.0"
"18318","Z70390",3021,454,102,352,"11.7"
"18319","Z70392",3550,392,84,308," 8.7"
"18320","Z70394",5718,443,97,346," 6.1"
"18321","Z70395",2062,164,18,146," 7.1"
"18322","Z70401",9337,1548,144,1404,"15.0"
"18323","Z70403",11231,1118,151,967," 8.6"
"18324","Z70420",3202,162,0,162," 5.1"
"18325","Z70422",6134,775,212,563," 9.2"
"18326","Z70426",2361,525,211,314,"13.3"
"18327","Z70427",9558,1873,131,1742,"18.2"
"18328","Z70431",2195,287,167,120," 5.5"
"18329","Z70433",14209,1191,126,1065," 7.5"
"18330","Z70435",7205,521,200,321," 4.5"
"18331","Z70436",260,19,0,19," 7.3"
"18332","Z70437",3531,354,100,254," 7.2"
"18333","Z70438",8068,1032,184,848,"10.5"
"18334","Z70441",2306,588,274,314,"13.6"
"18335","Z70443",4076,505,135,370," 9.1"
"18336","Z70444",4453,684,224,460,"10.3"
"18337","Z70445",4838,664,44,620,"12.8"
"18338","Z70446",2704,178,88,90," 3.3"
"18339","Z70447",4008,396,20,376," 9.4"
"18340","Z70448",9655,477,59,418," 4.3"
"18341","Z70449",2175,725,333,392,"18.0"
"18342","Z70450",1490,244,150,94," 6.3"
"18343","Z70452",5144,777,141,636,"12.4"
"18344","Z70453",404,88,13,75,"18.6"
"18345","Z70454",11458,1332,175,1157,"10.1"
"18346","Z70456",965,174,82,92," 9.5"
"18347","Z70458",15479,1695,93,1602,"10.3"
"18348","Z70460",8711,616,30,586," 6.7"
"18349","Z70461",10973,1103,208,895," 8.2"
"18350","Z70462",2842,606,392,214," 7.5"
"18351","Z70465",286,68,7,61,"21.3"
"18352","Z70466",3291,255,36,219," 6.7"
"18353","Z70471",8541,567,116,451," 5.3"
"18354","Z70501",12559,1519,133,1386,"11.0"
"18355","Z70503",12008,854,107,747," 6.2"
"18356","Z70506",19222,1183,142,1041," 5.4"
"18357","Z70507",6870,409,32,377," 5.5"
"18358","Z70508",16638,1282,160,1122," 6.7"
"18359","Z70510",10760,1393,149,1244,"11.6"
"18360","Z70512",4079,480,230,250," 6.1"
"18361","Z70515",1367,217,21,196,"14.3"
"18362","Z70517",11015,1508,533,975," 8.9"
"18363","Z70518",5546,399,26,373," 6.7"
"18364","Z70520",7401,528,137,391," 5.3"
"18365","Z70525",5344,604,135,469," 8.8"
"18366","Z70526",8047,1212,63,1149,"14.3"
"18367","Z70529",5008,592,42,550,"11.0"
"18368","Z70532",1184,181,39,142,"12.0"
"18369","Z70533",2905,284,59,225," 7.7"
"18370","Z70534",404,53,6,47,"11.6"
"18371","Z70535",7564,931,194,737," 9.7"
"18372","Z70537",208,31,0,31,"14.9"
"18373","Z70538",6091,953,246,707,"11.6"
"18374","Z70541",173,31,19,12," 6.9"
"18375","Z70542",1902,466,234,232,"12.2"
"18376","Z70543",1926,247,35,212,"11.0"
"18377","Z70544",5115,842,174,668,"13.1"
"18378","Z70546",6792,931,167,764,"11.2"
"18379","Z70548",4922,1053,478,575,"11.7"
"18380","Z70549",1779,212,50,162," 9.1"
"18381","Z70552",723,59,8,51," 7.1"
"18382","Z70554",2631,410,59,351,"13.3"
"18383","Z70555",3409,462,132,330," 9.7"
"18384","Z70556",159,41,15,26,"16.4"
"18385","Z70559",1156,232,71,161,"13.9"
"18386","Z70560",17127,2329,215,2114,"12.3"
"18387","Z70563",7444,526,61,465," 6.2"
"18388","Z70570",16086,2248,332,1916,"11.9"
"18389","Z70577",2044,400,230,170," 8.3"
"18390","Z70578",6843,763,67,696,"10.2"
"18391","Z70582",8180,1178,95,1083,"13.2"
"18392","Z70583",4960,497,168,329," 6.6"
"18393","Z70584",3349,434,153,281," 8.4"
"18394","Z70585",85,6,0,6," 7.1"
"18395","Z70586",9185,1787,587,1200,"13.1"
"18396","Z70589",1478,282,126,156,"10.6"
"18397","Z70591",2239,314,54,260,"11.6"
"18398","Z70592",7826,204,0,204," 2.6"
"18399","Z70601",15816,2284,156,2128,"13.5"
"18400","Z70605",15283,1201,232,969," 6.3"
"18401","Z70607",11990,1461,228,1233,"10.3"
"18402","Z70611",7946,787,126,661," 8.3"
"18403","Z70615",5257,1048,49,999,"19.0"
"18404","Z70631",386,68,68,0," 0.0"
"18405","Z70632",321,110,110,0," 0.0"
"18406","Z70633",3061,454,63,391,"12.8"
"18407","Z70634",10801,1681,436,1245,"11.5"
"18408","Z70637",312,82,71,11," 3.5"
"18409","Z70638",341,81,5,76,"22.3"
"18410","Z70639",248,68,8,60,"24.2"
"18411","Z70643",129,13,0,13,"10.1"
"18412","Z70645",681,234,214,20," 2.9"
"18413","Z70646",232,47,0,47,"20.3"
"18414","Z70647",3813,541,0,541,"14.2"
"18415","Z70648",2975,554,216,338,"11.4"
"18416","Z70650",132,27,27,0," 0.0"
"18417","Z70652",917,107,66,41," 4.5"
"18418","Z70653",1541,203,74,129," 8.4"
"18419","Z70655",1295,153,45,108," 8.3"
"18420","Z70656",1657,260,92,168,"10.1"
"18421","Z70657",1960,109,40,69," 3.5"
"18422","Z70658",427,91,26,65,"15.2"
"18423","Z70659",585,84,6,78,"13.3"
"18424","Z70661",1108,154,50,104," 9.4"
"18425","Z70663",11430,987,50,937," 8.2"
"18426","Z70665",4357,470,115,355," 8.1"
"18427","Z70668",3161,370,78,292," 9.2"
"18428","Z70669",4393,444,23,421," 9.6"
"18429","Z70706",7709,318,0,318," 4.1"
"18430","Z70710",1629,116,22,94," 5.8"
"18431","Z70711",2033,169,0,169," 8.3"
"18432","Z70712",226,47,13,34,"15.0"
"18433","Z70714",7741,605,114,491," 6.3"
"18434","Z70715",817,282,191,91,"11.1"
"18435","Z70719",1732,35,0,35," 2.0"
"18436","Z70722",2631,346,192,154," 5.9"
"18437","Z70723",693,63,7,56," 8.1"
"18438","Z70725",641,66,0,66,"10.3"
"18439","Z70726",21351,1844,123,1721," 8.1"
"18440","Z70730",1534,89,36,53," 3.5"
"18441","Z70732",465,27,6,21," 4.5"
"18442","Z70733",789,157,61,96,"12.2"
"18443","Z70734",2676,68,0,68," 2.5"
"18444","Z70737",16376,1278,123,1155," 7.1"
"18445","Z70739",4871,137,15,122," 2.5"
"18446","Z70740",616,56,0,56," 9.1"
"18447","Z70744",2499,239,54,185," 7.4"
"18448","Z70748",1819,324,45,279,"15.3"
"18449","Z70750",1038,352,242,110,"10.6"
"18450","Z70753",436,60,21,39," 8.9"
"18451","Z70754",3809,294,41,253," 6.6"
"18452","Z70755",919,116,0,116,"12.6"
"18453","Z70757",1391,204,9,195,"14.0"
"18454","Z70759",702,193,0,193,"27.5"
"18455","Z70760",3228,680,205,475,"14.7"
"18456","Z70761",441,139,32,107,"24.3"
"18457","Z70762",591,245,171,74,"12.5"
"18458","Z70763",1338,14,0,14," 1.0"
"18459","Z70764",7499,1147,373,774,"10.3"
"18460","Z70767",6142,514,8,506," 8.2"
"18461","Z70769",14200,879,189,690," 4.9"
"18462","Z70770",1165,78,0,78," 6.7"
"18463","Z70772",444,64,4,60,"13.5"
"18464","Z70774",4148,302,65,237," 5.7"
"18465","Z70775",4644,1140,564,576,"12.4"
"18466","Z70776",978,121,0,121,"12.4"
"18467","Z70777",1979,265,87,178," 9.0"
"18468","Z70778",1114,42,10,32," 2.9"
"18469","Z70780",510,30,0,30," 5.9"
"18470","Z70783",1536,349,349,0," 0.0"
"18471","Z70785",8543,832,25,807," 9.4"
"18472","Z70788",1730,165,26,139," 8.0"
"18473","Z70791",9565,706,24,682," 7.1"
"18474","Z70802",13213,2657,328,2329,"17.6"
"18475","Z70805",11943,1428,172,1256,"10.5"
"18476","Z70806",14607,1983,280,1703,"11.7"
"18477","Z70807",7074,1178,115,1063,"15.0"
"18478","Z70808",14552,1857,321,1536,"10.6"
"18479","Z70809",12557,1543,601,942," 7.5"
"18480","Z70810",16841,1831,258,1573," 9.3"
"18481","Z70811",5331,612,74,538,"10.1"
"18482","Z70814",5732,247,0,247," 4.3"
"18483","Z70815",12477,1275,77,1198," 9.6"
"18484","Z70816",20345,2124,520,1604," 7.9"
"18485","Z70817",12904,747,133,614," 4.8"
"18486","Z70818",4006,180,0,180," 4.5"
"18487","Z70819",1748,138,0,138," 7.9"
"18488","Z70820",8944,1556,165,1391,"15.6"
"18489","Z71001",2179,344,130,214," 9.8"
"18490","Z71003",685,143,13,130,"19.0"
"18491","Z71004",284,54,1,53,"18.7"
"18492","Z71006",4866,551,152,399," 8.2"
"18493","Z71007",527,176,10,166,"31.5"
"18494","Z71016",988,245,41,204,"20.6"
"18495","Z71018",825,221,21,200,"24.2"
"18496","Z71019",3835,627,87,540,"14.1"
"18497","Z71021",474,188,20,168,"35.4"
"18498","Z71023",1864,553,255,298,"16.0"
"18499","Z71027",678,28,0,28," 4.1"
"18500","Z71028",945,285,43,242,"25.6"
"18501","Z71030",765,102,0,102,"13.3"
"18502","Z71032",1061,299,40,259,"24.4"
"18503","Z71033",1668,176,0,176,"10.6"
"18504","Z71037",8331,778,53,725," 8.7"
"18505","Z71038",2250,458,38,420,"18.7"
"18506","Z71039",875,138,20,118,"13.5"
"18507","Z71040",3963,1173,548,625,"15.8"
"18508","Z71043",307,91,6,85,"27.7"
"18509","Z71044",336,52,5,47,"14.0"
"18510","Z71046",625,100,7,93,"14.9"
"18511","Z71047",4684,709,114,595,"12.7"
"18512","Z71049",1631,440,41,399,"24.5"
"18513","Z71051",1268,369,54,315,"24.8"
"18514","Z71052",4892,911,69,842,"17.2"
"18515","Z71055",9127,1428,271,1157,"12.7"
"18516","Z71060",1260,190,6,184,"14.6"
"18517","Z71061",795,89,0,89,"11.2"
"18518","Z71064",2059,515,24,491,"23.8"
"18519","Z71068",1971,456,204,252,"12.8"
"18520","Z71069",328,109,0,109,"33.2"
"18521","Z71070",1034,258,123,135,"13.1"
"18522","Z71071",1244,275,24,251,"20.2"
"18523","Z71072",696,160,15,145,"20.8"
"18524","Z71073",1228,227,106,121," 9.9"
"18525","Z71075",3131,604,53,551,"17.6"
"18526","Z71078",2393,150,11,139," 5.8"
"18527","Z71082",2501,362,20,342,"13.7"
"18528","Z71101",4369,1054,0,1054,"24.1"
"18529","Z71103",3608,754,0,754,"20.9"
"18530","Z71104",7297,1397,147,1250,"17.1"
"18531","Z71105",11304,1231,77,1154,"10.2"
"18532","Z71106",14798,1774,112,1662,"11.2"
"18533","Z71107",13271,1634,61,1573,"11.9"
"18534","Z71108",7724,1135,11,1124,"14.6"
"18535","Z71109",9735,1497,0,1497,"15.4"
"18536","Z71111",18448,1822,222,1600," 8.7"
"18537","Z71112",13847,1279,118,1161," 8.4"
"18538","Z71115",7453,746,174,572," 7.7"
"18539","Z71118",11023,624,32,592," 5.4"
"18540","Z71119",4864,388,0,388," 8.0"
"18541","Z71129",5856,564,65,499," 8.5"
"18542","Z71201",10016,1069,67,1002,"10.0"
"18543","Z71202",10502,1593,83,1510,"14.4"
"18544","Z71203",15594,1804,194,1610,"10.3"
"18545","Z71219",508,17,9,8," 1.6"
"18546","Z71220",10336,1477,237,1240,"12.0"
"18547","Z71222",1704,468,145,323,"19.0"
"18548","Z71223",293,127,52,75,"25.6"
"18549","Z71225",2804,155,45,110," 3.9"
"18550","Z71226",1057,308,181,127,"12.0"
"18551","Z71227",1836,336,19,317,"17.3"
"18552","Z71232",2941,537,140,397,"13.5"
"18553","Z71234",2046,451,137,314,"15.3"
"18554","Z71238",1316,83,0,83," 6.3"
"18555","Z71241",4727,1142,533,609,"12.9"
"18556","Z71251",4019,792,182,610,"15.2"
"18557","Z71254",2704,379,152,227," 8.4"
"18558","Z71259",806,156,62,94,"11.7"
"18559","Z71260",1759,492,189,303,"17.2"
"18560","Z71261",796,166,81,85,"10.7"
"18561","Z71263",3664,538,51,487,"13.3"
"18562","Z71264",535,104,34,70,"13.1"
"18563","Z71266",737,136,86,50," 6.8"
"18564","Z71268",1248,230,45,185,"14.8"
"18565","Z71269",5067,471,108,363," 7.2"
"18566","Z71270",13509,1464,129,1335," 9.9"
"18567","Z71275",1230,278,88,190,"15.4"
"18568","Z71282",4448,704,218,486,"10.9"
"18569","Z71286",287,67,13,54,"18.8"
"18570","Z71291",14751,1432,53,1379," 9.3"
"18571","Z71292",9574,1813,104,1709,"17.9"
"18572","Z71295",6096,1133,137,996,"16.3"
"18573","Z71301",9763,1832,58,1774,"18.2"
"18574","Z71302",6819,1083,99,984,"14.4"
"18575","Z71303",9317,1405,345,1060,"11.4"
"18576","Z71322",3093,491,70,421,"13.6"
"18577","Z71323",343,25,8,17," 5.0"
"18578","Z71325",550,158,23,135,"24.5"
"18579","Z71327",1825,349,40,309,"16.9"
"18580","Z71328",3031,353,98,255," 8.4"
"18581","Z71331",486,73,24,49,"10.1"
"18582","Z71334",4083,604,320,284," 7.0"
"18583","Z71336",806,146,50,96,"11.9"
"18584","Z71340",550,184,85,99,"18.0"
"18585","Z71341",1396,234,55,179,"12.8"
"18586","Z71342",3552,467,91,376,"10.6"
"18587","Z71343",3688,637,340,297," 8.1"
"18588","Z71346",1397,320,34,286,"20.5"
"18589","Z71350",1968,221,45,176," 8.9"
"18590","Z71351",5012,1057,490,567,"11.3"
"18591","Z71353",858,131,52,79," 9.2"
"18592","Z71354",969,160,120,40," 4.1"
"18593","Z71355",1505,239,148,91," 6.0"
"18594","Z71357",1517,741,567,174,"11.5"
"18595","Z71358",545,80,58,22," 4.0"
"18596","Z71360",14927,2164,435,1729,"11.6"
"18597","Z71362",925,273,71,202,"21.8"
"18598","Z71366",1267,543,374,169,"13.3"
"18599","Z71368",849,274,218,56," 6.6"
"18600","Z71369",1322,277,112,165,"12.5"
"18601","Z71371",905,82,23,59," 6.5"
"18602","Z71373",3400,630,295,335," 9.9"
"18603","Z71378",1143,198,51,147,"12.9"
"18604","Z71401",114,46,33,13,"11.4"
"18605","Z71403",1822,323,101,222,"12.2"
"18606","Z71407",432,69,22,47,"10.9"
"18607","Z71409",2926,534,77,457,"15.6"
"18608","Z71414",74,16,0,16,"21.6"
"18609","Z71416",471,104,9,95,"20.2"
"18610","Z71417",2301,514,146,368,"16.0"
"18611","Z71418",3484,971,649,322," 9.2"
"18612","Z71419",1430,392,199,193,"13.5"
"18613","Z71422",778,142,49,93,"12.0"
"18614","Z71423",1926,334,40,294,"15.3"
"18615","Z71424",574,112,0,112,"19.5"
"18616","Z71429",1790,758,452,306,"17.1"
"18617","Z71430",1163,317,191,126,"10.8"
"18618","Z71432",514,73,11,62,"12.1"
"18619","Z71433",1815,253,96,157," 8.7"
"18620","Z71435",1782,411,159,252,"14.1"
"18621","Z71438",665,52,0,52," 7.8"
"18622","Z71439",862,177,38,139,"16.1"
"18623","Z71446",10772,1942,170,1772,"16.5"
"18624","Z71447",573,144,29,115,"20.1"
"18625","Z71449",5967,2334,1786,548," 9.2"
"18626","Z71450",485,118,27,91,"18.8"
"18627","Z71454",1410,466,187,279,"19.8"
"18628","Z71456",777,384,202,182,"23.4"
"18629","Z71457",12725,2340,248,2092,"16.4"
"18630","Z71459",3822,712,0,712,"18.6"
"18631","Z71462",768,290,202,88,"11.5"
"18632","Z71463",3891,662,130,532,"13.7"
"18633","Z71465",1337,263,88,175,"13.1"
"18634","Z71468",541,158,76,82,"15.2"
"18635","Z71469",1374,382,98,284,"20.7"
"18636","Z71479",400,86,17,69,"17.2"
"18637","Z71480",291,89,4,85,"29.2"
"18638","Z71483",4909,1189,163,1026,"20.9"
"18639","Z71485",904,98,37,61," 6.7"
"18640","Z71486",3117,985,643,342,"11.0"
"18641","Z71601",7497,1581,126,1455,"19.4"
"18642","Z71602",7317,874,79,795,"10.9"
"18643","Z71603",15141,1894,60,1834,"12.1"
"18644","Z71638",1690,367,79,288,"17.0"
"18645","Z71639",3010,454,109,345,"11.5"
"18646","Z71640",1545,241,53,188,"12.2"
"18647","Z71643",574,157,17,140,"24.4"
"18648","Z71644",512,103,54,49," 9.6"
"18649","Z71646",2940,358,11,347,"11.8"
"18650","Z71653",2460,391,196,195," 7.9"
"18651","Z71654",2193,347,145,202," 9.2"
"18652","Z71655",6746,835,31,804,"11.9"
"18653","Z71660",414,119,46,73,"17.6"
"18654","Z71661",193,42,14,28,"14.5"
"18655","Z71663",287,38,14,24," 8.4"
"18656","Z71665",2673,392,87,305,"11.4"
"18657","Z71667",3525,479,125,354,"10.0"
"18658","Z71670",707,148,34,114,"16.1"
"18659","Z71671",4274,672,95,577,"13.5"
"18660","Z71674",331,68,25,43,"13.0"
"18661","Z71675",966,117,33,84," 8.7"
"18662","Z71676",449,187,70,117,"26.1"
"18663","Z71701",9890,1753,430,1323,"13.4"
"18664","Z71720",1069,145,45,100," 9.4"
"18665","Z71726",1042,386,258,128,"12.3"
"18666","Z71730",14836,2026,284,1742,"11.7"
"18667","Z71740",707,144,5,139,"19.7"
"18668","Z71742",3021,569,89,480,"15.9"
"18669","Z71744",1840,514,195,319,"17.3"
"18670","Z71749",1052,130,48,82," 7.8"
"18671","Z71751",520,133,59,74,"14.2"
"18672","Z71753",7767,1206,250,956,"12.3"
"18673","Z71759",297,46,6,40,"13.5"
"18674","Z71762",1126,218,30,188,"16.7"
"18675","Z71763",851,270,121,149,"17.5"
"18676","Z71764",1150,288,131,157,"13.7"
"18677","Z71765",1201,263,120,143,"11.9"
"18678","Z71766",299,43,4,39,"13.0"
"18679","Z71770",1897,376,68,308,"16.2"
"18680","Z71801",7446,1651,160,1491,"20.0"
"18681","Z71822",4240,634,172,462,"10.9"
"18682","Z71826",637,170,57,113,"17.7"
"18683","Z71827",432,187,73,114,"26.4"
"18684","Z71832",3945,318,22,296," 7.5"
"18685","Z71833",1055,242,13,229,"21.7"
"18686","Z71834",686,103,0,103,"15.0"
"18687","Z71836",1529,274,27,247,"16.2"
"18688","Z71837",2023,213,65,148," 7.3"
"18689","Z71842",1008,187,53,134,"13.3"
"18690","Z71845",1140,354,113,241,"21.1"
"18691","Z71846",1460,193,65,128," 8.8"
"18692","Z71852",4445,839,121,718,"16.2"
"18693","Z71854",16475,2031,187,1844,"11.2"
"18694","Z71857",2655,507,157,350,"13.2"
"18695","Z71859",309,135,77,58,"18.8"
"18696","Z71860",1639,458,82,376,"22.9"
"18697","Z71861",1329,482,359,123," 9.3"
"18698","Z71901",14539,2690,646,2044,"14.1"
"18699","Z71909",8988,1614,861,753," 8.4"
"18700","Z71913",24235,5045,2721,2324," 9.6"
"18701","Z71921",1653,290,30,260,"15.7"
"18702","Z71923",6918,942,202,740,"10.7"
"18703","Z71929",2013,352,249,103," 5.1"
"18704","Z71935",415,125,77,48,"11.6"
"18705","Z71937",971,242,35,207,"21.3"
"18706","Z71940",928,161,73,88," 9.5"
"18707","Z71941",1018,237,29,208,"20.4"
"18708","Z71943",2182,360,145,215," 9.9"
"18709","Z71945",586,39,10,29," 4.9"
"18710","Z71949",1354,329,329,0," 0.0"
"18711","Z71950",653,208,128,80,"12.3"
"18712","Z71953",7490,1587,817,770,"10.3"
"18713","Z71956",795,121,50,71," 8.9"
"18714","Z71957",2423,1012,817,195," 8.0"
"18715","Z71958",1305,394,165,229,"17.5"
"18716","Z71959",324,62,0,62,"19.1"
"18717","Z71961",505,119,45,74,"14.7"
"18718","Z71962",513,48,29,19," 3.7"
"18719","Z71964",1508,86,0,86," 5.7"
"18720","Z71968",2423,798,271,527,"21.7"
"18721","Z71970",567,225,123,102,"18.0"
"18722","Z71971",243,39,21,18," 7.4"
"18723","Z72002",6122,680,9,671,"11.0"
"18724","Z72004",635,174,40,134,"21.1"
"18725","Z72006",1540,378,165,213,"13.8"
"18726","Z72007",2803,263,58,205," 7.3"
"18727","Z72010",3075,468,50,418,"13.6"
"18728","Z72011",1557,44,0,44," 2.8"
"18729","Z72012",5106,396,45,351," 6.9"
"18730","Z72013",1250,402,261,141,"11.3"
"18731","Z72014",51,16,0,16,"31.4"
"18732","Z72015",11361,882,6,876," 7.7"
"18733","Z72017",486,98,42,56,"11.5"
"18734","Z72019",9544,643,57,586," 6.1"
"18735","Z72020",1857,216,12,204,"11.0"
"18736","Z72021",2252,534,101,433,"19.2"
"18737","Z72022",7062,534,0,534," 7.6"
"18738","Z72023",14339,827,43,784," 5.5"
"18739","Z72024",1612,263,89,174,"10.8"
"18740","Z72027",708,71,44,27," 3.8"
"18741","Z72029",879,122,30,92,"10.5"
"18742","Z72031",3544,847,548,299," 8.4"
"18743","Z72032",13743,1832,328,1504,"10.9"
"18744","Z72034",20048,1769,166,1603," 8.0"
"18745","Z72036",571,237,67,170,"29.8"
"18746","Z72039",915,66,20,46," 5.0"
"18747","Z72040",1436,187,77,110," 7.7"
"18748","Z72041",811,199,46,153,"18.9"
"18749","Z72042",2433,424,117,307,"12.6"
"18750","Z72044",751,430,387,43," 5.7"
"18751","Z72046",2023,198,138,60," 3.0"
"18752","Z72047",355,44,4,40,"11.3"
"18753","Z72051",332,64,37,27," 8.1"
"18754","Z72055",506,147,82,65,"12.8"
"18755","Z72057",468,101,69,32," 6.8"
"18756","Z72058",6436,880,90,790,"12.3"
"18757","Z72060",206,28,20,8," 3.9"
"18758","Z72061",64,24,0,24,"37.5"
"18759","Z72064",1246,101,25,76," 6.1"
"18760","Z72065",2103,287,82,205," 9.7"
"18761","Z72067",2864,1683,1458,225," 7.9"
"18762","Z72069",1090,393,299,94," 8.6"
"18763","Z72072",169,18,9,9," 5.3"
"18764","Z72073",575,114,60,54," 9.4"
"18765","Z72076",16962,2434,176,2258,"13.3"
"18766","Z72079",348,69,0,69,"19.8"
"18767","Z72081",3221,418,0,418,"13.0"
"18768","Z72082",986,98,0,98," 9.9"
"18769","Z72083",96,8,4,4," 4.2"
"18770","Z72084",698,134,56,78,"11.2"
"18771","Z72086",4258,432,146,286," 6.7"
"18772","Z72087",1081,172,114,58," 5.4"
"18773","Z72088",2366,1142,976,166," 7.0"
"18774","Z72101",1496,276,37,239,"16.0"
"18775","Z72102",1234,200,50,150,"12.2"
"18776","Z72103",5433,664,24,640,"11.8"
"18777","Z72104",9806,1285,219,1066,"10.9"
"18778","Z72106",2433,261,114,147," 6.0"
"18779","Z72107",235,103,37,66,"28.1"
"18780","Z72110",5069,742,282,460," 9.1"
"18781","Z72111",430,52,44,8," 1.9"
"18782","Z72112",4357,900,112,788,"18.1"
"18783","Z72113",9737,646,112,534," 5.5"
"18784","Z72114",6492,1425,29,1396,"21.5"
"18785","Z72116",10358,977,0,977," 9.4"
"18786","Z72117",5759,761,62,699,"12.1"
"18787","Z72118",10180,1606,30,1576,"15.5"
"18788","Z72120",13465,1054,75,979," 7.3"
"18789","Z72121",1554,313,168,145," 9.3"
"18790","Z72125",389,52,15,37," 9.5"
"18791","Z72126",1817,405,157,248,"13.6"
"18792","Z72128",328,20,0,20," 6.1"
"18793","Z72129",624,60,38,22," 3.5"
"18794","Z72131",2410,557,217,340,"14.1"
"18795","Z72134",174,29,11,18,"10.3"
"18796","Z72135",1102,64,27,37," 3.4"
"18797","Z72136",688,73,0,73,"10.6"
"18798","Z72137",1101,178,3,175,"15.9"
"18799","Z72142",1253,191,61,130,"10.4"
"18800","Z72143",14663,1414,209,1205," 8.2"
"18801","Z72150",5169,617,119,498," 9.6"
"18802","Z72157",633,96,64,32," 5.1"
"18803","Z72160",5184,738,98,640,"12.3"
"18804","Z72167",644,97,0,97,"15.1"
"18805","Z72173",3652,293,63,230," 6.3"
"18806","Z72176",3539,359,124,235," 6.6"
"18807","Z72201",811,178,8,170,"21.0"
"18808","Z72202",6434,1353,144,1209,"18.8"
"18809","Z72204",14680,3009,223,2786,"19.0"
"18810","Z72205",11644,1158,106,1052," 9.0"
"18811","Z72206",11794,2413,113,2300,"19.5"
"18812","Z72207",5443,683,107,576,"10.6"
"18813","Z72209",14055,2961,93,2868,"20.4"
"18814","Z72210",7276,999,85,914,"12.6"
"18815","Z72211",11132,1807,0,1807,"16.2"
"18816","Z72212",5172,198,0,198," 3.8"
"18817","Z72223",9092,622,21,601," 6.6"
"18818","Z72227",5930,961,97,864,"14.6"
"18819","Z72301",11323,1686,77,1609,"14.2"
"18820","Z72315",11549,2194,118,2076,"18.0"
"18821","Z72324",898,15,0,15," 1.7"
"18822","Z72327",744,138,21,117,"15.7"
"18823","Z72331",1381,262,16,246,"17.8"
"18824","Z72333",382,71,0,71,"18.6"
"18825","Z72335",7067,1106,10,1096,"15.5"
"18826","Z72342",2813,859,105,754,"26.8"
"18827","Z72346",295,45,0,45,"15.3"
"18828","Z72347",418,113,15,98,"23.4"
"18829","Z72348",1557,411,266,145," 9.3"
"18830","Z72351",272,59,0,59,"21.7"
"18831","Z72354",1102,182,20,162,"14.7"
"18832","Z72355",1140,130,54,76," 6.7"
"18833","Z72359",285,51,0,51,"17.9"
"18834","Z72360",3054,484,51,433,"14.2"
"18835","Z72364",6153,620,31,589," 9.6"
"18836","Z72365",1475,181,0,181,"12.3"
"18837","Z72366",1128,232,42,190,"16.8"
"18838","Z72368",696,115,41,74,"10.6"
"18839","Z72370",3471,424,21,403,"11.6"
"18840","Z72372",943,106,6,100,"10.6"
"18841","Z72373",687,153,10,143,"20.8"
"18842","Z72376",874,143,0,143,"16.4"
"18843","Z72386",787,63,5,58," 7.4"
"18844","Z72389",128,5,0,5," 3.9"
"18845","Z72390",4088,665,191,474,"11.6"
"18846","Z72392",253,39,17,22," 8.7"
"18847","Z72394",355,33,0,33," 9.3"
"18848","Z72395",459,49,0,49,"10.7"
"18849","Z72396",5751,626,51,575,"10.0"
"18850","Z72401",23676,2270,183,2087," 8.8"
"18851","Z72404",10350,640,83,557," 5.4"
"18852","Z72410",224,41,0,41,"18.3"
"18853","Z72411",1034,117,7,110,"10.6"
"18854","Z72415",553,97,22,75,"13.6"
"18855","Z72416",2748,455,40,415,"15.1"
"18856","Z72417",1732,176,14,162," 9.4"
"18857","Z72419",748,125,0,125,"16.7"
"18858","Z72421",227,22,0,22," 9.7"
"18859","Z72422",2729,544,111,433,"15.9"
"18860","Z72426",101,11,0,11,"10.9"
"18861","Z72432",2676,576,90,486,"18.2"
"18862","Z72433",1350,138,25,113," 8.4"
"18863","Z72434",1093,230,108,122,"11.2"
"18864","Z72435",233,51,9,42,"18.0"
"18865","Z72436",359,44,28,16," 4.5"
"18866","Z72437",1420,106,0,106," 7.5"
"18867","Z72438",1006,141,0,141,"14.0"
"18868","Z72440",124,37,23,14,"11.3"
"18869","Z72441",35,3,0,3," 8.6"
"18870","Z72442",1917,181,46,135," 7.0"
"18871","Z72444",889,239,52,187,"21.0"
"18872","Z72447",885,91,10,81," 9.2"
"18873","Z72450",15605,1211,100,1111," 7.1"
"18874","Z72454",2561,394,0,394,"15.4"
"18875","Z72455",5686,525,235,290," 5.1"
"18876","Z72456",217,28,5,23,"10.6"
"18877","Z72459",866,211,112,99,"11.4"
"18878","Z72460",459,118,28,90,"19.6"
"18879","Z72461",1815,284,28,256,"14.1"
"18880","Z72462",211,44,24,20," 9.5"
"18881","Z72466",800,231,123,108,"13.5"
"18882","Z72469",587,83,40,43," 7.3"
"18883","Z72471",528,74,6,68,"12.9"
"18884","Z72472",4218,529,28,501,"11.9"
"18885","Z72473",1264,130,18,112," 8.9"
"18886","Z72476",2893,272,54,218," 7.5"
"18887","Z72479",772,88,41,47," 6.1"
"18888","Z72501",11113,1286,176,1110,"10.0"
"18889","Z72512",1466,310,110,200,"13.6"
"18890","Z72513",1233,129,39,90," 7.3"
"18891","Z72519",1496,501,240,261,"17.4"
"18892","Z72521",2332,359,116,243,"10.4"
"18893","Z72524",165,44,22,22,"13.3"
"18894","Z72529",2959,921,431,490,"16.6"
"18895","Z72530",1189,577,434,143,"12.0"
"18896","Z72531",724,368,321,47," 6.5"
"18897","Z72532",932,245,86,159,"17.1"
"18898","Z72536",159,11,0,11," 6.9"
"18899","Z72537",446,211,123,88,"19.7"
"18900","Z72542",2690,1052,611,441,"16.4"
"18901","Z72543",6845,2078,1529,549," 8.0"
"18902","Z72554",1534,287,132,155,"10.1"
"18903","Z72556",1840,506,244,262,"14.2"
"18904","Z72560",5059,1323,886,437," 8.6"
"18905","Z72561",455,83,37,46,"10.1"
"18906","Z72566",342,91,15,76,"22.2"
"18907","Z72568",612,139,13,126,"20.6"
"18908","Z72576",2231,390,138,252,"11.3"
"18909","Z72581",670,194,148,46," 6.9"
"18910","Z72583",815,73,0,73," 9.0"
"18911","Z72601",13371,1330,125,1205," 9.0"
"18912","Z72616",4253,545,0,545,"12.8"
"18913","Z72619",1255,309,137,172,"13.7"
"18914","Z72626",755,206,89,117,"15.5"
"18915","Z72628",456,142,93,49,"10.7"
"18916","Z72629",412,188,57,131,"31.8"
"18917","Z72630",140,61,45,16,"11.4"
"18918","Z72631",2890,812,586,226," 7.8"
"18919","Z72632",2628,593,247,346,"13.2"
"18920","Z72633",854,93,20,73," 8.5"
"18921","Z72634",2173,427,196,231,"10.6"
"18922","Z72635",1470,135,20,115," 7.8"
"18923","Z72638",3185,532,131,401,"12.6"
"18924","Z72641",1492,370,174,196,"13.1"
"18925","Z72644",1469,329,131,198,"13.5"
"18926","Z72645",1208,421,165,256,"21.2"
"18927","Z72650",2440,847,298,549,"22.5"
"18928","Z72651",816,81,0,81," 9.9"
"18929","Z72653",14653,2111,843,1268," 8.7"
"18930","Z72655",310,125,30,95,"30.6"
"18931","Z72658",1222,312,174,138,"11.3"
"18932","Z72660",233,7,0,7," 3.0"
"18933","Z72661",307,150,85,65,"21.2"
"18934","Z72662",1433,243,99,144,"10.0"
"18935","Z72672",126,25,0,25,"19.8"
"18936","Z72675",829,251,109,142,"17.1"
"18937","Z72677",243,42,0,42,"17.3"
"18938","Z72685",629,153,77,76,"12.1"
"18939","Z72687",3257,899,265,634,"19.5"
"18940","Z72701",17743,1793,329,1464," 8.3"
"18941","Z72703",15406,1178,120,1058," 6.9"
"18942","Z72704",10445,1009,220,789," 7.6"
"18943","Z72712",18293,1607,157,1450," 7.9"
"18944","Z72714",5655,791,300,491," 8.7"
"18945","Z72715",8068,995,442,553," 6.9"
"18946","Z72718",719,34,7,27," 3.8"
"18947","Z72719",3479,105,10,95," 2.7"
"18948","Z72721",230,21,8,13," 5.7"
"18949","Z72722",1276,143,0,143,"11.2"
"18950","Z72727",2447,178,87,91," 3.7"
"18951","Z72730",3480,184,0,184," 5.3"
"18952","Z72732",2643,988,614,374,"14.2"
"18953","Z72734",2956,267,2,265," 9.0"
"18954","Z72736",2442,230,0,230," 9.4"
"18955","Z72738",1076,84,61,23," 2.1"
"18956","Z72740",4237,693,187,506,"11.9"
"18957","Z72744",2333,336,85,251,"10.8"
"18958","Z72745",4703,402,73,329," 7.0"
"18959","Z72751",2653,367,0,367,"13.8"
"18960","Z72753",3197,256,144,112," 3.5"
"18961","Z72756",16966,2348,734,1614," 9.5"
"18962","Z72758",14168,990,36,954," 6.7"
"18963","Z72761",8455,960,86,874,"10.3"
"18964","Z72762",14046,1048,125,923," 6.6"
"18965","Z72764",19149,1313,82,1231," 6.4"
"18966","Z72773",442,30,0,30," 6.8"
"18967","Z72774",2674,302,102,200," 7.5"
"18968","Z72801",7354,876,68,808,"11.0"
"18969","Z72802",8938,984,306,678," 7.6"
"18970","Z72821",958,153,8,145,"15.1"
"18971","Z72823",2654,419,65,354,"13.3"
"18972","Z72824",696,151,21,130,"18.7"
"18973","Z72830",6417,569,200,369," 5.8"
"18974","Z72833",1852,468,119,349,"18.8"
"18975","Z72834",4510,490,217,273," 6.1"
"18976","Z72835",413,49,32,17," 4.1"
"18977","Z72837",3444,483,204,279," 8.1"
"18978","Z72840",867,43,23,20," 2.3"
"18979","Z72842",634,187,20,167,"26.3"
"18980","Z72843",1128,192,117,75," 6.6"
"18981","Z72845",577,42,8,34," 5.9"
"18982","Z72847",1191,102,41,61," 5.1"
"18983","Z72853",995,242,19,223,"22.4"
"18984","Z72854",639,260,142,118,"18.5"
"18985","Z72855",2972,606,158,448,"15.1"
"18986","Z72856",285,80,55,25," 8.8"
"18987","Z72857",917,444,250,194,"21.2"
"18988","Z72858",1351,95,0,95," 7.0"
"18989","Z72863",671,146,74,72,"10.7"
"18990","Z72865",586,59,4,55," 9.4"
"18991","Z72901",10251,1424,95,1329,"13.0"
"18992","Z72903",12864,1303,143,1160," 9.0"
"18993","Z72904",8593,1196,0,1196,"13.9"
"18994","Z72908",6246,664,63,601," 9.6"
"18995","Z72916",3071,187,0,187," 6.1"
"18996","Z72921",5608,438,34,404," 7.2"
"18997","Z72923",2176,225,0,225,"10.3"
"18998","Z72926",320,49,8,41,"12.8"
"18999","Z72927",3864,361,68,293," 7.6"
"19000","Z72928",238,38,26,12," 5.0"
"19001","Z72932",922,99,26,73," 7.9"
"19002","Z72933",2002,182,25,157," 7.8"
"19003","Z72934",499,189,189,0," 0.0"
"19004","Z72936",5862,594,76,518," 8.8"
"19005","Z72937",1619,193,73,120," 7.4"
"19006","Z72940",1074,83,25,58," 5.4"
"19007","Z72941",2174,135,0,135," 6.2"
"19008","Z72943",1190,231,29,202,"17.0"
"19009","Z72944",1175,179,55,124,"10.6"
"19010","Z72946",1733,290,117,173,"10.0"
"19011","Z72947",2203,356,73,283,"12.8"
"19012","Z72949",4426,712,181,531,"12.0"
"19013","Z72951",502,61,12,49," 9.8"
"19014","Z72952",1193,6,0,6," 0.5"
"19015","Z72956",14053,1237,25,1212," 8.6"
"19016","Z72958",3625,828,199,629,"17.4"
"19017","Z72959",1100,66,19,47," 4.3"
"19018","Z73002",483,97,3,94,"19.5"
"19019","Z73003",8958,562,0,562," 6.3"
"19020","Z73004",350,39,3,36,"10.3"
"19021","Z73005",3970,757,60,697,"17.6"
"19022","Z73006",1686,334,31,303,"18.0"
"19023","Z73007",1074,229,87,142,"13.2"
"19024","Z73008",8729,955,20,935,"10.7"
"19025","Z73009",582,135,28,107,"18.4"
"19026","Z73010",7049,700,70,630," 8.9"
"19027","Z73013",19047,1028,84,944," 5.0"
"19028","Z73014",734,85,18,67," 9.1"
"19029","Z73015",1484,414,78,336,"22.6"
"19030","Z73016",713,108,5,103,"14.4"
"19031","Z73017",817,175,13,162,"19.8"
"19032","Z73018",9281,1409,67,1342,"14.5"
"19033","Z73020",8742,571,29,542," 6.2"
"19034","Z73021",206,39,0,39,"18.9"
"19035","Z73025",4376,187,26,161," 3.7"
"19036","Z73026",4352,319,52,267," 6.1"
"19037","Z73028",1726,363,143,220,"12.7"
"19038","Z73029",821,170,13,157,"19.1"
"19039","Z73030",1865,288,79,209,"11.2"
"19040","Z73033",195,40,0,40,"20.5"
"19041","Z73034",16761,1045,14,1031," 6.2"
"19042","Z73036",7407,992,38,954,"12.9"
"19043","Z73038",1209,444,224,220,"18.2"
"19044","Z73040",819,176,3,173,"21.1"
"19045","Z73042",503,124,6,118,"23.5"
"19046","Z73043",94,31,0,31,"33.0"
"19047","Z73044",8557,1004,71,933,"10.9"
"19048","Z73045",4112,373,57,316," 7.7"
"19049","Z73047",1962,574,290,284,"14.5"
"19050","Z73048",1000,227,58,169,"16.9"
"19051","Z73049",2411,275,15,260,"10.8"
"19052","Z73051",3025,351,18,333,"11.0"
"19053","Z73052",2921,363,26,337,"11.5"
"19054","Z73053",348,69,11,58,"16.7"
"19055","Z73054",1636,202,44,158," 9.7"
"19056","Z73055",4488,588,101,487,"10.9"
"19057","Z73057",1089,141,2,139,"12.8"
"19058","Z73059",1194,198,27,171,"14.3"
"19059","Z73061",733,54,7,47," 6.4"
"19060","Z73062",807,214,23,191,"23.7"
"19061","Z73063",282,24,0,24," 8.5"
"19062","Z73064",8179,348,42,306," 3.7"
"19063","Z73065",2777,141,13,128," 4.6"
"19064","Z73066",139,38,18,20,"14.4"
"19065","Z73067",967,129,8,121,"12.5"
"19066","Z73068",4732,517,32,485,"10.2"
"19067","Z73069",11646,1729,98,1631,"14.0"
"19068","Z73071",17935,2175,209,1966,"11.0"
"19069","Z73072",18275,1935,193,1742," 9.5"
"19070","Z73074",524,119,14,105,"20.0"
"19071","Z73075",4434,912,9,903,"20.4"
"19072","Z73078",3007,116,0,116," 3.9"
"19073","Z73079",280,57,8,49,"17.5"
"19074","Z73080",3972,347,69,278," 7.0"
"19075","Z73082",1310,285,21,264,"20.2"
"19076","Z73084",3063,329,21,308,"10.1"
"19077","Z73086",4400,1036,528,508,"11.5"
"19078","Z73089",4238,190,1,189," 4.5"
"19079","Z73092",469,83,22,61,"13.0"
"19080","Z73093",1079,100,8,92," 8.5"
"19081","Z73096",5923,684,50,634,"10.7"
"19082","Z73097",79,20,0,20,"25.3"
"19083","Z73098",2173,406,0,406,"18.7"
"19084","Z73099",23431,1359,77,1282," 5.5"
"19085","Z73102",1255,200,19,181,"14.4"
"19086","Z73103",2912,512,26,486,"16.7"
"19087","Z73104",1225,184,22,162,"13.2"
"19088","Z73105",3556,723,6,717,"20.2"
"19089","Z73106",5495,1033,0,1033,"18.8"
"19090","Z73107",12444,1617,6,1611,"12.9"
"19091","Z73108",5532,940,0,940,"17.0"
"19092","Z73109",8193,1224,52,1172,"14.3"
"19093","Z73110",15800,1506,36,1470," 9.3"
"19094","Z73111",6211,1361,12,1349,"21.7"
"19095","Z73112",16380,1722,9,1713,"10.5"
"19096","Z73114",8252,1094,67,1027,"12.4"
"19097","Z73115",9403,830,25,805," 8.6"
"19098","Z73116",5000,481,29,452," 9.0"
"19099","Z73117",3026,633,4,629,"20.8"
"19100","Z73118",7366,1186,12,1174,"15.9"
"19101","Z73119",11422,1444,56,1388,"12.2"
"19102","Z73120",19459,1654,111,1543," 7.9"
"19103","Z73121",1474,161,1,160,"10.9"
"19104","Z73122",5864,629,0,629,"10.7"
"19105","Z73127",11299,2356,90,2266,"20.1"
"19106","Z73128",1824,271,50,221,"12.1"
"19107","Z73129",7263,1084,22,1062,"14.6"
"19108","Z73130",8610,697,26,671," 7.8"
"19109","Z73131",1535,174,5,169,"11.0"
"19110","Z73132",12279,1328,70,1258,"10.2"
"19111","Z73134",3089,710,43,667,"21.6"
"19112","Z73135",8646,929,0,929,"10.7"
"19113","Z73139",8170,656,0,656," 8.0"
"19114","Z73141",1222,171,4,167,"13.7"
"19115","Z73142",5887,489,56,433," 7.4"
"19116","Z73145",539,74,0,74,"13.7"
"19117","Z73149",2035,195,27,168," 8.3"
"19118","Z73150",1785,203,4,199,"11.1"
"19119","Z73159",12744,1003,0,1003," 7.9"
"19120","Z73160",22516,1316,82,1234," 5.5"
"19121","Z73162",12402,726,8,718," 5.8"
"19122","Z73169",790,78,0,78," 9.9"
"19123","Z73170",13771,429,12,417," 3.0"
"19124","Z73173",586,34,0,34," 5.8"
"19125","Z73179",1430,150,8,142," 9.9"
"19126","Z73401",15443,2291,239,2052,"13.3"
"19127","Z73430",727,316,210,106,"14.6"
"19128","Z73432",439,88,26,62,"14.1"
"19129","Z73433",1275,208,11,197,"15.5"
"19130","Z73438",2013,606,31,575,"28.6"
"19131","Z73439",6205,3203,2615,588," 9.5"
"19132","Z73442",211,49,2,47,"22.3"
"19133","Z73443",1575,211,17,194,"12.3"
"19134","Z73446",3641,780,333,447,"12.3"
"19135","Z73447",495,94,17,77,"15.6"
"19136","Z73448",2709,700,145,555,"20.5"
"19137","Z73449",1623,548,403,145," 8.9"
"19138","Z73450",616,87,31,56," 9.1"
"19139","Z73453",253,55,15,40,"15.8"
"19140","Z73456",1046,273,18,255,"24.4"
"19141","Z73459",489,128,27,101,"20.7"
"19142","Z73460",2369,424,148,276,"11.7"
"19143","Z73463",1559,282,35,247,"15.8"
"19144","Z73481",480,83,20,63,"13.1"
"19145","Z73491",313,27,3,24," 7.7"
"19146","Z73501",8860,1696,42,1654,"18.7"
"19147","Z73503",1711,253,0,253,"14.8"
"19148","Z73505",21844,3211,80,3131,"14.3"
"19149","Z73507",10669,1845,69,1776,"16.6"
"19150","Z73521",9875,1466,42,1424,"14.4"
"19151","Z73527",2097,172,0,172," 8.2"
"19152","Z73528",281,49,0,49,"17.4"
"19153","Z73529",2508,379,27,352,"14.0"
"19154","Z73530",278,49,3,46,"16.5"
"19155","Z73532",258,51,4,47,"18.2"
"19156","Z73533",13147,1778,119,1659,"12.6"
"19157","Z73538",2316,196,34,162," 7.0"
"19158","Z73541",1166,185,4,181,"15.5"
"19159","Z73542",2303,597,0,597,"25.9"
"19160","Z73546",618,166,8,158,"25.6"
"19161","Z73547",832,143,35,108,"13.0"
"19162","Z73550",1259,297,33,264,"21.0"
"19163","Z73552",696,143,8,135,"19.4"
"19164","Z73554",1697,339,24,315,"18.6"
"19165","Z73557",225,106,28,78,"34.7"
"19166","Z73560",381,134,3,131,"34.4"
"19167","Z73564",386,148,15,133,"34.5"
"19168","Z73566",945,230,11,219,"23.2"
"19169","Z73567",330,66,0,66,"20.0"
"19170","Z73568",657,202,30,172,"26.2"
"19171","Z73572",1659,218,2,216,"13.0"
"19172","Z73573",1295,288,80,208,"16.1"
"19173","Z73601",4384,855,13,842,"19.2"
"19174","Z73620",427,88,3,85,"19.9"
"19175","Z73624",916,151,14,137,"15.0"
"19176","Z73625",392,131,71,60,"15.3"
"19177","Z73626",523,133,74,59,"11.3"
"19178","Z73627",299,82,28,54,"18.1"
"19179","Z73632",1629,218,0,218,"13.4"
"19180","Z73641",375,80,15,65,"17.3"
"19181","Z73642",119,36,15,21,"17.6"
"19182","Z73644",6582,1488,13,1475,"22.4"
"19183","Z73645",756,191,16,175,"23.1"
"19184","Z73647",345,54,10,44,"12.8"
"19185","Z73650",454,162,7,155,"34.1"
"19186","Z73651",2051,324,14,310,"15.1"
"19187","Z73654",428,124,6,118,"27.6"
"19188","Z73655",621,248,132,116,"18.7"
"19189","Z73659",96,20,4,16,"16.7"
"19190","Z73660",247,65,15,50,"20.2"
"19191","Z73661",197,27,0,27,"13.7"
"19192","Z73662",2360,541,54,487,"20.6"
"19193","Z73663",574,134,12,122,"21.3"
"19194","Z73664",556,88,9,79,"14.2"
"19195","Z73667",368,115,10,105,"28.5"
"19196","Z73669",756,110,9,101,"13.4"
"19197","Z73701",10365,1400,9,1391,"13.4"
"19198","Z73703",13001,1109,9,1100," 8.5"
"19199","Z73717",3213,643,145,498,"15.5"
"19200","Z73718",273,20,1,19," 7.0"
"19201","Z73720",119,14,0,14,"11.8"
"19202","Z73724",675,308,131,177,"26.2"
"19203","Z73728",1078,249,29,220,"20.4"
"19204","Z73729",304,60,9,51,"16.8"
"19205","Z73730",322,54,0,54,"16.8"
"19206","Z73734",361,67,8,59,"16.3"
"19207","Z73736",232,29,5,24,"10.3"
"19208","Z73737",1719,289,45,244,"14.2"
"19209","Z73739",182,36,5,31,"17.0"
"19210","Z73741",392,70,33,37," 9.4"
"19211","Z73742",1667,150,8,142," 8.5"
"19212","Z73749",364,165,114,51,"14.0"
"19213","Z73750",3055,266,11,255," 8.3"
"19214","Z73753",155,15,0,15," 9.7"
"19215","Z73754",541,72,3,69,"12.8"
"19216","Z73755",565,190,78,112,"19.8"
"19217","Z73757",83,7,4,3," 3.6"
"19218","Z73759",815,141,36,105,"12.9"
"19219","Z73760",189,10,0,10," 5.3"
"19220","Z73761",231,27,11,16," 6.9"
"19221","Z73762",888,82,18,64," 7.2"
"19222","Z73763",792,132,26,106,"13.4"
"19223","Z73766",565,75,9,66,"11.7"
"19224","Z73768",618,84,28,56," 9.1"
"19225","Z73771",284,62,12,50,"17.6"
"19226","Z73772",1813,345,22,323,"17.8"
"19227","Z73773",793,89,0,89,"11.2"
"19228","Z73801",6698,1108,23,1085,"16.2"
"19229","Z73832",515,107,13,94,"18.3"
"19230","Z73834",852,120,17,103,"12.1"
"19231","Z73838",220,63,11,52,"23.6"
"19232","Z73840",344,42,8,34," 9.9"
"19233","Z73842",291,97,22,75,"25.8"
"19234","Z73843",502,123,16,107,"21.3"
"19235","Z73844",156,48,0,48,"30.8"
"19236","Z73848",1070,326,43,283,"26.4"
"19237","Z73852",1130,183,13,170,"15.0"
"19238","Z73857",344,66,38,28," 8.1"
"19239","Z73858",905,284,8,276,"30.5"
"19240","Z73859",713,74,20,54," 7.6"
"19241","Z73860",924,283,47,236,"25.5"
"19242","Z73931",276,55,21,34,"12.3"
"19243","Z73932",1119,273,0,273,"24.4"
"19244","Z73933",1051,353,42,311,"29.6"
"19245","Z73938",293,56,2,54,"18.4"
"19246","Z73939",609,135,12,123,"20.2"
"19247","Z73942",4941,379,19,360," 7.3"
"19248","Z73944",241,71,11,60,"24.9"
"19249","Z73945",1268,179,20,159,"12.5"
"19250","Z73947",307,132,6,126,"41.0"
"19251","Z73950",696,167,0,167,"24.0"
"19252","Z74002",968,163,39,124,"12.8"
"19253","Z74003",7103,1175,30,1145,"16.1"
"19254","Z74006",11710,948,71,877," 7.5"
"19255","Z74008",9508,720,33,687," 7.2"
"19256","Z74010",4569,717,86,631,"13.8"
"19257","Z74011",10392,573,65,508," 4.9"
"19258","Z74012",23235,1453,33,1420," 6.1"
"19259","Z74014",13688,745,49,696," 5.1"
"19260","Z74015",3554,293,23,270," 7.6"
"19261","Z74016",2599,339,12,327,"12.6"
"19262","Z74017",12041,965,130,835," 6.9"
"19263","Z74019",7412,449,56,393," 5.3"
"19264","Z74020",3380,579,123,456,"13.5"
"19265","Z74021",7237,375,72,303," 4.2"
"19266","Z74022",856,76,4,72," 8.4"
"19267","Z74023",5191,868,46,822,"15.8"
"19268","Z74027",474,96,24,72,"15.2"
"19269","Z74028",775,119,8,111,"14.3"
"19270","Z74029",2306,251,0,251,"10.9"
"19271","Z74030",1758,296,14,282,"16.0"
"19272","Z74032",1058,188,94,94," 8.9"
"19273","Z74033",3829,255,18,237," 6.2"
"19274","Z74035",1708,314,36,278,"16.3"
"19275","Z74036",2751,252,65,187," 6.8"
"19276","Z74037",6120,388,105,283," 4.6"
"19277","Z74038",943,117,10,107,"11.3"
"19278","Z74041",940,93,0,93," 9.9"
"19279","Z74044",3217,410,49,361,"11.2"
"19280","Z74045",199,41,7,34,"17.1"
"19281","Z74047",2827,374,28,346,"12.2"
"19282","Z74048",2780,423,40,383,"13.8"
"19283","Z74052",603,137,8,129,"21.4"
"19284","Z74053",1753,120,0,120," 6.8"
"19285","Z74055",15990,808,31,777," 4.9"
"19286","Z74056",2938,587,138,449,"15.3"
"19287","Z74058",2091,468,75,393,"18.8"
"19288","Z74059",2248,157,11,146," 6.5"
"19289","Z74060",310,60,12,48,"15.5"
"19290","Z74061",927,91,15,76," 8.2"
"19291","Z74062",540,116,48,68,"12.6"
"19292","Z74063",12868,1203,89,1114," 8.7"
"19293","Z74066",13328,1417,57,1360,"10.2"
"19294","Z74070",5726,564,74,490," 8.6"
"19295","Z74072",858,120,2,118,"13.8"
"19296","Z74073",2424,264,51,213," 8.8"
"19297","Z74074",13007,1560,83,1477,"11.4"
"19298","Z74075",11731,1337,75,1262,"10.8"
"19299","Z74079",2136,299,16,283,"13.2"
"19300","Z74080",1241,83,23,60," 4.8"
"19301","Z74081",802,144,28,116,"14.5"
"19302","Z74083",484,73,0,73,"15.1"
"19303","Z74084",329,76,5,71,"21.6"
"19304","Z74085",1199,226,20,206,"17.2"
"19305","Z74103",263,22,13,9," 3.4"
"19306","Z74104",6439,834,22,812,"12.6"
"19307","Z74105",14617,2006,236,1770,"12.1"
"19308","Z74106",8690,1539,72,1467,"16.9"
"19309","Z74107",9159,1089,79,1010,"11.0"
"19310","Z74108",2980,290,16,274," 9.2"
"19311","Z74110",6218,1172,88,1084,"17.4"
"19312","Z74112",10409,1240,43,1197,"11.5"
"19313","Z74114",8292,1029,115,914,"11.0"
"19314","Z74115",9456,1272,52,1220,"12.9"
"19315","Z74116",1787,349,13,336,"18.8"
"19316","Z74117",58,10,0,10,"17.2"
"19317","Z74119",2990,469,82,387,"12.9"
"19318","Z74120",2978,560,25,535,"18.0"
"19319","Z74126",4770,1192,18,1174,"24.6"
"19320","Z74127",7808,1018,43,975,"12.5"
"19321","Z74128",5105,603,12,591,"11.6"
"19322","Z74129",7923,749,19,730," 9.2"
"19323","Z74130",904,183,10,173,"19.1"
"19324","Z74131",1259,109,5,104," 8.3"
"19325","Z74132",3649,337,25,312," 8.6"
"19326","Z74133",20619,1546,114,1432," 6.9"
"19327","Z74134",6536,678,19,659,"10.1"
"19328","Z74135",10982,1129,102,1027," 9.4"
"19329","Z74136",15873,2118,241,1877,"11.8"
"19330","Z74137",11698,897,118,779," 6.7"
"19331","Z74145",8455,739,20,719," 8.5"
"19332","Z74146",6109,586,36,550," 9.0"
"19333","Z74301",5542,1102,311,791,"14.3"
"19334","Z74331",6247,3320,2759,561," 9.0"
"19335","Z74332",821,183,23,160,"19.5"
"19336","Z74337",2285,295,90,205," 9.0"
"19337","Z74338",2301,365,45,320,"13.9"
"19338","Z74342",2435,1286,826,460,"18.9"
"19339","Z74343",1465,266,135,131," 8.9"
"19340","Z74344",8616,2176,1384,792," 9.2"
"19341","Z74346",3824,884,358,526,"13.8"
"19342","Z74347",1264,330,125,205,"16.2"
"19343","Z74349",274,131,105,26," 9.5"
"19344","Z74350",444,107,55,52,"11.7"
"19345","Z74352",3024,593,242,351,"11.6"
"19346","Z74354",7942,1004,51,953,"12.0"
"19347","Z74358",107,31,0,31,"29.0"
"19348","Z74360",26,17,0,17,"65.4"
"19349","Z74361",7408,1049,209,840,"11.3"
"19350","Z74363",1130,105,8,97," 8.6"
"19351","Z74364",716,116,26,90,"12.6"
"19352","Z74365",2265,465,245,220," 9.7"
"19353","Z74368",45,12,0,12,"26.7"
"19354","Z74369",860,139,18,121,"14.1"
"19355","Z74370",1688,331,151,180,"10.7"
"19356","Z74401",8078,1377,60,1317,"16.3"
"19357","Z74403",13767,1890,124,1766,"12.8"
"19358","Z74421",1993,181,10,171," 8.6"
"19359","Z74423",414,63,8,55,"13.3"
"19360","Z74425",777,301,221,80,"10.3"
"19361","Z74426",5979,2096,1294,802,"13.4"
"19362","Z74427",1279,886,720,166,"13.0"
"19363","Z74428",523,61,16,45," 8.6"
"19364","Z74429",5570,447,50,397," 7.1"
"19365","Z74431",367,50,3,47,"12.8"
"19366","Z74432",7464,2983,2074,909,"12.2"
"19367","Z74434",3798,415,46,369," 9.7"
"19368","Z74435",1857,654,423,231,"12.4"
"19369","Z74436",2161,349,28,321,"14.9"
"19370","Z74437",4806,911,133,778,"16.2"
"19371","Z74441",2287,440,173,267,"11.7"
"19372","Z74442",432,76,16,60,"13.9"
"19373","Z74445",1293,105,3,102," 7.9"
"19374","Z74446",238,16,0,16," 6.7"
"19375","Z74447",7971,1402,64,1338,"16.8"
"19376","Z74451",2371,911,628,283,"11.9"
"19377","Z74454",1372,118,17,101," 7.4"
"19378","Z74462",4300,1332,757,575,"13.4"
"19379","Z74464",13099,2496,279,2217,"16.9"
"19380","Z74467",7242,1278,421,857,"11.8"
"19381","Z74469",960,123,6,117,"12.2"
"19382","Z74470",827,132,38,94,"11.4"
"19383","Z74471",756,171,48,123,"16.3"
"19384","Z74501",13014,1883,303,1580,"12.1"
"19385","Z74522",126,14,1,13,"10.3"
"19386","Z74523",3017,547,82,465,"15.4"
"19387","Z74525",4458,719,190,529,"11.9"
"19388","Z74533",350,38,11,27," 7.7"
"19389","Z74536",952,226,89,137,"14.4"
"19390","Z74538",2019,349,62,287,"14.2"
"19391","Z74546",408,78,14,64,"15.7"
"19392","Z74547",1651,255,49,206,"12.5"
"19393","Z74552",513,79,13,66,"12.9"
"19394","Z74553",567,112,15,97,"17.1"
"19395","Z74554",889,102,18,84," 9.4"
"19396","Z74558",241,36,7,29,"12.0"
"19397","Z74561",1044,167,10,157,"15.0"
"19398","Z74565",306,50,7,43,"14.1"
"19399","Z74569",356,98,22,76,"21.3"
"19400","Z74570",576,154,35,119,"20.7"
"19401","Z74574",576,95,33,62,"10.8"
"19402","Z74578",2929,483,149,334,"11.4"
"19403","Z74601",9125,1533,67,1466,"16.1"
"19404","Z74604",5611,634,71,563,"10.0"
"19405","Z74630",339,70,6,64,"18.9"
"19406","Z74631",3881,690,37,653,"16.8"
"19407","Z74632",383,121,76,45,"11.7"
"19408","Z74633",217,34,13,21," 9.7"
"19409","Z74637",1093,324,25,299,"27.4"
"19410","Z74641",457,155,103,52,"11.4"
"19411","Z74646",125,8,8,0," 0.0"
"19412","Z74647",1633,246,22,224,"13.7"
"19413","Z74651",322,42,4,38,"11.8"
"19414","Z74652",498,180,39,141,"28.3"
"19415","Z74653",1723,260,18,242,"14.0"
"19416","Z74701",10213,1378,11,1367,"13.4"
"19417","Z74723",771,147,60,87,"11.3"
"19418","Z74726",1139,197,46,151,"13.3"
"19419","Z74727",997,194,56,138,"13.8"
"19420","Z74728",5350,1016,490,526," 9.8"
"19421","Z74729",1355,176,57,119," 8.8"
"19422","Z74730",1852,185,27,158," 8.5"
"19423","Z74731",963,228,157,71," 7.4"
"19424","Z74733",1269,193,67,126," 9.9"
"19425","Z74734",555,71,22,49," 8.8"
"19426","Z74740",1012,155,28,127,"12.5"
"19427","Z74741",507,114,56,58,"11.4"
"19428","Z74743",4141,890,91,799,"19.3"
"19429","Z74745",4650,660,46,614,"13.2"
"19430","Z74750",179,33,2,31,"17.3"
"19431","Z74754",195,50,15,35,"17.9"
"19432","Z74756",456,115,38,77,"16.9"
"19433","Z74764",1682,299,17,282,"16.8"
"19434","Z74801",9912,1377,107,1270,"12.8"
"19435","Z74804",8238,677,67,610," 7.4"
"19436","Z74820",13861,1605,79,1526,"11.0"
"19437","Z74824",567,75,8,67,"11.8"
"19438","Z74825",905,166,26,140,"15.5"
"19439","Z74826",535,120,19,101,"18.9"
"19440","Z74829",340,115,2,113,"33.2"
"19441","Z74830",111,20,2,18,"16.2"
"19442","Z74831",399,83,8,75,"18.8"
"19443","Z74832",373,50,3,47,"12.6"
"19444","Z74834",3173,364,52,312," 9.8"
"19445","Z74839",393,151,47,104,"26.5"
"19446","Z74848",3427,968,124,844,"24.6"
"19447","Z74849",1443,288,47,241,"16.7"
"19448","Z74851",3409,331,18,313," 9.2"
"19449","Z74852",637,101,13,88,"13.8"
"19450","Z74854",758,170,25,145,"19.1"
"19451","Z74856",347,59,19,40,"11.5"
"19452","Z74857",3378,361,74,287," 8.5"
"19453","Z74859",2760,626,68,558,"20.2"
"19454","Z74860",812,184,25,159,"19.6"
"19455","Z74864",2347,386,54,332,"14.1"
"19456","Z74865",708,102,13,89,"12.6"
"19457","Z74867",479,101,20,81,"16.9"
"19458","Z74868",5740,899,122,777,"13.5"
"19459","Z74871",1038,191,31,160,"15.4"
"19460","Z74872",1566,245,20,225,"14.4"
"19461","Z74873",5129,630,16,614,"12.0"
"19462","Z74875",570,108,7,101,"17.7"
"19463","Z74878",733,155,36,119,"16.2"
"19464","Z74880",1120,275,11,264,"23.6"
"19465","Z74881",1996,276,34,242,"12.1"
"19466","Z74883",1163,303,60,243,"20.9"
"19467","Z74884",3122,961,236,725,"23.2"
"19468","Z74901",920,117,0,117,"12.7"
"19469","Z74902",1743,184,8,176,"10.1"
"19470","Z74930",872,100,13,87,"10.0"
"19471","Z74932",1015,131,20,111,"10.9"
"19472","Z74936",507,77,10,67,"13.2"
"19473","Z74937",2387,365,23,342,"14.3"
"19474","Z74939",448,151,86,65,"14.5"
"19475","Z74940",1131,258,37,221,"19.5"
"19476","Z74941",1242,164,22,142,"11.4"
"19477","Z74944",521,87,22,65,"12.5"
"19478","Z74946",69,17,2,15,"21.7"
"19479","Z74948",5327,723,63,660,"12.4"
"19480","Z74951",664,146,8,138,"20.8"
"19481","Z74953",4903,671,51,620,"12.6"
"19482","Z74954",1947,232,0,232,"11.9"
"19483","Z74955",6588,974,125,849,"12.9"
"19484","Z74956",812,94,15,79," 9.7"
"19485","Z74957",619,181,89,92,"14.9"
"19486","Z74959",3097,489,67,422,"13.6"
"19487","Z74960",5567,765,115,650,"11.7"
"19488","Z74962",2552,651,336,315,"12.3"
"19489","Z74963",313,66,12,54,"17.3"
"19490","Z74964",1121,175,29,146,"13.0"
"19491","Z74965",2113,252,36,216,"10.2"
"19492","Z74966",1661,317,111,206,"12.4"
"19493","Z75001",8983,956,86,870," 9.7"
"19494","Z75002",22414,361,0,361," 1.6"
"19495","Z75006",18153,708,10,698," 3.8"
"19496","Z75007",19350,591,43,548," 2.8"
"19497","Z75009",3247,238,6,232," 7.1"
"19498","Z75010",9952,624,20,604," 6.1"
"19499","Z75013",11743,240,0,240," 2.0"
"19500","Z75019",15340,712,116,596," 3.9"
"19501","Z75020",10337,1437,268,1169,"11.3"
"19502","Z75021",3483,254,64,190," 5.5"
"19503","Z75022",7492,148,30,118," 1.6"
"19504","Z75023",18838,727,73,654," 3.5"
"19505","Z75024",17987,954,91,863," 4.8"
"19506","Z75025",19597,589,36,553," 2.8"
"19507","Z75028",15561,618,164,454," 2.9"
"19508","Z75032",11276,728,33,695," 6.2"
"19509","Z75034",30321,1686,85,1601," 5.3"
"19510","Z75035",18597,383,44,339," 1.8"
"19511","Z75038",13495,1258,0,1258," 9.3"
"19512","Z75039",8326,624,13,611," 7.3"
"19513","Z75040",19306,1267,10,1257," 6.5"
"19514","Z75041",10283,668,9,659," 6.4"
"19515","Z75042",12287,691,0,691," 5.6"
"19516","Z75043",22328,1662,45,1617," 7.2"
"19517","Z75044",15760,695,20,675," 4.3"
"19518","Z75048",7429,112,0,112," 1.5"
"19519","Z75050",16628,1605,3,1602," 9.6"
"19520","Z75051",14191,1105,52,1053," 7.4"
"19521","Z75052",30091,1398,0,1398," 4.6"
"19522","Z75054",2273,33,0,33," 1.5"
"19523","Z75056",20051,956,72,884," 4.4"
"19524","Z75057",5389,385,140,245," 4.5"
"19525","Z75058",1048,97,23,74," 7.1"
"19526","Z75060",15393,839,29,810," 5.3"
"19527","Z75061",19537,2105,63,2042,"10.5"
"19528","Z75062",17649,1295,40,1255," 7.1"
"19529","Z75063",16714,721,68,653," 3.9"
"19530","Z75065",4783,461,62,399," 8.3"
"19531","Z75067",27126,2028,91,1937," 7.1"
"19532","Z75068",15266,769,31,738," 4.8"
"19533","Z75069",14403,1047,0,1047," 7.3"
"19534","Z75070",30123,1189,13,1176," 3.9"
"19535","Z75071",14688,615,37,578," 3.9"
"19536","Z75074",16867,770,42,728," 4.3"
"19537","Z75075",14182,534,0,534," 3.8"
"19538","Z75076",4230,1154,765,389," 9.2"
"19539","Z75077",13460,578,0,578," 4.3"
"19540","Z75078",4863,262,63,199," 4.1"
"19541","Z75080",18949,976,75,901," 4.8"
"19542","Z75081",14916,1103,27,1076," 7.2"
"19543","Z75082",8519,228,0,228," 2.7"
"19544","Z75087",11000,555,45,510," 4.6"
"19545","Z75088",9043,372,30,342," 3.8"
"19546","Z75089",10146,437,0,437," 4.3"
"19547","Z75090",9002,888,157,731," 8.1"
"19548","Z75092",10996,1143,193,950," 8.6"
"19549","Z75093",20446,1016,106,910," 4.5"
"19550","Z75094",6010,11,0,11," 0.2"
"19551","Z75098",16984,774,0,774," 4.6"
"19552","Z75102",582,125,78,47," 8.1"
"19553","Z75103",5844,928,176,752,"12.9"
"19554","Z75104",17052,987,121,866," 5.1"
"19555","Z75109",1788,219,165,54," 3.0"
"19556","Z75110",11339,1167,61,1106," 9.8"
"19557","Z75114",1809,254,17,237,"13.1"
"19558","Z75115",19893,1317,0,1317," 6.6"
"19559","Z75116",7264,385,5,380," 5.2"
"19560","Z75117",1677,242,34,208,"12.4"
"19561","Z75119",9986,760,74,686," 6.9"
"19562","Z75124",1865,421,128,293,"15.7"
"19563","Z75125",2183,154,81,73," 3.3"
"19564","Z75126",12079,569,30,539," 4.5"
"19565","Z75127",691,112,40,72,"10.4"
"19566","Z75132",402,23,0,23," 5.7"
"19567","Z75134",7463,436,0,436," 5.8"
"19568","Z75135",2039,136,0,136," 6.7"
"19569","Z75137",7311,330,9,321," 4.4"
"19570","Z75140",2783,526,145,381,"13.7"
"19571","Z75141",1391,85,0,85," 6.1"
"19572","Z75142",6636,759,92,667,"10.1"
"19573","Z75143",7446,1617,764,853,"11.5"
"19574","Z75144",1689,398,204,194,"11.5"
"19575","Z75146",7071,427,28,399," 5.6"
"19576","Z75147",2990,472,162,310,"10.4"
"19577","Z75148",3315,1176,664,512,"15.4"
"19578","Z75149",19743,1401,0,1401," 7.1"
"19579","Z75150",23733,2058,23,2035," 8.6"
"19580","Z75152",1638,90,0,90," 5.5"
"19581","Z75154",13163,894,30,864," 6.6"
"19582","Z75155",1009,113,34,79," 7.8"
"19583","Z75156",9015,3039,2039,1000,"11.1"
"19584","Z75157",155,36,4,32,"20.6"
"19585","Z75158",1564,117,24,93," 5.9"
"19586","Z75159",5598,207,21,186," 3.3"
"19587","Z75160",8952,899,135,764," 8.5"
"19588","Z75161",2558,225,2,223," 8.7"
"19589","Z75163",1678,771,586,185,"11.0"
"19590","Z75164",219,27,0,27,"12.3"
"19591","Z75165",15082,968,41,927," 6.1"
"19592","Z75166",1246,58,0,58," 4.7"
"19593","Z75167",3428,247,13,234," 6.8"
"19594","Z75169",6204,1515,391,1124,"18.1"
"19595","Z75172",1274,179,0,179,"14.1"
"19596","Z75173",1698,288,41,247,"14.5"
"19597","Z75181",8190,129,10,119," 1.5"
"19598","Z75189",7848,472,120,352," 4.5"
"19599","Z75201",8258,1251,138,1113,"13.5"
"19600","Z75202",1668,265,60,205,"12.3"
"19601","Z75203",6916,985,13,972,"14.1"
"19602","Z75204",17789,2107,295,1812,"10.2"
"19603","Z75205",10037,996,185,811," 8.1"
"19604","Z75206",22733,2170,221,1949," 8.6"
"19605","Z75207",1381,86,0,86," 6.2"
"19606","Z75208",11121,1061,24,1037," 9.3"
"19607","Z75209",7204,705,157,548," 7.6"
"19608","Z75210",3124,606,0,606,"19.4"
"19609","Z75211",22939,1673,4,1669," 7.3"
"19610","Z75212",7901,656,22,634," 8.0"
"19611","Z75214",17435,1808,21,1787,"10.2"
"19612","Z75215",7495,1670,13,1657,"22.1"
"19613","Z75217",24843,2430,68,2362," 9.5"
"19614","Z75218",11040,793,36,757," 6.9"
"19615","Z75219",14750,2189,332,1857,"12.6"
"19616","Z75220",15863,1494,77,1417," 8.9"
"19617","Z75223",4800,405,0,405," 8.4"
"19618","Z75224",11473,854,27,827," 7.2"
"19619","Z75225",9354,849,73,776," 8.3"
"19620","Z75226",1815,263,0,263,"14.5"
"19621","Z75227",18800,1760,28,1732," 9.2"
"19622","Z75228",27504,2718,15,2703," 9.8"
"19623","Z75229",11808,790,50,740," 6.3"
"19624","Z75230",13635,1427,216,1211," 8.9"
"19625","Z75231",18490,3176,34,3142,"17.0"
"19626","Z75232",11124,1124,24,1100," 9.9"
"19627","Z75233",5422,741,34,707,"13.0"
"19628","Z75234",11682,941,79,862," 7.4"
"19629","Z75235",7839,866,55,811,"10.3"
"19630","Z75236",6282,518,25,493," 7.8"
"19631","Z75237",8953,1143,0,1143,"12.8"
"19632","Z75238",13346,1032,22,1010," 7.6"
"19633","Z75240",10956,1048,65,983," 9.0"
"19634","Z75241",11010,992,78,914," 8.3"
"19635","Z75243",29568,4794,11,4783,"16.2"
"19636","Z75244",6362,473,15,458," 7.2"
"19637","Z75248",16705,944,9,935," 5.6"
"19638","Z75249",4765,142,0,142," 3.0"
"19639","Z75251",1915,230,0,230,"12.0"
"19640","Z75252",13367,894,43,851," 6.4"
"19641","Z75253",6274,772,0,772,"12.3"
"19642","Z75254",12495,975,22,953," 7.6"
"19643","Z75287",29469,2511,0,2511," 8.5"
"19644","Z75401",7504,1164,147,1017,"13.6"
"19645","Z75402",7174,999,378,621," 8.7"
"19646","Z75407",5827,367,0,367," 6.3"
"19647","Z75409",4451,222,17,205," 4.6"
"19648","Z75410",2264,564,305,259,"11.4"
"19649","Z75411",531,76,44,32," 6.0"
"19650","Z75414",1350,111,23,88," 6.5"
"19651","Z75416",1096,160,66,94," 8.6"
"19652","Z75417",1319,261,62,199,"15.1"
"19653","Z75418",5433,813,257,556,"10.2"
"19654","Z75420",494,68,8,60,"12.1"
"19655","Z75422",1053,144,22,122,"11.6"
"19656","Z75424",1357,145,15,130," 9.6"
"19657","Z75426",2829,815,313,502,"17.7"
"19658","Z75428",4441,1030,47,983,"22.1"
"19659","Z75431",882,156,20,136,"15.4"
"19660","Z75432",1588,303,65,238,"15.0"
"19661","Z75433",1253,192,45,147,"11.7"
"19662","Z75435",670,69,0,69,"10.3"
"19663","Z75436",980,193,55,138,"14.1"
"19664","Z75437",531,60,9,51," 9.6"
"19665","Z75438",383,50,25,25," 6.5"
"19666","Z75439",430,24,4,20," 4.7"
"19667","Z75440",3125,649,374,275," 8.8"
"19668","Z75442",3707,436,32,404,"10.9"
"19669","Z75446",1522,332,90,242,"15.9"
"19670","Z75448",261,62,19,43,"16.5"
"19671","Z75449",655,155,43,112,"17.1"
"19672","Z75452",1812,302,57,245,"13.5"
"19673","Z75453",1579,224,70,154," 9.8"
"19674","Z75454",2121,14,0,14," 0.7"
"19675","Z75455",10437,1266,124,1142,"10.9"
"19676","Z75457",3224,676,503,173," 5.4"
"19677","Z75459",1919,219,13,206,"10.7"
"19678","Z75460",11237,2023,98,1925,"17.1"
"19679","Z75462",4834,494,123,371," 7.7"
"19680","Z75468",403,113,48,65,"16.1"
"19681","Z75472",1704,354,160,194,"11.4"
"19682","Z75473",1652,209,108,101," 6.1"
"19683","Z75474",6713,1310,427,883,"13.2"
"19684","Z75476",526,78,18,60,"11.4"
"19685","Z75477",435,77,10,67,"15.4"
"19686","Z75479",772,131,43,88,"11.4"
"19687","Z75480",1129,542,452,90," 8.0"
"19688","Z75482",10357,1177,320,857," 8.3"
"19689","Z75486",1089,226,79,147,"13.5"
"19690","Z75487",673,116,0,116,"17.2"
"19691","Z75489",383,17,0,17," 4.4"
"19692","Z75490",968,120,16,104,"10.7"
"19693","Z75491",2203,191,10,181," 8.2"
"19694","Z75493",171,15,4,11," 6.4"
"19695","Z75494",5027,1132,507,625,"12.4"
"19696","Z75495",2924,227,0,227," 7.8"
"19697","Z75496",1657,306,84,222,"13.4"
"19698","Z75497",1891,456,233,223,"11.8"
"19699","Z75501",15323,2304,40,2264,"14.8"
"19700","Z75503",10557,1357,61,1296,"12.3"
"19701","Z75550",531,142,29,113,"21.3"
"19702","Z75551",5131,855,69,786,"15.3"
"19703","Z75555",737,171,29,142,"19.3"
"19704","Z75556",437,48,0,48,"11.0"
"19705","Z75558",643,154,58,96,"14.9"
"19706","Z75559",2650,485,120,365,"13.8"
"19707","Z75561",2452,389,0,389,"15.9"
"19708","Z75563",2313,385,29,356,"15.4"
"19709","Z75567",1788,127,13,114," 6.4"
"19710","Z75568",1594,488,46,442,"27.7"
"19711","Z75569",1371,152,0,152,"11.1"
"19712","Z75570",3814,529,22,507,"13.3"
"19713","Z75571",1450,358,119,239,"16.5"
"19714","Z75572",1607,254,24,230,"14.3"
"19715","Z75573",23,8,0,8,"34.8"
"19716","Z75574",911,198,15,183,"20.1"
"19717","Z75601",7003,621,71,550," 7.9"
"19718","Z75602",8232,1027,153,874,"10.6"
"19719","Z75603",2774,382,171,211," 7.6"
"19720","Z75604",12294,861,64,797," 6.5"
"19721","Z75605",12841,1140,126,1014," 7.9"
"19722","Z75630",1529,467,243,224,"14.7"
"19723","Z75631",1317,268,41,227,"17.2"
"19724","Z75633",6430,1051,369,682,"10.6"
"19725","Z75638",2679,318,67,251," 9.4"
"19726","Z75639",1518,328,51,277,"18.2"
"19727","Z75640",1859,285,72,213,"11.5"
"19728","Z75643",1133,281,173,108," 9.5"
"19729","Z75644",5063,866,150,716,"14.1"
"19730","Z75645",4064,780,142,638,"15.7"
"19731","Z75647",5266,716,103,613,"11.6"
"19732","Z75650",3442,522,157,365,"10.6"
"19733","Z75651",974,192,60,132,"13.6"
"19734","Z75652",5844,946,365,581," 9.9"
"19735","Z75654",5019,670,324,346," 6.9"
"19736","Z75656",2102,376,11,365,"17.4"
"19737","Z75657",4588,1184,428,756,"16.5"
"19738","Z75661",1895,760,228,532,"28.1"
"19739","Z75662",10308,1324,132,1192,"11.6"
"19740","Z75667",521,86,29,57,"10.9"
"19741","Z75670",7252,1306,118,1188,"16.4"
"19742","Z75672",7005,688,131,557," 8.0"
"19743","Z75681",1276,384,137,247,"19.4"
"19744","Z75683",1958,349,32,317,"16.2"
"19745","Z75684",2935,415,44,371,"12.6"
"19746","Z75686",5888,1204,404,800,"13.6"
"19747","Z75691",1562,487,147,340,"21.8"
"19748","Z75692",2222,469,159,310,"14.0"
"19749","Z75693",2565,175,0,175," 6.8"
"19750","Z75701",14457,1308,51,1257," 8.7"
"19751","Z75702",9383,1268,7,1261,"13.4"
"19752","Z75703",17748,1576,68,1508," 8.5"
"19753","Z75704",3416,338,92,246," 7.2"
"19754","Z75706",3407,567,11,556,"16.3"
"19755","Z75707",5918,453,150,303," 5.1"
"19756","Z75708",2401,168,0,168," 7.0"
"19757","Z75709",2519,520,142,378,"15.0"
"19758","Z75751",7027,989,368,621," 8.8"
"19759","Z75752",3379,737,365,372,"11.0"
"19760","Z75754",2497,463,204,259,"10.4"
"19761","Z75755",2454,411,57,354,"14.4"
"19762","Z75756",1722,336,147,189,"11.0"
"19763","Z75757",4640,614,298,316," 6.8"
"19764","Z75758",4136,818,212,606,"14.7"
"19765","Z75760",1256,287,117,170,"13.5"
"19766","Z75762",5297,376,177,199," 3.8"
"19767","Z75763",2830,629,237,392,"13.9"
"19768","Z75765",4038,1240,790,450,"11.1"
"19769","Z75766",10884,1636,509,1127,"10.4"
"19770","Z75770",1368,159,45,114," 8.3"
"19771","Z75771",8325,994,259,735," 8.8"
"19772","Z75773",5913,1198,401,797,"13.5"
"19773","Z75778",1875,533,364,169," 9.0"
"19774","Z75779",66,17,8,9,"13.6"
"19775","Z75780",89,15,3,12,"13.5"
"19776","Z75783",3682,711,352,359," 9.8"
"19777","Z75785",3966,640,130,510,"12.9"
"19778","Z75789",3186,402,114,288," 9.0"
"19779","Z75790",1843,248,15,233,"12.6"
"19780","Z75791",5199,568,119,449," 8.6"
"19781","Z75792",1504,150,50,100," 6.6"
"19782","Z75801",7294,1311,306,1005,"13.8"
"19783","Z75803",7204,881,390,491," 6.8"
"19784","Z75831",2691,675,375,300,"11.1"
"19785","Z75833",2149,729,277,452,"21.0"
"19786","Z75835",5951,1501,464,1037,"17.4"
"19787","Z75838",368,76,36,40,"10.9"
"19788","Z75839",2194,306,143,163," 7.4"
"19789","Z75840",3189,451,142,309," 9.7"
"19790","Z75844",3677,1241,655,586,"15.9"
"19791","Z75845",1835,534,207,327,"17.8"
"19792","Z75847",1061,350,97,253,"23.8"
"19793","Z75848",42,1,0,1," 2.4"
"19794","Z75849",41,5,0,5,"12.2"
"19795","Z75850",384,145,65,80,"20.8"
"19796","Z75851",1352,505,137,368,"27.2"
"19797","Z75853",519,104,76,28," 5.4"
"19798","Z75859",1349,556,323,233,"17.3"
"19799","Z75860",2573,469,132,337,"13.1"
"19800","Z75861",839,284,128,156,"18.6"
"19801","Z75862",6394,2836,1599,1237,"19.3"
"19802","Z75901",11890,1402,178,1224,"10.3"
"19803","Z75904",14561,2048,268,1780,"12.2"
"19804","Z75925",2008,389,174,215,"10.7"
"19805","Z75926",634,176,107,69,"10.9"
"19806","Z75929",1664,1003,749,254,"15.3"
"19807","Z75931",2036,1130,786,344,"16.9"
"19808","Z75932",1208,633,553,80," 6.6"
"19809","Z75933",658,171,33,138,"21.0"
"19810","Z75935",6125,985,271,714,"11.7"
"19811","Z75936",547,135,79,56,"10.2"
"19812","Z75937",454,122,51,71,"15.6"
"19813","Z75938",1579,537,291,246,"15.6"
"19814","Z75939",1965,369,155,214,"10.9"
"19815","Z75941",2942,324,0,324,"11.0"
"19816","Z75943",617,90,29,61," 9.9"
"19817","Z75944",893,321,235,86," 9.6"
"19818","Z75946",1663,370,153,217,"13.0"
"19819","Z75948",5301,3006,2269,737,"13.9"
"19820","Z75949",3361,643,74,569,"16.9"
"19821","Z75951",7115,2009,556,1453,"20.4"
"19822","Z75954",1397,264,68,196,"14.0"
"19823","Z75956",3452,773,122,651,"18.9"
"19824","Z75959",728,459,359,100,"13.7"
"19825","Z75961",7108,950,224,726,"10.2"
"19826","Z75964",7623,1051,277,774,"10.2"
"19827","Z75965",8650,873,158,715," 8.3"
"19828","Z75966",2314,762,172,590,"25.5"
"19829","Z75968",845,303,24,279,"33.0"
"19830","Z75969",1430,182,49,133," 9.3"
"19831","Z75972",3116,1105,90,1015,"32.6"
"19832","Z75973",1715,824,503,321,"18.7"
"19833","Z75974",1285,165,53,112," 8.7"
"19834","Z75975",1815,390,171,219,"12.1"
"19835","Z75976",378,57,0,57,"15.1"
"19836","Z75979",5310,1409,542,867,"16.3"
"19837","Z75980",2092,948,649,299,"14.3"
"19838","Z76001",10380,733,87,646," 6.2"
"19839","Z76002",9824,399,48,351," 3.6"
"19840","Z76006",13315,1801,51,1750,"13.1"
"19841","Z76008",5329,290,43,247," 4.6"
"19842","Z76009",7123,556,14,542," 7.6"
"19843","Z76010",20097,2340,43,2297,"11.4"
"19844","Z76011",11310,1842,29,1813,"16.0"
"19845","Z76012",11040,983,0,983," 8.9"
"19846","Z76013",13719,911,4,907," 6.6"
"19847","Z76014",11819,937,75,862," 7.3"
"19848","Z76015",7115,557,24,533," 7.5"
"19849","Z76016",11975,530,64,466," 3.9"
"19850","Z76017",18281,1266,15,1251," 6.8"
"19851","Z76018",9323,404,0,404," 4.3"
"19852","Z76020",11263,1267,125,1142,"10.1"
"19853","Z76021",16246,611,0,611," 3.8"
"19854","Z76022",6035,493,0,493," 8.2"
"19855","Z76023",2141,117,0,117," 5.5"
"19856","Z76028",24017,1176,39,1137," 4.7"
"19857","Z76031",6502,867,0,867,"13.3"
"19858","Z76033",9983,611,75,536," 5.4"
"19859","Z76034",8652,168,35,133," 1.5"
"19860","Z76035",706,53,3,50," 7.1"
"19861","Z76036",8722,647,85,562," 6.4"
"19862","Z76039",15263,1390,52,1338," 8.8"
"19863","Z76040",12751,1216,0,1216," 9.5"
"19864","Z76043",3268,308,28,280," 8.6"
"19865","Z76044",1522,167,0,167,"11.0"
"19866","Z76048",11072,2278,981,1297,"11.7"
"19867","Z76049",12321,1902,657,1245,"10.1"
"19868","Z76050",2380,290,17,273,"11.5"
"19869","Z76051",20358,1002,38,964," 4.7"
"19870","Z76052",5969,272,9,263," 4.4"
"19871","Z76053",11745,827,38,789," 6.7"
"19872","Z76054",4595,165,21,144," 3.1"
"19873","Z76055",1162,87,0,87," 7.5"
"19874","Z76058",6570,855,48,807,"12.3"
"19875","Z76059",1767,164,0,164," 9.3"
"19876","Z76060",2630,95,0,95," 3.6"
"19877","Z76063",22687,1038,133,905," 4.0"
"19878","Z76064",567,71,0,71,"12.5"
"19879","Z76065",11071,546,64,482," 4.4"
"19880","Z76067",8604,1332,71,1261,"14.7"
"19881","Z76070",259,9,0,9," 3.5"
"19882","Z76073",2520,386,2,384,"15.2"
"19883","Z76078",3442,288,4,284," 8.3"
"19884","Z76082",6959,703,164,539," 7.7"
"19885","Z76084",2707,316,11,305,"11.3"
"19886","Z76085",3467,344,68,276," 8.0"
"19887","Z76086",8841,1025,79,946,"10.7"
"19888","Z76087",10596,913,297,616," 5.8"
"19889","Z76088",4618,530,101,429," 9.3"
"19890","Z76092",9225,149,35,114," 1.2"
"19891","Z76093",787,131,3,128,"16.3"
"19892","Z76102",4026,559,145,414,"10.3"
"19893","Z76103",5770,820,49,771,"13.4"
"19894","Z76104",7348,1359,79,1280,"17.4"
"19895","Z76105",7291,948,21,927,"12.7"
"19896","Z76106",10353,811,34,777," 7.5"
"19897","Z76107",14909,1922,313,1609,"10.8"
"19898","Z76108",15777,885,15,870," 5.5"
"19899","Z76109",10725,1072,6,1066," 9.9"
"19900","Z76110",10710,1118,200,918," 8.6"
"19901","Z76111",7386,755,31,724," 9.8"
"19902","Z76112",18808,2984,62,2922,"15.5"
"19903","Z76114",9649,1034,119,915," 9.5"
"19904","Z76115",6469,645,0,645,"10.0"
"19905","Z76116",24270,3279,112,3167,"13.0"
"19906","Z76117",11655,1259,45,1214,"10.4"
"19907","Z76118",5866,478,0,478," 8.1"
"19908","Z76119",15493,1607,53,1554,"10.0"
"19909","Z76120",7756,648,0,648," 8.4"
"19910","Z76123",10303,570,0,570," 5.5"
"19911","Z76126",8670,755,60,695," 8.0"
"19912","Z76131",11034,702,0,702," 6.4"
"19913","Z76132",13232,911,33,878," 6.6"
"19914","Z76133",20025,1879,31,1848," 9.2"
"19915","Z76134",8735,635,47,588," 6.7"
"19916","Z76135",8980,821,73,748," 8.3"
"19917","Z76137",21084,1194,80,1114," 5.3"
"19918","Z76140",10079,839,71,768," 7.6"
"19919","Z76148",8291,139,0,139," 1.7"
"19920","Z76155",2556,192,0,192," 7.5"
"19921","Z76164",5219,472,6,466," 8.9"
"19922","Z76177",2944,332,33,299,"10.2"
"19923","Z76179",18305,1188,214,974," 5.3"
"19924","Z76180",15180,1353,0,1353," 8.9"
"19925","Z76182",10956,241,0,241," 2.2"
"19926","Z76201",10743,1107,128,979," 9.1"
"19927","Z76205",7452,529,56,473," 6.3"
"19928","Z76207",5341,291,89,202," 3.8"
"19929","Z76208",7954,828,45,783," 9.8"
"19930","Z76209",9908,651,41,610," 6.2"
"19931","Z76210",14760,926,186,740," 5.0"
"19932","Z76225",1410,229,0,229,"16.2"
"19933","Z76226",7368,323,69,254," 3.4"
"19934","Z76227",8845,541,45,496," 5.6"
"19935","Z76230",4965,966,333,633,"12.7"
"19936","Z76233",1383,123,0,123," 8.9"
"19937","Z76234",5905,559,133,426," 7.2"
"19938","Z76238",204,39,13,26,"12.7"
"19939","Z76239",616,166,74,92,"14.9"
"19940","Z76240",11736,1522,452,1070," 9.1"
"19941","Z76244",22004,887,53,834," 3.8"
"19942","Z76247",4102,152,0,152," 3.7"
"19943","Z76248",12865,377,0,377," 2.9"
"19944","Z76249",2754,281,45,236," 8.6"
"19945","Z76250",357,11,6,5," 1.4"
"19946","Z76251",370,93,34,59,"15.9"
"19947","Z76252",1185,142,54,88," 7.4"
"19948","Z76255",2981,627,247,380,"12.7"
"19949","Z76258",2739,330,102,228," 8.3"
"19950","Z76259",1792,107,0,107," 6.0"
"19951","Z76262",13014,646,86,560," 4.3"
"19952","Z76265",949,213,86,127,"13.4"
"19953","Z76270",806,220,75,145,"18.0"
"19954","Z76271",669,68,5,63," 9.4"
"19955","Z76273",3790,511,97,414,"10.9"
"19956","Z76301",8267,1545,111,1434,"17.3"
"19957","Z76302",5945,838,10,828,"13.9"
"19958","Z76305",2208,300,24,276,"12.5"
"19959","Z76306",7048,1325,40,1285,"18.2"
"19960","Z76308",9092,1049,36,1013,"11.1"
"19961","Z76309",6286,1112,5,1107,"17.6"
"19962","Z76310",7821,522,53,469," 6.0"
"19963","Z76351",905,156,21,135,"14.9"
"19964","Z76354",5172,662,68,594,"11.5"
"19965","Z76357",298,51,3,48,"16.1"
"19966","Z76360",1903,422,101,321,"16.9"
"19967","Z76363",169,53,4,49,"29.0"
"19968","Z76365",2313,469,148,321,"13.9"
"19969","Z76366",1163,273,118,155,"13.3"
"19970","Z76367",4085,468,83,385," 9.4"
"19971","Z76370",165,53,15,38,"23.0"
"19972","Z76371",855,202,39,163,"19.1"
"19973","Z76372",560,155,42,113,"20.2"
"19974","Z76373",100,16,0,16,"16.0"
"19975","Z76374",1925,387,75,312,"16.2"
"19976","Z76377",446,126,7,119,"26.7"
"19977","Z76379",279,59,4,55,"19.7"
"19978","Z76380",2787,1053,722,331,"11.9"
"19979","Z76384",5979,988,142,846,"14.1"
"19980","Z76389",547,109,31,78,"14.3"
"19981","Z76401",12108,1609,168,1441,"11.9"
"19982","Z76424",4393,1217,335,882,"20.1"
"19983","Z76426",4629,616,208,408," 8.8"
"19984","Z76427",471,112,16,96,"20.4"
"19985","Z76430",1318,233,69,164,"12.4"
"19986","Z76431",1576,405,222,183,"11.6"
"19987","Z76432",630,162,77,85,"13.5"
"19988","Z76433",704,174,102,72,"10.2"
"19989","Z76435",337,142,65,77,"22.8"
"19990","Z76437",3078,957,368,589,"19.1"
"19991","Z76442",3891,1098,410,688,"17.7"
"19992","Z76443",1135,381,148,233,"20.5"
"19993","Z76444",1825,449,167,282,"15.5"
"19994","Z76446",4023,961,334,627,"15.6"
"19995","Z76448",3117,905,409,496,"15.9"
"19996","Z76449",2869,1892,1649,243," 8.5"
"19997","Z76450",6680,1435,684,751,"11.2"
"19998","Z76453",803,299,207,92,"11.5"
"19999","Z76454",903,364,91,273,"30.2"
"20000","Z76455",587,170,76,94,"16.0"
"20001","Z76457",2057,561,216,345,"16.8"
"20002","Z76458",2539,641,133,508,"20.0"
"20003","Z76462",1252,215,23,192,"15.3"
"20004","Z76463",316,97,60,37,"11.7"
"20005","Z76470",1767,585,107,478,"27.1"
"20006","Z76471",1257,574,150,424,"33.7"
"20007","Z76472",813,189,57,132,"16.2"
"20008","Z76475",775,380,296,84,"10.8"
"20009","Z76476",1192,153,34,119,"10.0"
"20010","Z76483",650,185,59,126,"19.4"
"20011","Z76484",554,184,77,107,"19.3"
"20012","Z76486",672,125,49,76,"11.3"
"20013","Z76487",1090,196,20,176,"16.1"
"20014","Z76491",306,138,29,109,"35.6"
"20015","Z76501",7128,1041,113,928,"13.0"
"20016","Z76502",14838,1847,307,1540,"10.4"
"20017","Z76504",10582,2099,217,1882,"17.8"
"20018","Z76511",860,205,82,123,"14.3"
"20019","Z76513",13868,2067,260,1807,"13.0"
"20020","Z76520",3788,858,213,645,"17.0"
"20021","Z76522",15218,2216,90,2126,"14.0"
"20022","Z76524",1204,124,0,124,"10.3"
"20023","Z76525",651,231,121,110,"16.9"
"20024","Z76527",1649,217,0,217,"13.2"
"20025","Z76528",7057,1093,188,905,"12.8"
"20026","Z76530",1056,162,15,147,"13.9"
"20027","Z76531",2712,810,236,574,"21.2"
"20028","Z76534",1021,247,132,115,"11.3"
"20029","Z76537",1623,87,18,69," 4.3"
"20030","Z76539",3295,376,48,328,"10.0"
"20031","Z76541",10237,3019,45,2974,"29.1"
"20032","Z76542",17817,2328,68,2260,"12.7"
"20033","Z76543",13474,2435,60,2375,"17.6"
"20034","Z76548",10723,1616,63,1553,"14.5"
"20035","Z76549",18199,2972,0,2972,"16.3"
"20036","Z76550",5374,852,327,525," 9.8"
"20037","Z76554",819,150,21,129,"15.8"
"20038","Z76556",650,141,107,34," 5.2"
"20039","Z76557",2011,392,45,347,"17.3"
"20040","Z76559",2034,254,29,225,"11.1"
"20041","Z76561",493,75,23,52,"10.5"
"20042","Z76567",4174,501,131,370," 8.9"
"20043","Z76569",946,122,19,103,"10.9"
"20044","Z76570",1296,397,59,338,"26.1"
"20045","Z76571",2852,439,64,375,"13.1"
"20046","Z76574",6904,591,39,552," 8.0"
"20047","Z76577",1465,220,64,156,"10.6"
"20048","Z76579",1641,179,76,103," 6.3"
"20049","Z76621",473,99,35,64,"13.5"
"20050","Z76624",883,144,36,108,"12.2"
"20051","Z76626",730,126,37,89,"12.2"
"20052","Z76627",640,67,9,58," 9.1"
"20053","Z76629",1092,421,97,324,"29.7"
"20054","Z76630",560,129,0,129,"23.0"
"20055","Z76631",204,41,15,26,"12.7"
"20056","Z76632",677,256,57,199,"29.4"
"20057","Z76633",2164,128,24,104," 4.8"
"20058","Z76634",3721,1069,492,577,"15.5"
"20059","Z76636",707,96,44,52," 7.4"
"20060","Z76637",338,120,55,65,"19.2"
"20061","Z76640",1367,161,45,116," 8.5"
"20062","Z76641",702,96,16,80,"11.4"
"20063","Z76642",2936,556,218,338,"11.5"
"20064","Z76643",5464,284,0,284," 5.2"
"20065","Z76645",4562,743,147,596,"13.1"
"20066","Z76648",1238,176,34,142,"11.5"
"20067","Z76651",1458,158,13,145," 9.9"
"20068","Z76652",626,172,93,79,"12.6"
"20069","Z76653",571,201,65,136,"23.8"
"20070","Z76654",69,10,4,6," 8.7"
"20071","Z76655",3239,239,90,149," 4.6"
"20072","Z76656",941,175,23,152,"16.2"
"20073","Z76657",3544,375,21,354,"10.0"
"20074","Z76660",248,51,14,37,"14.9"
"20075","Z76661",3496,1062,31,1031,"29.5"
"20076","Z76664",1454,294,28,266,"18.3"
"20077","Z76665",1191,225,114,111," 9.3"
"20078","Z76667",4739,938,128,810,"17.1"
"20079","Z76671",1275,460,214,246,"19.3"
"20080","Z76679",705,128,40,88,"12.5"
"20081","Z76681",351,66,20,46,"13.1"
"20082","Z76682",1234,252,73,179,"14.5"
"20083","Z76689",1687,402,145,257,"15.2"
"20084","Z76691",2902,477,95,382,"13.2"
"20085","Z76692",5374,1566,800,766,"14.3"
"20086","Z76693",763,217,34,183,"24.0"
"20087","Z76701",854,194,14,180,"21.1"
"20088","Z76704",3776,553,2,551,"14.6"
"20089","Z76705",11211,1481,209,1272,"11.3"
"20090","Z76706",14473,1929,80,1849,"12.8"
"20091","Z76707",5985,775,0,775,"12.9"
"20092","Z76708",9838,797,41,756," 7.7"
"20093","Z76710",11433,909,32,877," 7.7"
"20094","Z76711",3437,322,59,263," 7.7"
"20095","Z76712",10426,575,83,492," 4.7"
"20096","Z76801",11774,3203,1232,1971,"16.7"
"20097","Z76802",2054,348,103,245,"11.9"
"20098","Z76821",2334,636,129,507,"21.7"
"20099","Z76823",1552,343,108,235,"15.1"
"20100","Z76825",3431,765,179,586,"17.1"
"20101","Z76834",3365,1081,186,895,"26.6"
"20102","Z76837",895,352,101,251,"28.0"
"20103","Z76844",2033,614,329,285,"14.0"
"20104","Z76849",2759,1042,632,410,"14.9"
"20105","Z76853",810,205,76,129,"15.9"
"20106","Z76856",2227,699,387,312,"14.0"
"20107","Z76859",1418,587,283,304,"21.4"
"20108","Z76862",266,208,166,42,"15.8"
"20109","Z76866",390,211,154,57,"14.6"
"20110","Z76870",129,48,8,40,"31.0"
"20111","Z76871",624,301,126,175,"28.0"
"20112","Z76877",1998,558,264,294,"14.7"
"20113","Z76878",979,326,122,204,"20.8"
"20114","Z76901",12391,1197,163,1034," 8.3"
"20115","Z76903",13674,1853,189,1664,"12.2"
"20116","Z76904",14838,977,459,518," 3.5"
"20117","Z76905",4813,275,45,230," 4.8"
"20118","Z76930",78,17,17,0," 0.0"
"20119","Z76932",1458,202,56,146,"10.0"
"20120","Z76933",830,180,91,89,"10.7"
"20121","Z76934",443,73,32,41," 9.3"
"20122","Z76936",1465,391,199,192,"13.1"
"20123","Z76941",736,177,116,61," 8.3"
"20124","Z76943",1733,330,137,193,"11.1"
"20125","Z76945",1339,551,300,251,"18.7"
"20126","Z76950",2116,620,328,292,"13.8"
"20127","Z76951",597,146,56,90,"15.1"
"20128","Z77002",3962,777,107,670,"16.9"
"20129","Z77003",5117,754,47,707,"13.8"
"20130","Z77004",16680,3788,10,3778,"22.6"
"20131","Z77005",10656,965,233,732," 6.9"
"20132","Z77006",13649,1755,91,1664,"12.2"
"20133","Z77007",18909,1698,104,1594," 8.4"
"20134","Z77008",16676,1393,48,1345," 8.1"
"20135","Z77009",16290,2218,296,1922,"11.8"
"20136","Z77011",6826,1197,65,1132,"16.6"
"20137","Z77012",7201,1057,0,1057,"14.7"
"20138","Z77013",6254,492,0,492," 7.9"
"20139","Z77014",12373,1272,0,1272,"10.3"
"20140","Z77015",18850,1651,9,1642," 8.7"
"20141","Z77016",10836,1581,6,1575,"14.5"
"20142","Z77017",11102,1117,48,1069," 9.6"
"20143","Z77018",11856,991,24,967," 8.2"
"20144","Z77019",11195,929,47,882," 7.9"
"20145","Z77020",9636,1282,61,1221,"12.7"
"20146","Z77021",12156,1898,32,1866,"15.4"
"20147","Z77022",10954,1758,70,1688,"15.4"
"20148","Z77023",10909,1549,78,1471,"13.5"
"20149","Z77024",16521,1512,525,987," 6.0"
"20150","Z77025",14127,1501,149,1352," 9.6"
"20151","Z77026",9790,1947,17,1930,"19.7"
"20152","Z77027",10708,1707,336,1371,"12.8"
"20153","Z77028",6685,1400,74,1326,"19.8"
"20154","Z77029",6473,787,0,787,"12.2"
"20155","Z77030",5693,939,93,846,"14.9"
"20156","Z77031",6539,730,0,730,"11.2"
"20157","Z77032",4408,340,0,340," 7.7"
"20158","Z77033",10103,1412,0,1412,"14.0"
"20159","Z77034",13539,1350,0,1350,"10.0"
"20160","Z77035",15589,2154,91,2063,"13.2"
"20161","Z77036",30486,5306,66,5240,"17.2"
"20162","Z77037",5671,345,0,345," 6.1"
"20163","Z77038",8239,432,0,432," 5.2"
"20164","Z77039",8310,931,39,892,"10.7"
"20165","Z77040",18271,924,14,910," 5.0"
"20166","Z77041",12170,592,43,549," 4.5"
"20167","Z77042",21334,3064,66,2998,"14.1"
"20168","Z77043",9707,1251,113,1138,"11.7"
"20169","Z77044",12178,1179,0,1179," 9.7"
"20170","Z77045",10372,676,0,676," 6.5"
"20171","Z77046",777,78,28,50," 6.4"
"20172","Z77047",9515,942,48,894," 9.4"
"20173","Z77048",6672,1360,0,1360,"20.4"
"20174","Z77049",10312,864,17,847," 8.2"
"20175","Z77050",1623,169,0,169,"10.4"
"20176","Z77051",7108,1315,0,1315,"18.5"
"20177","Z77053",9121,525,11,514," 5.6"
"20178","Z77054",14539,2109,436,1673,"11.5"
"20179","Z77055",16302,1665,109,1556," 9.5"
"20180","Z77056",12229,2541,877,1664,"13.6"
"20181","Z77057",22607,2667,245,2422,"10.7"
"20182","Z77058",9179,830,75,755," 8.2"
"20183","Z77059",6047,180,46,134," 2.2"
"20184","Z77060",16070,2358,28,2330,"14.5"
"20185","Z77061",9820,1143,24,1119,"11.4"
"20186","Z77062",10221,458,0,458," 4.5"
"20187","Z77063",19938,2134,289,1845," 9.3"
"20188","Z77064",16824,883,0,883," 5.2"
"20189","Z77065",15689,705,0,705," 4.5"
"20190","Z77066",10416,613,5,608," 5.8"
"20191","Z77067",10877,1115,21,1094,"10.1"
"20192","Z77068",4265,350,11,339," 7.9"
"20193","Z77069",8660,625,15,610," 7.0"
"20194","Z77070",20274,1534,149,1385," 6.8"
"20195","Z77071",11085,1040,0,1040," 9.4"
"20196","Z77072",19774,2136,101,2035,"10.3"
"20197","Z77073",13039,823,21,802," 6.2"
"20198","Z77074",14550,2202,115,2087,"14.3"
"20199","Z77075",13611,986,16,970," 7.1"
"20200","Z77076",10277,863,60,803," 7.8"
"20201","Z77077",28267,3138,662,2476," 8.8"
"20202","Z77078",5226,506,0,506," 9.7"
"20203","Z77079",13390,1039,223,816," 6.1"
"20204","Z77080",16463,1630,65,1565," 9.5"
"20205","Z77081",19660,2983,114,2869,"14.6"
"20206","Z77082",23969,2519,291,2228," 9.3"
"20207","Z77083",22467,1263,121,1142," 5.1"
"20208","Z77084",35117,1847,68,1779," 5.1"
"20209","Z77085",5076,209,41,168," 3.3"
"20210","Z77086",8509,529,0,529," 6.2"
"20211","Z77087",11859,1065,26,1039," 8.8"
"20212","Z77088",18598,1830,16,1814," 9.8"
"20213","Z77089",17559,784,28,756," 4.3"
"20214","Z77090",17388,2861,88,2773,"15.9"
"20215","Z77091",11091,2178,50,2128,"19.2"
"20216","Z77092",15236,1942,11,1931,"12.7"
"20217","Z77093",14113,2511,97,2414,"17.1"
"20218","Z77094",3269,212,42,170," 5.2"
"20219","Z77095",25036,838,16,822," 3.3"
"20220","Z77096",15901,1266,69,1197," 7.5"
"20221","Z77098",8599,951,223,728," 8.5"
"20222","Z77099",17882,2219,8,2211,"12.4"
"20223","Z77301",10860,1113,95,1018," 9.4"
"20224","Z77302",6823,500,62,438," 6.4"
"20225","Z77303",6575,352,0,352," 5.4"
"20226","Z77304",11385,1237,190,1047," 9.2"
"20227","Z77306",3978,488,0,488,"12.3"
"20228","Z77316",6869,376,86,290," 4.2"
"20229","Z77318",6970,1481,694,787,"11.3"
"20230","Z77320",11479,2481,921,1560,"13.6"
"20231","Z77327",8155,1211,327,884,"10.8"
"20232","Z77328",5623,725,232,493," 8.8"
"20233","Z77331",4198,1464,953,511,"12.2"
"20234","Z77335",1188,344,143,201,"16.9"
"20235","Z77336",4511,230,105,125," 2.8"
"20236","Z77338",13712,898,33,865," 6.3"
"20237","Z77339",16402,1041,27,1014," 6.2"
"20238","Z77340",11055,1253,105,1148,"10.4"
"20239","Z77345",10389,394,44,350," 3.4"
"20240","Z77346",19994,1067,35,1032," 5.2"
"20241","Z77351",16229,3976,2461,1515," 9.3"
"20242","Z77354",11415,559,91,468," 4.1"
"20243","Z77355",9283,617,12,605," 6.5"
"20244","Z77356",13111,3032,1943,1089," 8.3"
"20245","Z77357",7557,686,0,686," 9.1"
"20246","Z77358",2512,542,206,336,"13.4"
"20247","Z77360",3455,1199,666,533,"15.4"
"20248","Z77362",1553,53,0,53," 3.4"
"20249","Z77363",1515,314,139,175,"11.6"
"20250","Z77365",10297,707,73,634," 6.2"
"20251","Z77367",166,58,32,26,"15.7"
"20252","Z77369",388,148,36,112,"28.9"
"20253","Z77371",3141,540,123,417,"13.3"
"20254","Z77372",4657,556,29,527,"11.3"
"20255","Z77373",20228,1398,0,1398," 6.9"
"20256","Z77374",147,13,0,13," 8.8"
"20257","Z77375",15555,1475,53,1422," 9.1"
"20258","Z77377",10870,348,38,310," 2.9"
"20259","Z77378",5317,469,100,369," 6.9"
"20260","Z77379",26479,1160,122,1038," 3.9"
"20261","Z77380",12082,1089,250,839," 6.9"
"20262","Z77381",14535,606,265,341," 2.3"
"20263","Z77382",13480,1370,335,1035," 7.7"
"20264","Z77384",6582,543,177,366," 5.6"
"20265","Z77385",7586,377,57,320," 4.2"
"20266","Z77386",14925,584,0,584," 3.9"
"20267","Z77388",15324,326,0,326," 2.1"
"20268","Z77389",9811,591,312,279," 2.8"
"20269","Z77396",16464,933,0,933," 5.7"
"20270","Z77401",7164,509,103,406," 5.7"
"20271","Z77406",12735,1075,33,1042," 8.2"
"20272","Z77412",61,11,11,0," 0.0"
"20273","Z77414",11734,3389,1451,1938,"16.5"
"20274","Z77417",1297,221,30,191,"14.7"
"20275","Z77418",4725,681,261,420," 8.9"
"20276","Z77419",600,163,25,138,"23.0"
"20277","Z77422",5681,1106,382,724,"12.7"
"20278","Z77423",3875,469,89,380," 9.8"
"20279","Z77426",1076,294,97,197,"18.3"
"20280","Z77429",27072,1081,65,1016," 3.8"
"20281","Z77430",885,85,34,51," 5.8"
"20282","Z77433",20493,1028,49,979," 4.8"
"20283","Z77434",2027,476,52,424,"20.9"
"20284","Z77435",1982,333,0,333,"16.8"
"20285","Z77437",6475,664,43,621," 9.6"
"20286","Z77441",2553,163,2,161," 6.3"
"20287","Z77442",680,270,120,150,"22.1"
"20288","Z77445",5123,846,161,685,"13.4"
"20289","Z77447",4307,245,12,233," 5.4"
"20290","Z77449",31746,1339,13,1326," 4.2"
"20291","Z77450",25902,1001,94,907," 3.5"
"20292","Z77455",938,145,17,128,"13.6"
"20293","Z77456",569,100,23,77,"13.5"
"20294","Z77457",1169,956,792,164,"14.0"
"20295","Z77459",20805,555,0,555," 2.7"
"20296","Z77461",3919,312,47,265," 6.8"
"20297","Z77464",103,18,1,17,"16.5"
"20298","Z77465",4054,1125,681,444,"11.0"
"20299","Z77469",13731,827,71,756," 5.5"
"20300","Z77471",13285,1062,0,1062," 8.0"
"20301","Z77474",5052,487,95,392," 7.8"
"20302","Z77476",77,12,0,12,"15.6"
"20303","Z77477",13818,892,0,892," 6.5"
"20304","Z77478",9259,500,71,429," 4.6"
"20305","Z77479",26699,1070,108,962," 3.6"
"20306","Z77480",3126,418,42,376,"12.0"
"20307","Z77482",1059,209,68,141,"13.3"
"20308","Z77484",4214,397,12,385," 9.1"
"20309","Z77485",1815,165,23,142," 7.8"
"20310","Z77486",2822,290,25,265," 9.4"
"20311","Z77488",6424,1011,217,794,"12.4"
"20312","Z77489",12373,691,0,691," 5.6"
"20313","Z77493",8599,458,13,445," 5.2"
"20314","Z77494",27888,696,49,647," 2.3"
"20315","Z77502",11957,1027,0,1027," 8.6"
"20316","Z77503",8548,659,18,641," 7.5"
"20317","Z77504",10188,1386,38,1348,"13.2"
"20318","Z77505",9018,608,24,584," 6.5"
"20319","Z77506",12117,1347,64,1283,"10.6"
"20320","Z77510",5719,433,54,379," 6.6"
"20321","Z77511",17650,1558,118,1440," 8.2"
"20322","Z77514",2141,435,150,285,"13.3"
"20323","Z77515",11124,1138,81,1057," 9.5"
"20324","Z77517",2163,380,50,330,"15.3"
"20325","Z77518",3584,272,87,185," 5.2"
"20326","Z77519",525,79,0,79,"15.0"
"20327","Z77520",14494,1933,124,1809,"12.5"
"20328","Z77521",20517,2083,35,2048,"10.0"
"20329","Z77530",9808,676,6,670," 6.8"
"20330","Z77531",6808,909,43,866,"12.7"
"20331","Z77532",10355,710,0,710," 6.9"
"20332","Z77533",418,116,6,110,"26.3"
"20333","Z77534",1069,70,10,60," 5.6"
"20334","Z77535",10843,1014,316,698," 6.4"
"20335","Z77536",11418,530,18,512," 4.5"
"20336","Z77538",419,52,13,39," 9.3"
"20337","Z77539",16354,1687,331,1356," 8.3"
"20338","Z77541",8864,2381,1320,1061,"12.0"
"20339","Z77545",6471,268,13,255," 3.9"
"20340","Z77546",17935,641,76,565," 3.2"
"20341","Z77547",2811,155,0,155," 5.5"
"20342","Z77550",14310,4411,1300,3111,"21.7"
"20343","Z77551",10200,2523,757,1766,"17.3"
"20344","Z77554",9740,6038,4692,1346,"13.8"
"20345","Z77560",375,105,0,105,"28.0"
"20346","Z77562",4015,442,9,433,"10.8"
"20347","Z77563",4886,1017,387,630,"12.9"
"20348","Z77564",943,144,22,122,"12.9"
"20349","Z77565",3332,418,216,202," 6.1"
"20350","Z77566",12205,855,133,722," 5.9"
"20351","Z77568",6544,1027,106,921,"14.1"
"20352","Z77571",13834,943,141,802," 5.8"
"20353","Z77573",28941,1095,268,827," 2.9"
"20354","Z77575",6725,1000,119,881,"13.1"
"20355","Z77578",5582,404,0,404," 7.2"
"20356","Z77581",16801,906,92,814," 4.8"
"20357","Z77583",7536,450,85,365," 4.8"
"20358","Z77584",29178,1340,40,1300," 4.5"
"20359","Z77585",482,97,28,69,"14.3"
"20360","Z77586",9641,1073,354,719," 7.5"
"20361","Z77587",5125,509,28,481," 9.4"
"20362","Z77590",12885,1953,0,1953,"15.2"
"20363","Z77591",6038,769,91,678,"11.2"
"20364","Z77598",11441,1490,40,1450,"12.7"
"20365","Z77611",3339,302,0,302," 9.0"
"20366","Z77612",4221,699,19,680,"16.1"
"20367","Z77613",532,82,4,78,"14.7"
"20368","Z77616",460,120,39,81,"17.6"
"20369","Z77619",6830,578,36,542," 7.9"
"20370","Z77622",540,56,0,56,"10.4"
"20371","Z77625",3467,396,34,362,"10.4"
"20372","Z77627",9877,816,0,816," 8.3"
"20373","Z77629",297,23,0,23," 7.7"
"20374","Z77630",12906,1694,187,1507,"11.7"
"20375","Z77632",9841,913,59,854," 8.7"
"20376","Z77640",8056,1710,74,1636,"20.3"
"20377","Z77642",15732,2380,185,2195,"14.0"
"20378","Z77650",2283,1655,1236,419,"18.4"
"20379","Z77651",5414,420,0,420," 7.8"
"20380","Z77655",152,20,0,20,"13.2"
"20381","Z77656",7698,823,109,714," 9.3"
"20382","Z77657",8405,608,21,587," 7.0"
"20383","Z77659",2052,229,8,221,"10.8"
"20384","Z77660",620,157,63,94,"15.2"
"20385","Z77661",337,48,48,0," 0.0"
"20386","Z77662",11251,1206,99,1107," 9.8"
"20387","Z77665",2497,200,7,193," 7.7"
"20388","Z77701",6552,1322,0,1322,"20.2"
"20389","Z77702",1432,353,0,353,"24.7"
"20390","Z77703",6383,1017,17,1000,"15.7"
"20391","Z77705",12248,1462,21,1441,"11.8"
"20392","Z77706",14107,1261,64,1197," 8.5"
"20393","Z77707",6878,524,0,524," 7.6"
"20394","Z77708",5191,607,0,607,"11.7"
"20395","Z77713",6226,683,27,656,"10.5"
"20396","Z77801",7644,953,59,894,"11.7"
"20397","Z77802",11528,1009,160,849," 7.4"
"20398","Z77803",10123,1067,172,895," 8.8"
"20399","Z77807",3687,383,39,344," 9.3"
"20400","Z77808",4105,222,65,157," 3.8"
"20401","Z77831",1735,520,303,217,"12.5"
"20402","Z77833",11971,2165,496,1669,"13.9"
"20403","Z77835",1548,663,394,269,"17.4"
"20404","Z77836",5490,1258,442,816,"14.9"
"20405","Z77840",23071,2698,241,2457,"10.6"
"20406","Z77845",21639,1707,128,1579," 7.3"
"20407","Z77853",674,217,55,162,"24.0"
"20408","Z77856",2845,1013,558,455,"16.0"
"20409","Z77859",3214,653,35,618,"19.2"
"20410","Z77864",3376,495,110,385,"11.4"
"20411","Z77865",1057,415,328,87," 8.2"
"20412","Z77868",5522,650,339,311," 5.6"
"20413","Z77871",1913,771,429,342,"17.9"
"20414","Z77872",791,207,91,116,"14.7"
"20415","Z77873",669,158,53,105,"15.7"
"20416","Z77878",215,81,22,59,"27.4"
"20417","Z77879",3023,1050,582,468,"15.5"
"20418","Z77880",1100,515,371,144,"13.1"
"20419","Z77901",17022,1937,326,1611," 9.5"
"20420","Z77904",10907,562,101,461," 4.2"
"20421","Z77905",5727,570,52,518," 9.0"
"20422","Z77951",885,112,26,86," 9.7"
"20423","Z77954",4454,830,350,480,"10.8"
"20424","Z77957",3515,596,101,495,"14.1"
"20425","Z77962",1203,162,19,143,"11.9"
"20426","Z77963",2829,639,297,342,"12.1"
"20427","Z77964",4604,1237,659,578,"12.6"
"20428","Z77970",222,34,0,34,"15.3"
"20429","Z77975",1017,263,155,108,"10.6"
"20430","Z77977",278,19,0,19," 6.8"
"20431","Z77978",397,117,17,100,"25.2"
"20432","Z77979",7837,1363,456,907,"11.6"
"20433","Z77982",1593,1260,1148,112," 7.0"
"20434","Z77984",2168,533,240,293,"13.5"
"20435","Z77990",601,314,114,200,"33.3"
"20436","Z77995",4330,936,391,545,"12.6"
"20437","Z78002",2425,190,21,169," 7.0"
"20438","Z78003",4738,1208,664,544,"11.5"
"20439","Z78004",519,37,24,13," 2.5"
"20440","Z78006",11716,674,99,575," 4.9"
"20441","Z78009",3054,242,86,156," 5.1"
"20442","Z78010",1480,264,79,185,"12.5"
"20443","Z78013",2474,361,197,164," 6.6"
"20444","Z78014",2263,720,336,384,"17.0"
"20445","Z78015",4058,237,17,220," 5.4"
"20446","Z78016",3521,454,106,348," 9.9"
"20447","Z78017",1410,276,70,206,"14.6"
"20448","Z78019",581,235,58,177,"30.5"
"20449","Z78022",2264,739,233,506,"22.3"
"20450","Z78023",8964,261,54,207," 2.3"
"20451","Z78024",1013,488,387,101,"10.0"
"20452","Z78025",2291,602,295,307,"13.4"
"20453","Z78026",2279,212,63,149," 6.5"
"20454","Z78027",279,78,43,35,"12.5"
"20455","Z78028",18143,1805,568,1237," 6.8"
"20456","Z78039",663,65,21,44," 6.6"
"20457","Z78040",13468,1756,132,1624,"12.1"
"20458","Z78041",14784,1373,152,1221," 8.3"
"20459","Z78043",13235,1373,235,1138," 8.6"
"20460","Z78045",17927,942,458,484," 2.7"
"20461","Z78046",16316,1060,222,838," 5.1"
"20462","Z78052",2340,257,74,183," 7.8"
"20463","Z78055",1072,383,203,180,"16.8"
"20464","Z78058",776,421,235,186,"24.0"
"20465","Z78059",2354,430,188,242,"10.3"
"20466","Z78061",3938,710,160,550,"14.0"
"20467","Z78063",5048,1353,1009,344," 6.8"
"20468","Z78064",5627,456,32,424," 7.5"
"20469","Z78065",3946,759,225,534,"13.5"
"20470","Z78069",2021,326,78,248,"12.3"
"20471","Z78070",6017,518,218,300," 5.0"
"20472","Z78071",1700,581,237,344,"20.2"
"20473","Z78072",341,108,75,33," 9.7"
"20474","Z78073",2526,271,7,264,"10.5"
"20475","Z78075",62,27,10,17,"27.4"
"20476","Z78076",5526,1342,684,658,"11.9"
"20477","Z78101",2687,78,0,78," 2.9"
"20478","Z78102",8820,1435,129,1306,"14.8"
"20479","Z78108",11163,711,0,711," 6.4"
"20480","Z78109",12441,874,36,838," 6.7"
"20481","Z78112",2334,219,57,162," 6.9"
"20482","Z78113",1298,254,109,145,"11.2"
"20483","Z78114",8049,857,310,547," 6.8"
"20484","Z78116",221,121,36,85,"38.5"
"20485","Z78118",1615,411,123,288,"17.8"
"20486","Z78119",2339,623,225,398,"17.0"
"20487","Z78121",4249,204,49,155," 3.6"
"20488","Z78123",1306,272,175,97," 7.4"
"20489","Z78124",2189,138,22,116," 5.3"
"20490","Z78130",25010,2463,862,1601," 6.4"
"20491","Z78132",9263,780,309,471," 5.1"
"20492","Z78133",9740,2581,1764,817," 8.4"
"20493","Z78140",1467,347,131,216,"14.7"
"20494","Z78141",387,121,55,66,"17.1"
"20495","Z78145",52,12,0,12,"23.1"
"20496","Z78146",189,49,12,37,"19.6"
"20497","Z78147",727,70,9,61," 8.4"
"20498","Z78148",8438,534,37,497," 5.9"
"20499","Z78152",875,82,0,82," 9.4"
"20500","Z78154",12681,573,133,440," 3.5"
"20501","Z78155",18940,1917,290,1627," 8.6"
"20502","Z78160",1873,229,104,125," 6.7"
"20503","Z78161",292,24,15,9," 3.1"
"20504","Z78162",206,68,29,39,"18.9"
"20505","Z78163",3902,243,65,178," 4.6"
"20506","Z78164",2254,715,353,362,"16.1"
"20507","Z78201",17732,2282,4,2278,"12.8"
"20508","Z78202",4784,987,47,940,"19.6"
"20509","Z78203",2240,296,0,296,"13.2"
"20510","Z78204",4628,477,0,477,"10.3"
"20511","Z78205",1141,335,98,237,"20.8"
"20512","Z78207",18007,2340,180,2160,"12.0"
"20513","Z78208",1707,325,0,325,"19.0"
"20514","Z78209",20143,2226,274,1952," 9.7"
"20515","Z78210",14710,1355,21,1334," 9.1"
"20516","Z78211",9947,824,23,801," 8.1"
"20517","Z78212",12884,2119,90,2029,"15.7"
"20518","Z78213",17751,1356,132,1224," 6.9"
"20519","Z78214",8264,843,24,819," 9.9"
"20520","Z78215",1121,106,5,101," 9.0"
"20521","Z78216",20085,2454,213,2241,"11.2"
"20522","Z78217",15536,1529,17,1512," 9.7"
"20523","Z78218",14152,1717,63,1654,"11.7"
"20524","Z78219",5921,533,19,514," 8.7"
"20525","Z78220",6435,884,62,822,"12.8"
"20526","Z78221",12308,962,39,923," 7.5"
"20527","Z78222",7635,604,45,559," 7.3"
"20528","Z78223",18985,1940,56,1884," 9.9"
"20529","Z78224",5859,443,0,443," 7.6"
"20530","Z78225",4918,562,19,543,"11.0"
"20531","Z78226",2809,646,19,627,"22.3"
"20532","Z78227",15660,1201,65,1136," 7.3"
"20533","Z78228",21065,1596,80,1516," 7.2"
"20534","Z78229",16232,2189,184,2005,"12.4"
"20535","Z78230",20578,2000,220,1780," 8.7"
"20536","Z78231",3450,134,35,99," 2.9"
"20537","Z78232",16562,813,108,705," 4.3"
"20538","Z78233",17658,1032,68,964," 5.5"
"20539","Z78234",1087,35,0,35," 3.2"
"20540","Z78237",11955,979,53,926," 7.7"
"20541","Z78238",10154,692,0,692," 6.8"
"20542","Z78239",10439,876,25,851," 8.2"
"20543","Z78240",25691,1892,218,1674," 6.5"
"20544","Z78242",9989,1066,24,1042,"10.4"
"20545","Z78244",10133,735,105,630," 6.2"
"20546","Z78245",20177,1170,91,1079," 5.3"
"20547","Z78247",18644,631,69,562," 3.0"
"20548","Z78248",5929,297,21,276," 4.7"
"20549","Z78249",19891,1425,96,1329," 6.7"
"20550","Z78250",19517,833,14,819," 4.2"
"20551","Z78251",19794,778,29,749," 3.8"
"20552","Z78252",2216,122,0,122," 5.5"
"20553","Z78253",12009,641,0,641," 5.3"
"20554","Z78254",15840,343,21,322," 2.0"
"20555","Z78255",4462,276,45,231," 5.2"
"20556","Z78256",3724,410,109,301," 8.1"
"20557","Z78257",2093,381,61,320,"15.3"
"20558","Z78258",16182,919,232,687," 4.2"
"20559","Z78259",8684,548,18,530," 6.1"
"20560","Z78260",9127,273,38,235," 2.6"
"20561","Z78263",1612,89,22,67," 4.2"
"20562","Z78264",3684,657,113,544,"14.8"
"20563","Z78266",2313,120,12,108," 4.7"
"20564","Z78330",358,37,7,30," 8.4"
"20565","Z78332",10849,1302,297,1005," 9.3"
"20566","Z78336",6286,1602,881,721,"11.5"
"20567","Z78341",1224,412,103,309,"25.2"
"20568","Z78343",1854,335,51,284,"15.3"
"20569","Z78344",241,95,34,61,"25.3"
"20570","Z78355",2853,845,218,627,"22.0"
"20571","Z78357",1385,372,151,221,"16.0"
"20572","Z78358",466,172,100,72,"15.5"
"20573","Z78359",738,88,0,88,"11.9"
"20574","Z78361",2566,878,184,694,"27.0"
"20575","Z78363",12148,1784,584,1200," 9.9"
"20576","Z78368",4143,1020,406,614,"14.8"
"20577","Z78369",162,70,23,47,"29.0"
"20578","Z78370",1895,283,12,271,"14.3"
"20579","Z78372",2308,345,110,235,"10.2"
"20580","Z78373",4773,2866,2283,583,"12.2"
"20581","Z78374",6468,477,37,440," 6.8"
"20582","Z78375",1361,291,60,231,"17.0"
"20583","Z78377",1714,314,29,285,"16.6"
"20584","Z78379",843,302,209,93,"11.0"
"20585","Z78380",8798,1279,221,1058,"12.0"
"20586","Z78382",13380,5143,3475,1668,"12.5"
"20587","Z78383",2355,891,482,409,"17.4"
"20588","Z78384",2577,627,141,486,"18.9"
"20589","Z78387",3867,658,143,515,"13.3"
"20590","Z78390",2259,426,19,407,"18.0"
"20591","Z78393",1115,294,105,189,"17.0"
"20592","Z78401",2272,465,4,461,"20.3"
"20593","Z78402",449,176,88,88,"19.6"
"20594","Z78404",7771,1107,101,1006,"12.9"
"20595","Z78405",6056,719,29,690,"11.4"
"20596","Z78406",289,30,0,30,"10.4"
"20597","Z78407",1394,230,12,218,"15.6"
"20598","Z78408",4808,706,42,664,"13.8"
"20599","Z78409",1136,154,46,108," 9.5"
"20600","Z78410",10099,896,44,852," 8.4"
"20601","Z78411",11479,1021,16,1005," 8.8"
"20602","Z78412",15862,1091,112,979," 6.2"
"20603","Z78413",15898,1303,211,1092," 6.9"
"20604","Z78414",13489,598,152,446," 3.3"
"20605","Z78415",14823,1337,99,1238," 8.4"
"20606","Z78416",5711,563,96,467," 8.2"
"20607","Z78417",1488,107,11,96," 6.5"
"20608","Z78418",14783,2355,1427,928," 6.3"
"20609","Z78501",23181,3071,1115,1956," 8.4"
"20610","Z78503",7636,1162,582,580," 7.6"
"20611","Z78504",18099,1935,762,1173," 6.5"
"20612","Z78516",11751,1982,1244,738," 6.3"
"20613","Z78520",20297,2054,664,1390," 6.8"
"20614","Z78521",28159,2529,943,1586," 5.6"
"20615","Z78526",13704,1170,581,589," 4.3"
"20616","Z78535",219,9,0,9," 4.1"
"20617","Z78536",133,41,15,26,"19.5"
"20618","Z78537",12903,2110,1237,873," 6.8"
"20619","Z78538",3568,512,213,299," 8.4"
"20620","Z78539",11731,1166,92,1074," 9.2"
"20621","Z78541",13424,1224,327,897," 6.7"
"20622","Z78543",3030,391,38,353,"11.7"
"20623","Z78549",217,36,0,36,"16.6"
"20624","Z78550",18758,2684,464,2220,"11.8"
"20625","Z78552",13895,2343,1107,1236," 8.9"
"20626","Z78557",3334,269,109,160," 4.8"
"20627","Z78558",318,20,0,20," 6.3"
"20628","Z78559",4481,759,284,475,"10.6"
"20629","Z78560",1766,344,57,287,"16.3"
"20630","Z78566",5358,717,162,555,"10.4"
"20631","Z78567",225,35,11,24,"10.7"
"20632","Z78569",1330,180,50,130," 9.8"
"20633","Z78570",10097,1289,318,971," 9.6"
"20634","Z78572",29376,6148,3969,2179," 7.4"
"20635","Z78573",10153,1176,362,814," 8.0"
"20636","Z78574",17246,1699,481,1218," 7.1"
"20637","Z78575",3296,687,432,255," 7.7"
"20638","Z78576",2472,222,97,125," 5.1"
"20639","Z78577",23263,2801,1545,1256," 5.4"
"20640","Z78578",6379,2133,1643,490," 7.7"
"20641","Z78579",1051,106,18,88," 8.4"
"20642","Z78580",4299,729,231,498,"11.6"
"20643","Z78582",12596,2018,729,1289,"10.2"
"20644","Z78583",3242,786,471,315," 9.7"
"20645","Z78584",6110,1138,373,765,"12.5"
"20646","Z78586",17595,2178,565,1613," 9.2"
"20647","Z78588",125,36,19,17,"13.6"
"20648","Z78589",10778,891,260,631," 5.9"
"20649","Z78595",1806,167,45,122," 6.8"
"20650","Z78596",22442,3593,1844,1749," 7.8"
"20651","Z78597",7400,5739,3523,2216,"29.9"
"20652","Z78602",9960,1374,486,888," 8.9"
"20653","Z78605",2081,178,78,100," 4.8"
"20654","Z78606",2611,645,360,285,"10.9"
"20655","Z78607",217,144,144,0," 0.0"
"20656","Z78608",270,86,41,45,"16.7"
"20657","Z78609",1523,639,468,171,"11.2"
"20658","Z78610",10444,721,9,712," 6.8"
"20659","Z78611",6577,1398,1171,227," 3.5"
"20660","Z78612",3964,479,30,449,"11.3"
"20661","Z78613",25412,1301,367,934," 3.7"
"20662","Z78614",199,20,6,14," 7.0"
"20663","Z78615",441,53,0,53,"12.0"
"20664","Z78616",2298,358,9,349,"15.2"
"20665","Z78617",6776,498,124,374," 5.5"
"20666","Z78618",297,160,144,16," 5.4"
"20667","Z78619",1461,75,11,64," 4.4"
"20668","Z78620",5792,434,138,296," 5.1"
"20669","Z78621",8047,727,169,558," 6.9"
"20670","Z78622",122,28,6,22,"18.0"
"20671","Z78624",10969,1904,627,1277,"11.6"
"20672","Z78626",10203,719,17,702," 6.9"
"20673","Z78628",10795,609,31,578," 5.4"
"20674","Z78629",5033,1143,383,760,"15.1"
"20675","Z78631",1359,353,219,134," 9.9"
"20676","Z78632",528,142,47,95,"18.0"
"20677","Z78633",10863,524,56,468," 4.3"
"20678","Z78634",9020,686,16,670," 7.4"
"20679","Z78636",2315,661,549,112," 4.8"
"20680","Z78638",943,50,7,43," 4.6"
"20681","Z78639",4737,1620,1353,267," 5.6"
"20682","Z78640",14833,1106,153,953," 6.4"
"20683","Z78641",17339,894,238,656," 3.8"
"20684","Z78642",3360,311,154,157," 4.7"
"20685","Z78643",3966,1459,983,476,"12.0"
"20686","Z78644",6420,609,51,558," 8.7"
"20687","Z78645",6050,1644,870,774,"12.8"
"20688","Z78648",3271,339,81,258," 7.9"
"20689","Z78650",803,203,81,122,"15.2"
"20690","Z78652",2062,45,12,33," 1.6"
"20691","Z78653",6065,541,48,493," 8.1"
"20692","Z78654",8837,1661,995,666," 7.5"
"20693","Z78655",1282,154,13,141,"11.0"
"20694","Z78656",778,83,0,83,"10.7"
"20695","Z78657",4634,2066,1667,399," 8.6"
"20696","Z78660",27139,777,36,741," 2.7"
"20697","Z78661",132,7,0,7," 5.3"
"20698","Z78662",1160,127,21,106," 9.1"
"20699","Z78663",518,190,165,25," 4.8"
"20700","Z78664",20444,1041,208,833," 4.1"
"20701","Z78665",14049,919,175,744," 5.3"
"20702","Z78666",28498,2933,315,2618," 9.2"
"20703","Z78669",5008,1388,972,416," 8.3"
"20704","Z78670",80,3,0,3," 3.8"
"20705","Z78672",1034,483,410,73," 7.1"
"20706","Z78676",6277,1036,609,427," 6.8"
"20707","Z78681",18041,894,209,685," 3.8"
"20708","Z78701",5777,1411,574,837,"14.5"
"20709","Z78702",9173,836,97,739," 8.1"
"20710","Z78703",10813,1057,193,864," 8.0"
"20711","Z78704",24312,2269,250,2019," 8.3"
"20712","Z78705",10023,1319,130,1189,"11.9"
"20713","Z78717",9749,480,34,446," 4.6"
"20714","Z78719",557,141,9,132,"23.7"
"20715","Z78721",4488,312,106,206," 4.6"
"20716","Z78722",3164,191,19,172," 5.4"
"20717","Z78723",12994,1005,39,966," 7.4"
"20718","Z78724",6582,579,58,521," 7.9"
"20719","Z78725",2370,76,0,76," 3.2"
"20720","Z78727",13720,864,209,655," 4.8"
"20721","Z78728",10176,537,127,410," 4.0"
"20722","Z78729",13540,806,110,696," 5.1"
"20723","Z78730",4006,375,161,214," 5.3"
"20724","Z78731",13264,933,60,873," 6.6"
"20725","Z78732",5823,621,235,386," 6.6"
"20726","Z78733",3069,88,0,88," 2.9"
"20727","Z78734",8455,1172,772,400," 4.7"
"20728","Z78735",8013,651,182,469," 5.9"
"20729","Z78736",3200,296,80,216," 6.8"
"20730","Z78737",4942,134,11,123," 2.5"
"20731","Z78738",5669,560,251,309," 5.5"
"20732","Z78739",6098,95,0,95," 1.6"
"20733","Z78741",22555,2378,156,2222," 9.9"
"20734","Z78742",288,15,0,15," 5.2"
"20735","Z78744",14132,883,86,797," 5.6"
"20736","Z78745",26488,1548,141,1407," 5.3"
"20737","Z78746",11793,873,357,516," 4.4"
"20738","Z78747",6376,254,54,200," 3.1"
"20739","Z78748",18420,737,34,703," 3.8"
"20740","Z78749",15299,611,37,574," 3.8"
"20741","Z78750",12148,997,113,884," 7.3"
"20742","Z78751",8091,703,48,655," 8.1"
"20743","Z78752",8210,631,111,520," 6.3"
"20744","Z78753",20312,1640,118,1522," 7.5"
"20745","Z78754",7616,445,54,391," 5.1"
"20746","Z78756",4678,270,53,217," 4.6"
"20747","Z78757",11264,673,62,611," 5.4"
"20748","Z78758",20276,1829,370,1459," 7.2"
"20749","Z78759",21062,1211,443,768," 3.6"
"20750","Z78801",8273,1582,479,1103,"13.3"
"20751","Z78827",503,92,6,86,"17.1"
"20752","Z78829",547,138,40,98,"17.9"
"20753","Z78832",1719,640,299,341,"19.8"
"20754","Z78833",911,474,360,114,"12.5"
"20755","Z78834",3392,516,198,318," 9.4"
"20756","Z78838",264,185,147,38,"14.4"
"20757","Z78839",2991,357,91,266," 8.9"
"20758","Z78840",18292,3620,1710,1910,"10.4"
"20759","Z78850",586,190,100,90,"15.4"
"20760","Z78852",17330,1805,168,1637," 9.4"
"20761","Z78861",4884,1054,409,645,"13.2"
"20762","Z78870",480,109,44,65,"13.5"
"20763","Z78872",769,175,21,154,"20.0"
"20764","Z78873",1516,804,693,111," 7.3"
"20765","Z78879",353,203,178,25," 7.1"
"20766","Z78880",1452,805,738,67," 4.6"
"20767","Z78881",1112,358,134,224,"20.1"
"20768","Z78884",820,429,328,101,"12.3"
"20769","Z78932",431,184,97,87,"20.2"
"20770","Z78933",654,127,64,63," 9.6"
"20771","Z78934",3108,750,379,371,"11.9"
"20772","Z78938",238,80,27,53,"22.3"
"20773","Z78940",1403,498,294,204,"14.5"
"20774","Z78941",1752,658,372,286,"16.3"
"20775","Z78942",3669,735,204,531,"14.5"
"20776","Z78944",302,73,41,32,"10.6"
"20777","Z78945",5362,1444,753,691,"12.9"
"20778","Z78946",666,249,136,113,"17.0"
"20779","Z78947",2068,461,271,190," 9.2"
"20780","Z78948",402,109,49,60,"14.9"
"20781","Z78949",269,92,41,51,"19.0"
"20782","Z78950",1428,518,329,189,"13.2"
"20783","Z78954",874,419,302,117,"13.4"
"20784","Z78956",3014,942,473,469,"15.6"
"20785","Z78957",4530,802,319,483,"10.7"
"20786","Z78959",951,325,128,197,"20.7"
"20787","Z78962",2828,762,406,356,"12.6"
"20788","Z78963",474,149,128,21," 4.4"
"20789","Z79003",97,22,22,0," 0.0"
"20790","Z79005",641,71,25,46," 7.2"
"20791","Z79007",6733,1361,86,1275,"18.9"
"20792","Z79009",759,106,0,106,"14.0"
"20793","Z79012",508,37,0,37," 7.3"
"20794","Z79014",1714,271,140,131," 7.6"
"20795","Z79015",8481,698,122,576," 6.8"
"20796","Z79019",812,173,18,155,"19.1"
"20797","Z79022",3992,660,148,512,"12.8"
"20798","Z79027",2029,462,48,414,"20.4"
"20799","Z79029",5799,634,73,561," 9.7"
"20800","Z79031",606,146,0,146,"24.1"
"20801","Z79035",1810,283,31,252,"13.9"
"20802","Z79036",2718,605,225,380,"14.0"
"20803","Z79039",443,75,28,47,"10.6"
"20804","Z79040",769,205,35,170,"22.1"
"20805","Z79041",1446,213,19,194,"13.4"
"20806","Z79042",552,112,0,112,"20.3"
"20807","Z79043",580,120,8,112,"19.3"
"20808","Z79045",7120,923,54,869,"12.2"
"20809","Z79046",242,50,12,38,"15.7"
"20810","Z79052",492,98,10,88,"17.9"
"20811","Z79053",83,26,0,26,"31.3"
"20812","Z79054",272,88,5,83,"30.5"
"20813","Z79057",646,133,31,102,"15.8"
"20814","Z79061",193,32,12,20,"10.4"
"20815","Z79063",275,23,6,17," 6.2"
"20816","Z79064",1038,186,12,174,"16.8"
"20817","Z79065",9300,1649,171,1478,"15.9"
"20818","Z79070",3932,353,48,305," 7.8"
"20819","Z79072",10252,1497,55,1442,"14.1"
"20820","Z79079",1439,270,78,192,"13.3"
"20821","Z79080",348,123,37,86,"24.7"
"20822","Z79081",1639,184,11,173,"10.6"
"20823","Z79083",1169,319,32,287,"24.6"
"20824","Z79084",943,183,48,135,"14.3"
"20825","Z79086",971,101,9,92," 9.5"
"20826","Z79087",319,74,17,57,"17.9"
"20827","Z79088",2430,494,29,465,"19.1"
"20828","Z79092",492,107,20,87,"17.7"
"20829","Z79095",1225,236,44,192,"15.7"
"20830","Z79096",899,98,36,62," 6.9"
"20831","Z79097",487,67,0,67,"13.8"
"20832","Z79098",186,9,2,7," 3.8"
"20833","Z79101",1486,268,30,238,"16.0"
"20834","Z79102",4516,494,37,457,"10.1"
"20835","Z79103",4098,250,44,206," 5.0"
"20836","Z79104",2725,329,4,325,"11.9"
"20837","Z79106",12935,1012,33,979," 7.6"
"20838","Z79107",12455,1483,49,1434,"11.5"
"20839","Z79108",5177,559,33,526,"10.2"
"20840","Z79109",20867,2384,207,2177,"10.4"
"20841","Z79110",7910,557,50,507," 6.4"
"20842","Z79111",481,30,0,30," 6.2"
"20843","Z79118",7349,602,135,467," 6.4"
"20844","Z79119",5639,274,0,274," 4.9"
"20845","Z79121",3139,205,48,157," 5.0"
"20846","Z79124",3284,205,43,162," 4.9"
"20847","Z79201",3103,701,112,589,"19.0"
"20848","Z79225",634,222,42,180,"28.4"
"20849","Z79226",1855,692,265,427,"23.0"
"20850","Z79227",878,351,169,182,"20.7"
"20851","Z79235",1780,338,61,277,"15.6"
"20852","Z79237",317,156,58,98,"30.9"
"20853","Z79241",1190,242,46,196,"16.5"
"20854","Z79245",1278,439,104,335,"26.2"
"20855","Z79248",934,324,118,206,"22.1"
"20856","Z79250",663,154,19,135,"20.4"
"20857","Z79252",1801,548,177,371,"20.6"
"20858","Z79255",384,134,42,92,"24.0"
"20859","Z79257",604,167,68,99,"16.4"
"20860","Z79261",347,164,75,89,"25.6"
"20861","Z79311",1598,235,27,208,"13.0"
"20862","Z79312",476,77,11,66,"13.9"
"20863","Z79316",4337,738,36,702,"16.2"
"20864","Z79322",1005,191,0,191,"19.0"
"20865","Z79323",2256,111,25,86," 3.8"
"20866","Z79325",999,148,11,137,"13.7"
"20867","Z79329",1370,142,43,99," 7.2"
"20868","Z79331",4972,937,144,793,"15.9"
"20869","Z79336",6826,788,45,743,"10.9"
"20870","Z79339",3133,608,13,595,"19.0"
"20871","Z79343",633,132,4,128,"20.2"
"20872","Z79346",1069,279,16,263,"24.6"
"20873","Z79347",2866,348,0,348,"12.1"
"20874","Z79351",599,126,18,108,"18.0"
"20875","Z79355",897,166,25,141,"15.7"
"20876","Z79356",1664,218,20,198,"11.9"
"20877","Z79357",1020,191,2,189,"18.5"
"20878","Z79358",447,80,0,80,"17.9"
"20879","Z79359",1167,243,23,220,"18.9"
"20880","Z79360",4752,432,67,365," 7.7"
"20881","Z79363",2013,267,0,267,"13.3"
"20882","Z79364",3706,391,77,314," 8.5"
"20883","Z79370",1156,552,224,328,"28.4"
"20884","Z79371",645,147,0,147,"22.8"
"20885","Z79372",494,74,11,63,"12.8"
"20886","Z79373",1482,243,34,209,"14.1"
"20887","Z79378",154,16,0,16,"10.4"
"20888","Z79379",239,36,0,36,"15.1"
"20889","Z79381",583,110,10,100,"17.2"
"20890","Z79382",2143,200,41,159," 7.4"
"20891","Z79401",4131,724,63,661,"16.0"
"20892","Z79403",6298,1095,105,990,"15.7"
"20893","Z79404",3930,638,159,479,"12.2"
"20894","Z79407",8658,909,90,819," 9.5"
"20895","Z79410",4583,782,77,705,"15.4"
"20896","Z79411",3778,509,48,461,"12.2"
"20897","Z79412",6075,666,125,541," 8.9"
"20898","Z79413",9602,900,104,796," 8.3"
"20899","Z79414",8489,492,78,414," 4.9"
"20900","Z79415",7186,930,64,866,"12.1"
"20901","Z79416",14273,1378,135,1243," 8.7"
"20902","Z79423",14339,841,128,713," 5.0"
"20903","Z79424",18324,1053,54,999," 5.5"
"20904","Z79501",1583,411,87,324,"20.5"
"20905","Z79502",781,266,81,185,"23.7"
"20906","Z79504",1480,300,74,226,"15.3"
"20907","Z79508",558,87,12,75,"13.4"
"20908","Z79510",3648,705,292,413,"11.3"
"20909","Z79511",598,106,16,90,"15.1"
"20910","Z79512",3428,1109,406,703,"20.5"
"20911","Z79520",1229,243,45,198,"16.1"
"20912","Z79521",2132,733,474,259,"12.1"
"20913","Z79525",1045,174,39,135,"12.9"
"20914","Z79526",513,60,21,39," 7.6"
"20915","Z79527",172,89,56,33,"19.2"
"20916","Z79528",367,71,29,42,"11.4"
"20917","Z79529",698,187,32,155,"22.2"
"20918","Z79530",193,31,16,15," 7.8"
"20919","Z79532",492,140,13,127,"25.8"
"20920","Z79533",234,107,42,65,"27.8"
"20921","Z79535",82,44,27,17,"20.7"
"20922","Z79536",2335,467,6,461,"19.7"
"20923","Z79538",193,108,71,37,"19.2"
"20924","Z79543",611,128,27,101,"16.5"
"20925","Z79545",849,153,22,131,"15.4"
"20926","Z79546",1132,293,50,243,"21.5"
"20927","Z79547",437,125,24,101,"23.1"
"20928","Z79549",6553,1241,144,1097,"16.7"
"20929","Z79553",2096,656,73,583,"27.8"
"20930","Z79556",6062,1267,154,1113,"18.4"
"20931","Z79562",1498,152,5,147," 9.8"
"20932","Z79563",496,94,3,91,"18.3"
"20933","Z79565",140,44,3,41,"29.3"
"20934","Z79567",1678,509,133,376,"22.4"
"20935","Z79601",9263,1506,141,1365,"14.7"
"20936","Z79602",9123,1086,6,1080,"11.8"
"20937","Z79603",9554,991,13,978,"10.2"
"20938","Z79605",13146,1735,80,1655,"12.6"
"20939","Z79606",10565,1016,39,977," 9.2"
"20940","Z79607",673,27,0,27," 4.0"
"20941","Z79701",10596,1117,17,1100,"10.4"
"20942","Z79703",7759,299,25,274," 3.5"
"20943","Z79705",14147,1006,114,892," 6.3"
"20944","Z79706",7723,499,35,464," 6.0"
"20945","Z79707",14726,850,50,800," 5.4"
"20946","Z79713",238,65,6,59,"24.8"
"20947","Z79714",6013,537,0,537," 8.9"
"20948","Z79718",451,186,71,115,"25.5"
"20949","Z79719",200,35,0,35,"17.5"
"20950","Z79720",12575,1846,93,1753,"13.9"
"20951","Z79730",123,27,5,22,"17.9"
"20952","Z79731",1602,110,0,110," 6.9"
"20953","Z79733",79,20,0,20,"25.3"
"20954","Z79734",1490,515,296,219,"14.7"
"20955","Z79735",4669,1051,195,856,"18.3"
"20956","Z79741",109,8,0,8," 7.3"
"20957","Z79742",206,62,3,59,"28.6"
"20958","Z79743",169,46,2,44,"26.0"
"20959","Z79744",506,68,11,57,"11.3"
"20960","Z79745",2606,339,10,329,"12.6"
"20961","Z79752",991,203,17,186,"18.8"
"20962","Z79755",93,15,6,9," 9.7"
"20963","Z79756",3899,609,106,503,"12.9"
"20964","Z79758",899,255,56,199,"22.1"
"20965","Z79761",12500,1080,74,1006," 8.0"
"20966","Z79762",17095,1229,0,1229," 7.2"
"20967","Z79763",12487,993,92,901," 7.2"
"20968","Z79764",8112,737,53,684," 8.4"
"20969","Z79765",4002,137,0,137," 3.4"
"20970","Z79766",1979,144,11,133," 6.7"
"20971","Z79772",3869,576,92,484,"12.5"
"20972","Z79777",178,105,4,101,"56.7"
"20973","Z79778",426,75,0,75,"17.6"
"20974","Z79782",1508,166,42,124," 8.2"
"20975","Z79783",106,23,0,23,"21.7"
"20976","Z79788",205,29,6,23,"11.2"
"20977","Z79821",1794,175,12,163," 9.1"
"20978","Z79830",4032,784,169,615,"15.3"
"20979","Z79834",119,31,17,14,"11.8"
"20980","Z79835",3703,364,165,199," 5.4"
"20981","Z79837",340,137,30,107,"31.5"
"20982","Z79838",2345,278,39,239,"10.2"
"20983","Z79839",725,189,38,151,"20.8"
"20984","Z79842",494,208,82,126,"25.5"
"20985","Z79843",1498,583,204,379,"25.3"
"20986","Z79845",2314,625,83,542,"23.4"
"20987","Z79849",3352,351,39,312," 9.3"
"20988","Z79851",288,130,16,114,"39.6"
"20989","Z79852",715,324,200,124,"17.3"
"20990","Z79853",895,137,11,126,"14.1"
"20991","Z79855",1002,229,69,160,"16.0"
"20992","Z79901",4546,548,21,527,"11.6"
"20993","Z79902",9635,1233,125,1108,"11.5"
"20994","Z79903",6880,720,0,720,"10.5"
"20995","Z79904",12429,1415,106,1309,"10.5"
"20996","Z79905",9057,1016,112,904,"10.0"
"20997","Z79906",1199,178,0,178,"14.8"
"20998","Z79907",17672,931,54,877," 5.0"
"20999","Z79908",628,40,0,40," 6.4"
"21000","Z79912",31234,2668,305,2363," 7.6"
"21001","Z79915",13479,959,31,928," 6.9"
"21002","Z79922",3005,278,43,235," 7.8"
"21003","Z79924",21639,1986,189,1797," 8.3"
"21004","Z79925",16197,1324,52,1272," 7.9"
"21005","Z79927",11416,643,67,576," 5.0"
"21006","Z79928",15164,706,19,687," 4.5"
"21007","Z79930",12108,1470,157,1313,"10.8"
"21008","Z79932",9098,420,59,361," 4.0"
"21009","Z79934",8521,908,14,894,"10.5"
"21010","Z79935",6955,492,0,492," 7.1"
"21011","Z79936",36754,1893,295,1598," 4.3"
"21012","Z79938",19972,1650,279,1371," 6.9"
"21013","Z80002",8488,261,8,253," 3.0"
"21014","Z80003",14778,580,76,504," 3.4"
"21015","Z80004",15236,422,64,358," 2.3"
"21016","Z80005",10817,146,0,146," 1.3"
"21017","Z80007",2828,86,32,54," 1.9"
"21018","Z80010",13823,871,5,866," 6.3"
"21019","Z80011",16808,970,35,935," 5.6"
"21020","Z80012",19697,1357,85,1272," 6.5"
"21021","Z80013",25685,935,27,908," 3.5"
"21022","Z80014",19037,1107,138,969," 5.1"
"21023","Z80015",22421,671,148,523," 2.3"
"21024","Z80016",16994,560,76,484," 2.8"
"21025","Z80018",3543,122,50,72," 2.0"
"21026","Z80020",18885,636,103,533," 2.8"
"21027","Z80021",13718,684,55,629," 4.6"
"21028","Z80022",14250,762,43,719," 5.0"
"21029","Z80023",7282,371,70,301," 4.1"
"21030","Z80026",11743,275,67,208," 1.8"
"21031","Z80027",12934,537,88,449," 3.5"
"21032","Z80030",6284,294,21,273," 4.3"
"21033","Z80031",13711,655,168,487," 3.6"
"21034","Z80033",12123,778,49,729," 6.0"
"21035","Z80101",217,69,22,47,"21.7"
"21036","Z80102",1993,143,0,143," 7.2"
"21037","Z80103",1038,90,52,38," 3.7"
"21038","Z80104",11075,483,97,386," 3.5"
"21039","Z80106",1625,113,3,110," 6.8"
"21040","Z80107",4445,174,49,125," 2.8"
"21041","Z80108",9189,371,59,312," 3.4"
"21042","Z80109",6549,86,0,86," 1.3"
"21043","Z80110",9459,563,26,537," 5.7"
"21044","Z80111",12805,674,124,550," 4.3"
"21045","Z80112",13516,473,60,413," 3.1"
"21046","Z80113",10171,672,41,631," 6.2"
"21047","Z80116",1510,75,0,75," 5.0"
"21048","Z80117",1124,113,25,88," 7.8"
"21049","Z80118",2566,205,13,192," 7.5"
"21050","Z80120",14067,649,88,561," 4.0"
"21051","Z80121",7518,396,35,361," 4.8"
"21052","Z80122",12636,310,32,278," 2.2"
"21053","Z80123",19677,1017,153,864," 4.4"
"21054","Z80125",4001,225,19,206," 5.1"
"21055","Z80126",15699,520,12,508," 3.2"
"21056","Z80127",16555,387,88,299," 1.8"
"21057","Z80128",14508,443,76,367," 2.5"
"21058","Z80129",10896,237,26,211," 1.9"
"21059","Z80130",10689,316,28,288," 2.7"
"21060","Z80132",7304,459,137,322," 4.4"
"21061","Z80133",982,85,26,59," 6.0"
"21062","Z80134",21721,668,39,629," 2.9"
"21063","Z80135",1805,262,98,164," 9.1"
"21064","Z80136",1822,91,0,91," 5.0"
"21065","Z80137",414,40,0,40," 9.7"
"21066","Z80138",11236,255,25,230," 2.0"
"21067","Z80202",9500,1688,677,1011,"10.6"
"21068","Z80203",14921,1061,195,866," 5.8"
"21069","Z80204",13433,1240,115,1125," 8.4"
"21070","Z80205",13888,916,42,874," 6.3"
"21071","Z80206",13260,671,112,559," 4.2"
"21072","Z80207",9635,362,8,354," 3.7"
"21073","Z80209",13992,1036,171,865," 6.2"
"21074","Z80210",16528,997,161,836," 5.1"
"21075","Z80211",16408,1005,61,944," 5.8"
"21076","Z80212",9261,300,20,280," 3.0"
"21077","Z80214",11774,612,0,612," 5.2"
"21078","Z80215",8481,347,23,324," 3.8"
"21079","Z80216",3635,329,0,329," 9.1"
"21080","Z80218",12189,964,77,887," 7.3"
"21081","Z80219",20564,834,0,834," 4.1"
"21082","Z80220",16772,926,267,659," 3.9"
"21083","Z80221",13822,833,9,824," 6.0"
"21084","Z80222",10297,588,73,515," 5.0"
"21085","Z80223",7308,265,14,251," 3.4"
"21086","Z80224",8765,366,88,278," 3.2"
"21087","Z80226",13720,499,0,499," 3.6"
"21088","Z80227",15278,408,23,385," 2.5"
"21089","Z80228",13949,447,52,395," 2.8"
"21090","Z80229",18319,919,9,910," 5.0"
"21091","Z80230",4245,353,37,316," 7.4"
"21092","Z80231",17698,1159,193,966," 5.5"
"21093","Z80232",9247,347,10,337," 3.6"
"21094","Z80233",18222,956,43,913," 5.0"
"21095","Z80234",11090,743,36,707," 6.4"
"21096","Z80235",3619,251,16,235," 6.5"
"21097","Z80236",6313,324,31,293," 4.6"
"21098","Z80237",10430,721,106,615," 5.9"
"21099","Z80238",5134,104,33,71," 1.4"
"21100","Z80239",11477,349,4,345," 3.0"
"21101","Z80246",7733,500,129,371," 4.8"
"21102","Z80247",15029,1431,136,1295," 8.6"
"21103","Z80249",8599,240,47,193," 2.2"
"21104","Z80260",12592,797,31,766," 6.1"
"21105","Z80301",11570,665,125,540," 4.7"
"21106","Z80302",12932,945,237,708," 5.5"
"21107","Z80303",11672,528,83,445," 3.8"
"21108","Z80304",11674,481,149,332," 2.8"
"21109","Z80305",7365,292,88,204," 2.8"
"21110","Z80401",16694,643,59,584," 3.5"
"21111","Z80403",8310,720,351,369," 4.4"
"21112","Z80420",877,508,448,60," 6.8"
"21113","Z80421",4717,1037,886,151," 3.2"
"21114","Z80422",2747,820,741,79," 2.9"
"21115","Z80424",11032,7729,6649,1080," 9.8"
"21116","Z80427",639,159,71,88,"13.8"
"21117","Z80433",3719,485,285,200," 5.4"
"21118","Z80435",7857,5374,4506,868,"11.0"
"21119","Z80436",273,27,0,27," 9.9"
"21120","Z80439",10775,1002,546,456," 4.2"
"21121","Z80440",2276,1283,1156,127," 5.6"
"21122","Z80442",2673,1851,1586,265," 9.9"
"21123","Z80443",5233,3799,3341,458," 8.8"
"21124","Z80444",838,309,254,55," 6.6"
"21125","Z80446",2851,1445,1101,344,"12.1"
"21126","Z80447",3936,3140,2619,521,"13.2"
"21127","Z80448",307,161,161,0," 0.0"
"21128","Z80449",1264,894,846,48," 3.8"
"21129","Z80451",352,74,44,30," 8.5"
"21130","Z80452",2136,665,571,94," 4.4"
"21131","Z80454",543,66,47,19," 3.5"
"21132","Z80455",347,136,77,59,"17.0"
"21133","Z80459",1482,606,407,199,"13.4"
"21134","Z80461",4329,1395,1018,377," 8.7"
"21135","Z80465",6203,152,20,132," 2.1"
"21136","Z80466",1952,385,316,69," 3.5"
"21137","Z80469",169,38,38,0," 0.0"
"21138","Z80470",1655,310,310,0," 0.0"
"21139","Z80476",206,81,69,12," 5.8"
"21140","Z80478",1120,678,620,58," 5.2"
"21141","Z80480",1152,575,385,190,"16.5"
"21142","Z80481",460,151,99,52,"11.3"
"21143","Z80482",3470,3029,2486,543,"15.6"
"21144","Z80487",12332,5581,3993,1588,"12.9"
"21145","Z80497",819,511,329,182,"22.2"
"21146","Z80498",5297,2682,2370,312," 5.9"
"21147","Z80501",16737,843,29,814," 4.9"
"21148","Z80503",13388,600,182,418," 3.1"
"21149","Z80504",17607,351,22,329," 1.9"
"21150","Z80510",847,549,425,124,"14.6"
"21151","Z80512",1579,753,712,41," 2.6"
"21152","Z80513",4462,145,0,145," 3.2"
"21153","Z80514",1930,99,0,99," 5.1"
"21154","Z80516",7898,158,18,140," 1.8"
"21155","Z80517",7574,3019,2220,799,"10.5"
"21156","Z80521",13456,627,125,502," 3.7"
"21157","Z80524",13953,530,84,446," 3.2"
"21158","Z80525",21221,634,86,548," 2.6"
"21159","Z80526",18538,850,70,780," 4.2"
"21160","Z80528",6792,186,28,158," 2.3"
"21161","Z80530",1502,56,0,56," 3.7"
"21162","Z80534",5226,95,0,95," 1.8"
"21163","Z80535",1306,82,9,73," 5.6"
"21164","Z80536",1268,388,284,104," 8.2"
"21165","Z80537",18305,848,144,704," 3.8"
"21166","Z80538",19212,657,130,527," 2.7"
"21167","Z80540",2623,674,464,210," 8.0"
"21168","Z80542",1355,32,15,17," 1.3"
"21169","Z80543",2188,82,0,82," 3.7"
"21170","Z80545",1970,1721,1630,91," 4.6"
"21171","Z80549",3364,113,0,113," 3.4"
"21172","Z80550",8706,267,100,167," 1.9"
"21173","Z80601",11568,416,15,401," 3.5"
"21174","Z80602",9913,345,36,309," 3.1"
"21175","Z80603",4606,391,42,349," 7.6"
"21176","Z80610",1145,80,14,66," 5.8"
"21177","Z80611",279,29,0,29,"10.4"
"21178","Z80612",240,48,48,0," 0.0"
"21179","Z80615",2894,86,0,86," 3.0"
"21180","Z80620",6278,137,0,137," 2.2"
"21181","Z80621",4332,334,13,321," 7.4"
"21182","Z80622",68,8,0,8,"11.8"
"21183","Z80623",350,56,0,56,"16.0"
"21184","Z80631",17738,1222,25,1197," 6.7"
"21185","Z80634",21996,1161,193,968," 4.4"
"21186","Z80640",3709,193,0,193," 5.2"
"21187","Z80642",1297,61,0,61," 4.7"
"21188","Z80643",1228,76,0,76," 6.2"
"21189","Z80644",1229,94,0,94," 7.6"
"21190","Z80645",1674,111,0,111," 6.6"
"21191","Z80648",391,25,0,25," 6.4"
"21192","Z80650",606,26,9,17," 2.8"
"21193","Z80651",1622,73,0,73," 4.5"
"21194","Z80653",511,205,176,29," 5.7"
"21195","Z80654",1081,88,13,75," 6.9"
"21196","Z80701",6272,469,46,423," 6.7"
"21197","Z80705",417,36,10,26," 6.2"
"21198","Z80720",1392,265,67,198,"14.2"
"21199","Z80722",112,14,14,0," 0.0"
"21200","Z80723",2762,182,0,182," 6.6"
"21201","Z80729",261,70,28,42,"16.1"
"21202","Z80731",679,69,12,57," 8.4"
"21203","Z80733",225,18,0,18," 8.0"
"21204","Z80734",1210,152,11,141,"11.7"
"21205","Z80735",157,31,8,23,"14.6"
"21206","Z80736",242,41,14,27,"11.2"
"21207","Z80737",812,188,20,168,"20.7"
"21208","Z80741",362,33,18,15," 4.1"
"21209","Z80742",141,50,20,30,"21.3"
"21210","Z80744",243,64,23,41,"16.9"
"21211","Z80747",217,39,16,23,"10.6"
"21212","Z80751",7223,749,65,684," 9.5"
"21213","Z80754",95,21,4,17,"17.9"
"21214","Z80758",1554,207,87,120," 7.7"
"21215","Z80759",2232,196,42,154," 6.9"
"21216","Z80804",227,72,25,47,"20.7"
"21217","Z80805",215,12,0,12," 5.6"
"21218","Z80807",1970,160,56,104," 5.3"
"21219","Z80808",2809,484,103,381,"13.6"
"21220","Z80809",990,298,247,51," 5.2"
"21221","Z80810",499,33,10,23," 4.6"
"21222","Z80813",1273,543,353,190,"14.9"
"21223","Z80814",2163,672,485,187," 8.6"
"21224","Z80815",494,99,22,77,"15.6"
"21225","Z80816",3693,1292,1044,248," 6.7"
"21226","Z80817",10200,571,0,571," 5.6"
"21227","Z80819",591,241,176,65,"11.0"
"21228","Z80821",546,131,65,66,"12.1"
"21229","Z80822",131,33,22,11," 8.4"
"21230","Z80824",126,24,9,15,"11.9"
"21231","Z80825",242,88,16,72,"29.8"
"21232","Z80827",948,534,525,9," 0.9"
"21233","Z80828",1089,187,21,166,"15.2"
"21234","Z80829",3302,448,213,235," 7.1"
"21235","Z80831",8197,320,0,320," 3.9"
"21236","Z80835",378,51,0,51,"13.5"
"21237","Z80836",535,119,27,92,"17.2"
"21238","Z80863",5273,562,348,214," 4.1"
"21239","Z80864",628,141,40,101,"16.1"
"21240","Z80902",3067,196,0,196," 6.4"
"21241","Z80903",7766,836,35,801,"10.3"
"21242","Z80904",11057,966,182,784," 7.1"
"21243","Z80905",8299,786,52,734," 8.8"
"21244","Z80906",16550,1206,288,918," 5.5"
"21245","Z80907",13460,819,153,666," 4.9"
"21246","Z80908",5356,217,56,161," 3.0"
"21247","Z80909",17298,1366,15,1351," 7.8"
"21248","Z80910",13127,1150,86,1064," 8.1"
"21249","Z80911",11627,502,67,435," 3.7"
"21250","Z80915",8173,407,0,407," 5.0"
"21251","Z80916",14562,960,27,933," 6.4"
"21252","Z80917",13563,545,87,458," 3.4"
"21253","Z80918",19612,884,120,764," 3.9"
"21254","Z80919",11573,543,92,451," 3.9"
"21255","Z80920",14085,556,39,517," 3.7"
"21256","Z80921",7309,317,121,196," 2.7"
"21257","Z80922",9531,327,0,327," 3.4"
"21258","Z80923",10348,227,11,216," 2.1"
"21259","Z80924",2052,50,0,50," 2.4"
"21260","Z80925",2444,103,40,63," 2.6"
"21261","Z80926",665,62,24,38," 5.7"
"21262","Z80928",511,43,15,28," 5.5"
"21263","Z80930",531,64,0,64,"12.1"
"21264","Z81001",13313,1365,31,1334,"10.0"
"21265","Z81003",6347,649,56,593," 9.3"
"21266","Z81004",12138,1658,73,1585,"13.1"
"21267","Z81005",13299,812,67,745," 5.6"
"21268","Z81006",4823,394,57,337," 7.0"
"21269","Z81007",11557,617,152,465," 4.0"
"21270","Z81008",4698,485,23,462," 9.8"
"21271","Z81019",816,157,62,95,"11.6"
"21272","Z81020",722,294,155,139,"19.3"
"21273","Z81022",660,94,0,94,"14.2"
"21274","Z81023",844,320,174,146,"17.3"
"21275","Z81025",528,147,0,147,"27.8"
"21276","Z81036",573,160,34,126,"22.0"
"21277","Z81039",874,145,30,115,"13.2"
"21278","Z81047",715,125,38,87,"12.2"
"21279","Z81050",4635,843,110,733,"15.8"
"21280","Z81052",4438,712,98,614,"13.8"
"21281","Z81054",1601,353,4,349,"21.8"
"21282","Z81055",1743,1085,866,219,"12.6"
"21283","Z81057",238,48,0,48,"20.2"
"21284","Z81063",714,180,54,126,"17.6"
"21285","Z81067",2800,391,60,331,"11.8"
"21286","Z81069",1406,723,488,235,"16.7"
"21287","Z81073",1052,238,73,165,"15.7"
"21288","Z81077",234,43,0,43,"18.4"
"21289","Z81082",6303,1537,291,1246,"19.8"
"21290","Z81084",86,39,5,34,"39.5"
"21291","Z81089",2680,733,86,647,"24.1"
"21292","Z81092",395,51,16,35," 8.9"
"21293","Z81101",6234,607,87,520," 8.3"
"21294","Z81121",210,99,72,27,"12.9"
"21295","Z81122",4506,1164,761,403," 8.9"
"21296","Z81123",438,114,48,66,"15.1"
"21297","Z81125",1437,303,19,284,"19.8"
"21298","Z81131",989,317,198,119,"12.0"
"21299","Z81132",1815,580,378,202,"11.1"
"21300","Z81133",814,404,311,93,"11.4"
"21301","Z81136",104,29,16,13,"12.5"
"21302","Z81137",2590,291,58,233," 9.0"
"21303","Z81140",1113,149,30,119,"10.7"
"21304","Z81141",543,101,28,73,"13.4"
"21305","Z81143",475,169,53,116,"24.4"
"21306","Z81144",3204,508,47,461,"14.4"
"21307","Z81146",342,112,74,38,"11.1"
"21308","Z81147",8473,3382,2468,914,"10.8"
"21309","Z81149",637,215,101,114,"17.9"
"21310","Z81151",613,79,0,79,"12.9"
"21311","Z81152",1132,572,258,314,"27.7"
"21312","Z81154",1678,1094,1015,79," 4.7"
"21313","Z81201",4925,765,426,339," 6.9"
"21314","Z81210",657,548,471,77,"11.7"
"21315","Z81211",3887,1136,758,378," 9.7"
"21316","Z81212",12293,1523,382,1141," 9.3"
"21317","Z81220",455,371,343,28," 6.2"
"21318","Z81222",238,41,0,41,"17.2"
"21319","Z81223",1361,585,422,163,"12.0"
"21320","Z81224",2427,919,748,171," 7.0"
"21321","Z81225",1985,1489,1058,431,"21.7"
"21322","Z81226",2520,371,4,367,"14.6"
"21323","Z81230",4790,1011,537,474," 9.9"
"21324","Z81233",658,200,93,107,"16.3"
"21325","Z81235",1049,718,613,105,"10.0"
"21326","Z81236",1068,583,500,83," 7.8"
"21327","Z81240",1719,109,39,70," 4.1"
"21328","Z81241",322,286,269,17," 5.3"
"21329","Z81242",386,13,7,6," 1.6"
"21330","Z81251",194,103,98,5," 2.6"
"21331","Z81252",3788,2003,1564,439,"11.6"
"21332","Z81253",322,61,61,0," 0.0"
"21333","Z81301",15054,3070,1989,1081," 7.2"
"21334","Z81303",3479,360,128,232," 6.7"
"21335","Z81321",6382,511,74,437," 6.8"
"21336","Z81323",2574,616,375,241," 9.4"
"21337","Z81324",742,252,104,148,"19.9"
"21338","Z81326",1070,186,101,85," 7.9"
"21339","Z81327",301,32,0,32,"10.6"
"21340","Z81328",2048,358,239,119," 5.8"
"21341","Z81332",208,121,70,51,"24.5"
"21342","Z81401",10081,580,90,490," 4.9"
"21343","Z81410",744,58,36,22," 3.0"
"21344","Z81413",2836,748,498,250," 8.8"
"21345","Z81415",824,257,143,114,"13.8"
"21346","Z81416",5949,714,96,618,"10.4"
"21347","Z81418",795,82,55,27," 3.4"
"21348","Z81419",1794,217,143,74," 4.1"
"21349","Z81422",458,138,17,121,"26.4"
"21350","Z81423",807,154,99,55," 6.8"
"21351","Z81424",664,182,28,154,"23.2"
"21352","Z81425",2150,172,33,139," 6.5"
"21353","Z81426",103,29,29,0," 0.0"
"21354","Z81427",813,400,251,149,"18.3"
"21355","Z81428",1900,433,310,123," 6.5"
"21356","Z81430",662,328,310,18," 2.7"
"21357","Z81431",216,50,0,50,"23.1"
"21358","Z81432",1804,562,426,136," 7.5"
"21359","Z81433",541,273,203,70,"12.9"
"21360","Z81435",5060,2880,2185,695,"13.7"
"21361","Z81501",10094,627,156,471," 4.7"
"21362","Z81503",6342,307,46,261," 4.1"
"21363","Z81504",11961,447,106,341," 2.9"
"21364","Z81505",4173,279,54,225," 5.4"
"21365","Z81506",5163,320,140,180," 3.5"
"21366","Z81520",5786,361,153,208," 3.6"
"21367","Z81521",6179,254,40,214," 3.5"
"21368","Z81524",939,176,0,176,"18.7"
"21369","Z81526",2403,151,36,115," 4.8"
"21370","Z81601",6541,465,282,183," 2.8"
"21371","Z81610",213,75,18,57,"26.8"
"21372","Z81611",7901,3489,2484,1005,"12.7"
"21373","Z81615",2711,1450,1064,386,"14.2"
"21374","Z81620",8598,4913,4378,535," 6.2"
"21375","Z81621",2916,404,268,136," 4.7"
"21376","Z81623",6373,882,598,284," 4.5"
"21377","Z81624",789,308,216,92,"11.7"
"21378","Z81625",5656,948,198,750,"13.3"
"21379","Z81630",415,90,33,57,"13.7"
"21380","Z81631",3291,728,495,233," 7.1"
"21381","Z81632",5198,1933,1753,180," 3.5"
"21382","Z81635",3076,661,78,583,"19.0"
"21383","Z81637",2674,349,114,235," 8.8"
"21384","Z81638",93,19,8,11,"11.8"
"21385","Z81639",1227,299,152,147,"12.0"
"21386","Z81640",151,85,43,42,"27.8"
"21387","Z81641",2055,567,287,280,"13.6"
"21388","Z81643",528,237,201,36," 6.8"
"21389","Z81645",594,164,138,26," 4.4"
"21390","Z81647",2569,203,129,74," 2.9"
"21391","Z81648",1232,261,20,241,"19.6"
"21392","Z81649",121,30,9,21,"17.4"
"21393","Z81650",5075,703,76,627,"12.4"
"21394","Z81652",1835,177,4,173," 9.4"
"21395","Z81654",633,152,115,37," 5.8"
"21396","Z81656",159,41,23,18,"11.3"
"21397","Z81657",7547,5032,4704,328," 4.3"
"21398","Z82001",16868,2031,457,1574," 9.3"
"21399","Z82007",8809,957,205,752," 8.5"
"21400","Z82009",13468,655,342,313," 2.3"
"21401","Z82070",9694,1286,566,720," 7.4"
"21402","Z82072",7832,953,254,699," 8.9"
"21403","Z82082",824,164,11,153,"18.6"
"21404","Z82201",3480,693,297,396,"11.4"
"21405","Z82210",186,28,6,22,"11.8"
"21406","Z82213",518,267,235,32," 6.2"
"21407","Z82214",650,86,28,58," 8.9"
"21408","Z82221",231,31,19,12," 5.2"
"21409","Z82222",87,25,6,19,"21.8"
"21410","Z82223",565,78,16,62,"11.0"
"21411","Z82225",1061,206,103,103," 9.7"
"21412","Z82240",4509,359,60,299," 6.6"
"21413","Z82244",253,21,8,13," 5.1"
"21414","Z82301",4181,665,92,573,"13.7"
"21415","Z82321",385,106,30,76,"19.7"
"21416","Z82324",210,83,37,46,"21.9"
"21417","Z82327",750,395,224,171,"22.8"
"21418","Z82331",1524,502,324,178,"11.7"
"21419","Z82336",271,147,26,121,"44.6"
"21420","Z82401",3461,206,0,206," 6.0"
"21421","Z82410",827,120,14,106,"12.8"
"21422","Z82412",230,34,7,27,"11.7"
"21423","Z82414",7643,1199,557,642," 8.4"
"21424","Z82420",340,20,4,16," 4.7"
"21425","Z82426",1417,245,88,157,"11.1"
"21426","Z82431",1588,244,45,199,"12.5"
"21427","Z82432",128,28,0,28,"21.9"
"21428","Z82433",498,91,64,27," 5.4"
"21429","Z82435",5234,543,137,406," 7.8"
"21430","Z82440",94,20,0,20,"21.3"
"21431","Z82442",399,92,58,34," 8.5"
"21432","Z82443",2515,379,183,196," 7.8"
"21433","Z82501",8110,766,218,548," 6.8"
"21434","Z82512",113,46,32,14,"12.4"
"21435","Z82513",1464,544,423,121," 8.3"
"21436","Z82514",481,34,11,23," 4.8"
"21437","Z82520",5820,632,382,250," 4.3"
"21438","Z82523",483,73,40,33," 6.8"
"21439","Z82601",12923,1272,337,935," 7.2"
"21440","Z82604",11233,960,271,689," 6.1"
"21441","Z82609",7784,486,31,455," 5.8"
"21442","Z82620",352,269,232,37,"10.5"
"21443","Z82633",4710,627,158,469,"10.0"
"21444","Z82635",142,30,14,16,"11.3"
"21445","Z82636",1910,112,0,112," 5.9"
"21446","Z82637",1733,182,46,136," 7.8"
"21447","Z82639",401,79,33,46,"11.5"
"21448","Z82642",57,11,8,3," 5.3"
"21449","Z82644",729,29,18,11," 1.5"
"21450","Z82649",610,162,67,95,"15.6"
"21451","Z82701",2470,336,134,202," 8.2"
"21452","Z82710",180,29,0,29,"16.1"
"21453","Z82716",7746,916,185,731," 9.4"
"21454","Z82718",9673,718,82,636," 6.6"
"21455","Z82720",531,106,22,84,"15.8"
"21456","Z82721",1436,304,199,105," 7.3"
"21457","Z82727",871,156,43,113,"13.0"
"21458","Z82729",1055,128,22,106,"10.0"
"21459","Z82730",905,201,42,159,"17.6"
"21460","Z82732",1103,225,150,75," 6.8"
"21461","Z82801",11583,1019,464,555," 4.8"
"21462","Z82832",374,100,65,35," 9.4"
"21463","Z82834",3983,694,398,296," 7.4"
"21464","Z82836",590,140,106,34," 5.8"
"21465","Z82838",206,58,58,0," 0.0"
"21466","Z82839",525,40,17,23," 4.4"
"21467","Z82842",719,249,125,124,"17.2"
"21468","Z82901",12496,1573,135,1438,"11.5"
"21469","Z82923",344,255,210,45,"13.1"
"21470","Z82930",6761,1648,879,769,"11.4"
"21471","Z82932",398,64,7,57,"14.3"
"21472","Z82933",309,21,21,0," 0.0"
"21473","Z82934",123,30,8,22,"17.9"
"21474","Z82935",5142,335,42,293," 5.7"
"21475","Z82937",1458,118,14,104," 7.1"
"21476","Z82939",804,93,44,49," 6.1"
"21477","Z82941",2518,784,458,326,"12.9"
"21478","Z83001",8479,2490,1726,764," 9.0"
"21479","Z83013",452,239,239,0," 0.0"
"21480","Z83014",2682,1220,1018,202," 7.5"
"21481","Z83101",1706,488,211,277,"16.2"
"21482","Z83110",1869,353,151,202,"10.8"
"21483","Z83111",148,9,9,0," 0.0"
"21484","Z83112",190,94,50,44,"23.2"
"21485","Z83113",1302,308,99,209,"16.1"
"21486","Z83114",383,93,17,76,"19.8"
"21487","Z83115",987,442,345,97," 9.8"
"21488","Z83116",325,45,0,45,"13.8"
"21489","Z83119",74,44,44,0," 0.0"
"21490","Z83123",348,130,20,110,"31.6"
"21491","Z83126",165,20,20,0," 0.0"
"21492","Z83127",1755,572,444,128," 7.3"
"21493","Z83128",911,308,204,104,"11.4"
"21494","Z83201",15116,1217,171,1046," 6.9"
"21495","Z83202",7974,446,23,423," 5.3"
"21496","Z83204",7740,681,25,656," 8.5"
"21497","Z83209",178,22,0,22,"12.4"
"21498","Z83210",1188,162,53,109," 9.2"
"21499","Z83211",2241,261,51,210," 9.4"
"21500","Z83213",775,188,11,177,"22.8"
"21501","Z83217",375,98,18,80,"21.3"
"21502","Z83221",9743,857,89,768," 7.9"
"21503","Z83223",60,18,18,0," 0.0"
"21504","Z83226",1285,312,116,196,"15.3"
"21505","Z83234",688,124,96,28," 4.1"
"21506","Z83236",800,132,57,75," 9.4"
"21507","Z83237",383,18,0,18," 4.7"
"21508","Z83239",252,51,13,38,"15.1"
"21509","Z83241",897,122,30,92,"10.3"
"21510","Z83245",818,41,15,26," 3.2"
"21511","Z83246",746,382,248,134,"18.0"
"21512","Z83250",560,90,15,75,"13.4"
"21513","Z83251",800,323,210,113,"14.1"
"21514","Z83252",1892,347,107,240,"12.7"
"21515","Z83254",1833,336,114,222,"12.1"
"21516","Z83255",567,141,72,69,"12.2"
"21517","Z83261",346,135,103,32," 9.2"
"21518","Z83263",3341,290,143,147," 4.4"
"21519","Z83271",264,73,9,64,"24.2"
"21520","Z83274",3077,176,18,158," 5.1"
"21521","Z83276",1931,403,217,186," 9.6"
"21522","Z83278",681,597,460,137,"20.1"
"21523","Z83301",21322,1406,174,1232," 5.8"
"21524","Z83311",212,39,14,25,"11.8"
"21525","Z83313",1688,230,144,86," 5.1"
"21526","Z83314",460,101,35,66,"14.3"
"21527","Z83316",3964,345,62,283," 7.1"
"21528","Z83318",6234,388,84,304," 4.9"
"21529","Z83320",369,63,14,49,"13.3"
"21530","Z83321",231,39,8,31,"13.4"
"21531","Z83323",632,40,0,40," 6.3"
"21532","Z83324",237,40,9,31,"13.1"
"21533","Z83325",325,25,0,25," 7.7"
"21534","Z83327",765,404,274,130,"17.0"
"21535","Z83328",2149,239,79,160," 7.4"
"21536","Z83330",2632,346,142,204," 7.8"
"21537","Z83333",4969,831,733,98," 2.0"
"21538","Z83334",800,84,17,67," 8.4"
"21539","Z83335",699,61,11,50," 7.2"
"21540","Z83336",1658,83,0,83," 5.0"
"21541","Z83338",7182,474,25,449," 6.3"
"21542","Z83340",5270,2949,2617,332," 6.3"
"21543","Z83341",2630,348,36,312,"11.9"
"21544","Z83342",579,115,38,77,"13.3"
"21545","Z83344",449,57,0,57,"12.7"
"21546","Z83346",625,126,70,56," 9.0"
"21547","Z83347",1260,112,4,108," 8.6"
"21548","Z83349",450,69,18,51,"11.3"
"21549","Z83350",4931,435,79,356," 7.2"
"21550","Z83352",1496,394,172,222,"14.8"
"21551","Z83353",2483,1887,1698,189," 7.6"
"21552","Z83355",1693,147,23,124," 7.3"
"21553","Z83401",14111,1079,126,953," 6.8"
"21554","Z83402",10257,1069,45,1024,"10.0"
"21555","Z83404",9018,927,119,808," 9.0"
"21556","Z83406",5611,228,39,189," 3.4"
"21557","Z83420",1172,332,279,53," 4.5"
"21558","Z83422",1787,504,281,223,"12.5"
"21559","Z83423",438,193,88,105,"24.0"
"21560","Z83425",244,22,0,22," 9.0"
"21561","Z83428",430,261,230,31," 7.2"
"21562","Z83429",3708,3298,3136,162," 4.4"
"21563","Z83431",302,18,7,11," 3.6"
"21564","Z83434",556,46,0,46," 8.3"
"21565","Z83436",162,17,10,7," 4.3"
"21566","Z83440",11894,1992,71,1921,"16.2"
"21567","Z83442",6484,430,176,254," 3.9"
"21568","Z83444",465,65,0,65,"14.0"
"21569","Z83445",2756,321,100,221," 8.0"
"21570","Z83448",619,40,0,40," 6.5"
"21571","Z83449",205,99,80,19," 9.3"
"21572","Z83450",372,50,8,42,"11.3"
"21573","Z83451",368,37,0,37,"10.1"
"21574","Z83452",834,357,259,98,"11.8"
"21575","Z83454",183,6,0,6," 3.3"
"21576","Z83455",2764,1001,686,315,"11.4"
"21577","Z83464",245,111,49,62,"25.3"
"21578","Z83467",3484,558,295,263," 7.5"
"21579","Z83501",15191,963,140,823," 5.4"
"21580","Z83522",914,237,175,62," 6.8"
"21581","Z83523",378,62,13,49,"13.0"
"21582","Z83524",426,56,4,52,"12.2"
"21583","Z83525",433,222,203,19," 4.4"
"21584","Z83530",2769,434,270,164," 5.9"
"21585","Z83535",579,75,20,55," 9.5"
"21586","Z83536",2042,289,95,194," 9.5"
"21587","Z83537",601,111,62,49," 8.2"
"21588","Z83539",1126,213,125,88," 7.8"
"21589","Z83540",876,106,25,81," 9.2"
"21590","Z83543",330,43,7,36,"10.9"
"21591","Z83544",2706,355,187,168," 6.2"
"21592","Z83546",482,140,79,61,"12.7"
"21593","Z83549",562,230,173,57,"10.1"
"21594","Z83554",371,87,70,17," 4.6"
"21595","Z83605",14548,937,9,928," 6.4"
"21596","Z83607",8309,774,8,766," 9.2"
"21597","Z83610",553,149,110,39," 7.1"
"21598","Z83611",3359,2424,2333,91," 2.7"
"21599","Z83612",1243,436,362,74," 6.0"
"21600","Z83615",2130,1761,1683,78," 3.7"
"21601","Z83616",9508,319,10,309," 3.2"
"21602","Z83617",6549,717,145,572," 8.7"
"21603","Z83619",2786,186,50,136," 4.9"
"21604","Z83622",1696,992,941,51," 3.0"
"21605","Z83623",715,150,38,112,"15.7"
"21606","Z83624",531,124,39,85,"16.0"
"21607","Z83627",301,40,27,13," 4.3"
"21608","Z83628",1584,120,0,120," 7.6"
"21609","Z83631",1029,549,456,93," 9.0"
"21610","Z83633",236,67,34,33,"14.0"
"21611","Z83634",7124,129,28,101," 1.4"
"21612","Z83637",406,291,263,28," 6.9"
"21613","Z83638",6189,4354,4221,133," 2.1"
"21614","Z83641",1321,73,5,68," 5.1"
"21615","Z83642",15147,709,0,709," 4.7"
"21616","Z83644",3635,133,0,133," 3.7"
"21617","Z83646",18670,180,0,180," 1.0"
"21618","Z83647",9649,1780,617,1163,"12.1"
"21619","Z83651",11221,598,115,483," 4.3"
"21620","Z83654",1207,546,490,56," 4.6"
"21621","Z83655",1706,155,29,126," 7.4"
"21622","Z83660",2322,167,35,132," 5.7"
"21623","Z83661",3927,427,67,360," 9.2"
"21624","Z83669",3241,158,0,158," 4.9"
"21625","Z83672",3655,523,44,479,"13.1"
"21626","Z83676",1570,153,7,146," 9.3"
"21627","Z83686",17103,1137,91,1046," 6.1"
"21628","Z83687",10917,978,39,939," 8.6"
"21629","Z83702",11954,1301,534,767," 6.4"
"21630","Z83703",7566,404,61,343," 4.5"
"21631","Z83704",16865,654,0,654," 3.9"
"21632","Z83705",12810,911,115,796," 6.2"
"21633","Z83706",14226,692,242,450," 3.2"
"21634","Z83709",19195,702,193,509," 2.7"
"21635","Z83712",3904,294,0,294," 7.5"
"21636","Z83713",10790,588,0,588," 5.4"
"21637","Z83714",9237,517,47,470," 5.1"
"21638","Z83716",6482,524,266,258," 4.0"
"21639","Z83801",2668,420,285,135," 5.1"
"21640","Z83803",824,487,414,73," 8.9"
"21641","Z83804",841,358,170,188,"22.4"
"21642","Z83805",3552,702,297,405,"11.4"
"21643","Z83806",127,37,20,17,"13.4"
"21644","Z83810",531,108,51,57,"10.7"
"21645","Z83811",791,204,119,85,"10.7"
"21646","Z83814",12800,2223,1338,885," 6.9"
"21647","Z83815",13592,772,107,665," 4.9"
"21648","Z83822",947,60,0,60," 6.3"
"21649","Z83823",647,93,36,57," 8.8"
"21650","Z83827",153,81,68,13," 8.5"
"21651","Z83832",605,46,0,46," 7.6"
"21652","Z83835",8921,1110,890,220," 2.5"
"21653","Z83836",856,439,349,90,"10.5"
"21654","Z83837",1660,359,127,232,"14.0"
"21655","Z83839",710,119,20,99,"13.9"
"21656","Z83843",11587,657,23,634," 5.5"
"21657","Z83845",830,101,41,60," 7.2"
"21658","Z83847",807,121,15,106,"13.1"
"21659","Z83848",367,243,205,38,"10.4"
"21660","Z83849",925,47,14,33," 3.6"
"21661","Z83850",1047,83,15,68," 6.5"
"21662","Z83851",906,267,153,114,"12.6"
"21663","Z83852",422,22,0,22," 5.2"
"21664","Z83854",15776,897,193,704," 4.5"
"21665","Z83856",3653,1155,784,371,"10.2"
"21666","Z83857",364,33,0,33," 9.1"
"21667","Z83858",5974,891,642,249," 4.2"
"21668","Z83860",3738,1318,1079,239," 6.4"
"21669","Z83861",3290,688,319,369,"11.2"
"21670","Z83864",9580,2059,1452,607," 6.3"
"21671","Z83868",424,52,12,40," 9.4"
"21672","Z83869",2001,346,243,103," 5.1"
"21673","Z83871",794,68,17,51," 6.4"
"21674","Z83872",256,30,0,30,"11.7"
"21675","Z83873",1080,347,216,131,"12.1"
"21676","Z84001",374,45,0,45,"12.0"
"21677","Z84003",12102,333,108,225," 1.9"
"21678","Z84004",2889,126,0,126," 4.4"
"21679","Z84005",6058,95,0,95," 1.6"
"21680","Z84010",15688,633,85,548," 3.5"
"21681","Z84013",296,16,12,4," 1.4"
"21682","Z84014",5508,171,0,171," 3.1"
"21683","Z84015",20415,1024,19,1005," 4.9"
"21684","Z84017",2268,847,753,94," 4.1"
"21685","Z84020",13186,786,128,658," 5.0"
"21686","Z84021",2330,916,781,135," 5.8"
"21687","Z84022",575,297,21,276,"48.0"
"21688","Z84025",6346,212,54,158," 2.5"
"21689","Z84028",2084,1824,1621,203," 9.7"
"21690","Z84029",3063,156,1,155," 5.1"
"21691","Z84031",429,336,318,18," 4.2"
"21692","Z84032",7572,1694,1267,427," 5.6"
"21693","Z84033",356,30,0,30," 8.4"
"21694","Z84035",266,80,0,80,"30.1"
"21695","Z84036",2917,838,734,104," 3.6"
"21696","Z84037",9959,211,30,181," 1.8"
"21697","Z84039",359,78,28,50,"13.9"
"21698","Z84040",7341,288,60,228," 3.1"
"21699","Z84041",15748,582,0,582," 3.7"
"21700","Z84042",2701,135,4,131," 4.9"
"21701","Z84043",14759,579,109,470," 3.2"
"21702","Z84044",8362,412,26,386," 4.6"
"21703","Z84045",5088,70,25,45," 0.9"
"21704","Z84046",819,656,613,43," 5.3"
"21705","Z84047",13277,896,233,663," 5.0"
"21706","Z84049",2725,1173,948,225," 8.3"
"21707","Z84050",3170,176,61,115," 3.6"
"21708","Z84053",402,53,25,28," 7.0"
"21709","Z84054",5883,198,40,158," 2.7"
"21710","Z84055",1611,1199,1174,25," 1.6"
"21711","Z84057",11422,571,72,499," 4.4"
"21712","Z84058",10178,524,17,507," 5.0"
"21713","Z84060",9776,6503,5544,959," 9.8"
"21714","Z84062",12738,540,119,421," 3.3"
"21715","Z84063",175,20,0,20,"11.4"
"21716","Z84064",273,57,17,40,"14.7"
"21717","Z84065",11187,344,26,318," 2.8"
"21718","Z84066",4197,457,72,385," 9.2"
"21719","Z84067",12703,462,0,462," 3.6"
"21720","Z84070",9576,412,14,398," 4.2"
"21721","Z84071",452,34,21,13," 2.9"
"21722","Z84072",393,237,200,37," 9.4"
"21723","Z84074",15025,799,58,741," 4.9"
"21724","Z84075",7229,238,0,238," 3.3"
"21725","Z84078",10257,1174,209,965," 9.4"
"21726","Z84082",298,59,4,55,"18.5"
"21727","Z84083",624,157,42,115,"18.4"
"21728","Z84084",12226,589,0,589," 4.8"
"21729","Z84087",4622,103,11,92," 2.0"
"21730","Z84088",11518,507,25,482," 4.2"
"21731","Z84092",9583,826,361,465," 4.9"
"21732","Z84093",7516,172,53,119," 1.6"
"21733","Z84094",9125,290,24,266," 2.9"
"21734","Z84095",18116,1095,132,963," 5.3"
"21735","Z84096",10231,739,0,739," 7.2"
"21736","Z84097",6281,350,63,287," 4.6"
"21737","Z84098",9836,3272,2897,375," 3.8"
"21738","Z84101",2986,396,37,359,"12.0"
"21739","Z84102",9584,929,0,929," 9.7"
"21740","Z84103",11471,1241,216,1025," 8.9"
"21741","Z84104",8053,555,0,555," 6.9"
"21742","Z84105",9882,541,50,491," 5.0"
"21743","Z84106",14709,714,31,683," 4.6"
"21744","Z84107",14585,830,131,699," 4.8"
"21745","Z84108",8351,665,183,482," 5.8"
"21746","Z84109",9186,725,165,560," 6.1"
"21747","Z84111",6593,431,42,389," 5.9"
"21748","Z84115",10948,563,0,563," 5.1"
"21749","Z84116",11024,432,38,394," 3.6"
"21750","Z84117",10938,515,15,500," 4.6"
"21751","Z84118",19826,786,39,747," 3.8"
"21752","Z84119",17269,1145,11,1134," 6.6"
"21753","Z84120",13706,503,73,430," 3.1"
"21754","Z84121",17108,1518,562,956," 5.6"
"21755","Z84123",14272,330,0,330," 2.3"
"21756","Z84124",8418,369,51,318," 3.8"
"21757","Z84128",7345,297,0,297," 4.0"
"21758","Z84302",8489,577,44,533," 6.3"
"21759","Z84305",235,31,15,16," 6.8"
"21760","Z84310",2725,1223,1088,135," 5.0"
"21761","Z84312",1236,101,9,92," 7.4"
"21762","Z84314",352,16,0,16," 4.5"
"21763","Z84315",2410,46,0,46," 1.9"
"21764","Z84317",1764,919,887,32," 1.8"
"21765","Z84318",1205,38,0,38," 3.2"
"21766","Z84319",2366,261,75,186," 7.9"
"21767","Z84320",839,54,3,51," 6.1"
"21768","Z84321",15325,1301,299,1002," 6.5"
"21769","Z84325",658,27,0,27," 4.1"
"21770","Z84326",523,19,0,19," 3.6"
"21771","Z84327",300,7,7,0," 0.0"
"21772","Z84328",568,53,46,7," 1.2"
"21773","Z84332",2421,82,57,25," 1.0"
"21774","Z84333",921,34,0,34," 3.7"
"21775","Z84335",3780,192,70,122," 3.2"
"21776","Z84337",3845,220,6,214," 5.6"
"21777","Z84339",1554,134,33,101," 6.5"
"21778","Z84340",1235,105,30,75," 6.1"
"21779","Z84341",7516,563,47,516," 6.9"
"21780","Z84401",14479,1557,46,1511,"10.4"
"21781","Z84403",14071,955,64,891," 6.3"
"21782","Z84404",20396,1035,66,969," 4.8"
"21783","Z84405",11698,774,41,733," 6.3"
"21784","Z84414",9292,502,63,439," 4.7"
"21785","Z84501",5284,583,57,526,"10.0"
"21786","Z84511",1517,257,18,239,"15.8"
"21787","Z84512",623,257,141,116,"18.6"
"21788","Z84518",328,54,16,38,"11.6"
"21789","Z84523",669,110,25,85,"12.7"
"21790","Z84525",500,99,9,90,"18.0"
"21791","Z84526",2518,812,480,332,"13.2"
"21792","Z84528",1077,213,22,191,"17.7"
"21793","Z84531",263,93,34,59,"22.4"
"21794","Z84532",5077,1161,589,572,"11.3"
"21795","Z84534",837,346,180,166,"19.8"
"21796","Z84535",1202,373,158,215,"17.9"
"21797","Z84536",584,217,67,150,"25.7"
"21798","Z84537",796,319,224,95,"11.9"
"21799","Z84539",166,27,17,10," 6.0"
"21800","Z84542",785,85,18,67," 8.5"
"21801","Z84601",11207,533,31,502," 4.5"
"21802","Z84604",12937,1250,455,795," 6.1"
"21803","Z84606",10625,319,28,291," 2.7"
"21804","Z84620",403,38,25,13," 3.2"
"21805","Z84624",2156,256,81,175," 8.1"
"21806","Z84627",2086,237,41,196," 9.4"
"21807","Z84631",1239,224,85,139,"11.2"
"21808","Z84632",395,57,34,23," 5.8"
"21809","Z84633",343,22,5,17," 5.0"
"21810","Z84634",436,95,55,40," 9.2"
"21811","Z84639",327,35,13,22," 6.7"
"21812","Z84642",1222,84,40,44," 3.6"
"21813","Z84645",743,66,17,49," 6.6"
"21814","Z84646",640,61,21,40," 6.2"
"21815","Z84647",1771,481,331,150," 8.5"
"21816","Z84648",2041,235,83,152," 7.4"
"21817","Z84649",334,33,20,13," 3.9"
"21818","Z84651",6983,318,100,218," 3.1"
"21819","Z84653",2335,42,2,40," 1.7"
"21820","Z84654",1324,304,270,34," 2.6"
"21821","Z84655",2895,86,0,86," 3.0"
"21822","Z84656",188,42,19,23,"12.2"
"21823","Z84657",219,17,13,4," 1.8"
"21824","Z84660",10932,411,34,377," 3.4"
"21825","Z84663",9542,422,79,343," 3.6"
"21826","Z84664",2207,59,19,40," 1.8"
"21827","Z84665",160,52,35,17,"10.6"
"21828","Z84701",3465,536,238,298," 8.6"
"21829","Z84712",157,70,56,14," 8.9"
"21830","Z84713",1758,495,334,161," 9.2"
"21831","Z84714",362,176,117,59,"16.3"
"21832","Z84716",207,117,85,32,"15.5"
"21833","Z84720",7872,1157,400,757," 9.6"
"21834","Z84721",7447,933,271,662," 8.9"
"21835","Z84722",367,87,61,26," 7.1"
"21836","Z84723",342,87,42,45,"13.2"
"21837","Z84724",491,58,21,37," 7.5"
"21838","Z84725",649,178,91,87,"13.4"
"21839","Z84726",472,162,73,89,"18.9"
"21840","Z84729",165,65,48,17,"10.3"
"21841","Z84735",329,216,174,42,"12.8"
"21842","Z84737",6262,1058,575,483," 7.7"
"21843","Z84738",3231,388,246,142," 4.4"
"21844","Z84739",203,38,16,22,"10.8"
"21845","Z84741",2849,547,244,303,"10.6"
"21846","Z84745",1340,69,50,19," 1.4"
"21847","Z84747",518,204,136,68,"13.1"
"21848","Z84750",326,144,101,43,"13.2"
"21849","Z84751",741,121,56,65," 8.8"
"21850","Z84754",1454,194,99,95," 6.5"
"21851","Z84755",83,62,62,0," 0.0"
"21852","Z84759",1524,832,639,193,"12.7"
"21853","Z84760",340,114,101,13," 3.8"
"21854","Z84761",1496,370,236,134," 9.0"
"21855","Z84762",2441,2345,2149,196," 8.0"
"21856","Z84765",1978,159,39,120," 6.1"
"21857","Z84767",396,171,146,25," 6.3"
"21858","Z84770",18510,4616,3507,1109," 6.0"
"21859","Z84773",284,189,189,0," 0.0"
"21860","Z84774",589,72,46,26," 4.4"
"21861","Z84775",381,151,128,23," 6.0"
"21862","Z84776",262,35,15,20," 7.6"
"21863","Z84779",535,349,332,17," 3.2"
"21864","Z84780",9354,1861,1283,578," 6.2"
"21865","Z84782",283,39,39,0," 0.0"
"21866","Z84784",346,52,0,52,"15.0"
"21867","Z84790",15295,2267,1616,651," 4.3"
"21868","Z85003",4831,886,34,852,"17.6"
"21869","Z85004",2794,769,31,738,"26.4"
"21870","Z85006",10092,1482,57,1425,"14.1"
"21871","Z85007",5989,1116,15,1101,"18.4"
"21872","Z85008",23410,2822,96,2726,"11.6"
"21873","Z85009",14334,2494,0,2494,"17.4"
"21874","Z85012",3611,433,66,367,"10.2"
"21875","Z85013",11155,1439,211,1228,"11.0"
"21876","Z85014",14349,2686,458,2228,"15.5"
"21877","Z85015",16975,2759,145,2614,"15.4"
"21878","Z85016",19124,3062,722,2340,"12.2"
"21879","Z85017",13715,2228,124,2104,"15.3"
"21880","Z85018",19181,2673,451,2222,"11.6"
"21881","Z85019",8485,1462,66,1396,"16.5"
"21882","Z85020",17572,3101,627,2474,"14.1"
"21883","Z85021",17817,2581,116,2465,"13.8"
"21884","Z85022",23193,2506,230,2276," 9.8"
"21885","Z85023",13535,1757,299,1458,"10.8"
"21886","Z85024",10238,561,137,424," 4.1"
"21887","Z85027",16783,2025,339,1686,"10.0"
"21888","Z85028",8690,730,120,610," 7.0"
"21889","Z85029",18520,1876,197,1679," 9.1"
"21890","Z85031",8922,1530,0,1530,"17.1"
"21891","Z85032",29410,2639,654,1985," 6.7"
"21892","Z85033",16690,1518,25,1493," 8.9"
"21893","Z85034",1990,495,25,470,"23.6"
"21894","Z85035",15397,1402,25,1377," 8.9"
"21895","Z85037",15038,1665,143,1522,"10.1"
"21896","Z85040",10648,1513,86,1427,"13.4"
"21897","Z85041",18008,1712,57,1655," 9.2"
"21898","Z85042",14910,1821,168,1653,"11.1"
"21899","Z85043",9962,734,16,718," 7.2"
"21900","Z85044",18565,1874,598,1276," 6.9"
"21901","Z85045",2687,154,142,12," 0.4"
"21902","Z85048",13777,969,291,678," 4.9"
"21903","Z85050",12221,1062,473,589," 4.8"
"21904","Z85051",16629,2119,56,2063,"12.4"
"21905","Z85053",11834,996,78,918," 7.8"
"21906","Z85054",4055,941,612,329," 8.1"
"21907","Z85083",6552,410,99,311," 4.7"
"21908","Z85085",8244,936,367,569," 6.9"
"21909","Z85086",16049,2247,1240,1007," 6.3"
"21910","Z85087",3356,309,213,96," 2.9"
"21911","Z85201",21827,2784,449,2335,"10.7"
"21912","Z85202",17300,2142,359,1783,"10.3"
"21913","Z85203",13270,1340,272,1068," 8.0"
"21914","Z85204",23429,2419,450,1969," 8.4"
"21915","Z85205",22246,4702,3321,1381," 6.2"
"21916","Z85206",18251,3617,2406,1211," 6.6"
"21917","Z85207",20498,3455,2327,1128," 5.5"
"21918","Z85208",18612,4139,2904,1235," 6.6"
"21919","Z85209",19688,3966,3116,850," 4.3"
"21920","Z85210",14943,1651,109,1542,"10.3"
"21921","Z85212",8587,893,299,594," 6.9"
"21922","Z85213",14399,2307,1450,857," 6.0"
"21923","Z85215",9013,2250,1518,732," 8.1"
"21924","Z85224",18832,1162,244,918," 4.9"
"21925","Z85225",27760,2121,462,1659," 6.0"
"21926","Z85226",15605,982,130,852," 5.5"
"21927","Z85233",14427,1105,302,803," 5.6"
"21928","Z85234",17578,877,201,676," 3.8"
"21929","Z85248",17616,2940,1899,1041," 5.9"
"21930","Z85249",15049,1761,894,867," 5.8"
"21931","Z85250",10093,1541,936,605," 6.0"
"21932","Z85251",22888,4419,2083,2336,"10.2"
"21933","Z85253",8643,1496,923,573," 6.6"
"21934","Z85254",19942,2097,1079,1018," 5.1"
"21935","Z85255",19631,4080,2825,1255," 6.4"
"21936","Z85257",14344,1577,495,1082," 7.5"
"21937","Z85258",15709,4049,2890,1159," 7.4"
"21938","Z85259",10864,1699,855,844," 7.8"
"21939","Z85260",20327,3403,2130,1273," 6.3"
"21940","Z85262",7254,2766,2338,428," 5.9"
"21941","Z85263",2027,812,710,102," 5.0"
"21942","Z85266",6177,1332,1112,220," 3.6"
"21943","Z85268",14250,3175,2446,729," 5.1"
"21944","Z85281",25051,3776,242,3534,"14.1"
"21945","Z85282",23165,2679,331,2348,"10.1"
"21946","Z85283",19891,1587,182,1405," 7.1"
"21947","Z85284",6469,160,17,143," 2.2"
"21948","Z85286",14036,773,75,698," 5.0"
"21949","Z85295",14880,1355,331,1024," 6.9"
"21950","Z85296",13907,712,219,493," 3.5"
"21951","Z85297",9503,519,217,302," 3.2"
"21952","Z85298",9796,1101,659,442," 4.5"
"21953","Z85301",24184,3609,186,3423,"14.2"
"21954","Z85302",16099,2427,90,2337,"14.5"
"21955","Z85303",10063,1394,141,1253,"12.5"
"21956","Z85304",9844,496,71,425," 4.3"
"21957","Z85305",4613,529,225,304," 6.6"
"21958","Z85306",9618,937,27,910," 9.5"
"21959","Z85307",3378,561,0,561,"16.6"
"21960","Z85308",26272,2220,695,1525," 5.8"
"21961","Z85310",7084,454,185,269," 3.8"
"21962","Z85321",2724,820,323,497,"18.2"
"21963","Z85322",339,83,19,64,"18.9"
"21964","Z85323",12606,1409,247,1162," 9.2"
"21965","Z85324",1601,554,187,367,"22.9"
"21966","Z85325",933,419,325,94,"10.1"
"21967","Z85326",17323,2512,633,1879,"10.8"
"21968","Z85331",12577,1778,996,782," 6.2"
"21969","Z85332",1170,502,347,155,"13.2"
"21970","Z85333",320,141,61,80,"25.0"
"21971","Z85334",922,485,342,143,"15.5"
"21972","Z85335",11046,1269,488,781," 7.1"
"21973","Z85337",1026,196,19,177,"17.3"
"21974","Z85338",16896,2251,1054,1197," 7.1"
"21975","Z85339",12683,1437,141,1296,"10.2"
"21976","Z85340",10201,1113,351,762," 7.5"
"21977","Z85344",7344,3333,2523,810,"11.0"
"21978","Z85345",23221,2364,388,1976," 8.5"
"21979","Z85346",4161,1563,1197,366," 8.8"
"21980","Z85347",410,133,27,106,"25.9"
"21981","Z85348",1858,623,536,87," 4.7"
"21982","Z85349",8736,628,143,485," 5.6"
"21983","Z85350",6198,424,9,415," 6.7"
"21984","Z85351",21906,4505,2716,1789," 8.2"
"21985","Z85352",239,84,46,38,"15.9"
"21986","Z85353",10554,1104,69,1035," 9.8"
"21987","Z85354",2785,785,274,511,"18.3"
"21988","Z85356",2790,767,634,133," 4.8"
"21989","Z85361",2599,620,69,551,"21.2"
"21990","Z85362",600,275,126,149,"24.8"
"21991","Z85363",2589,318,88,230," 8.9"
"21992","Z85364",31101,4815,1576,3239,"10.4"
"21993","Z85365",24076,6240,4747,1493," 6.2"
"21994","Z85367",15282,5431,4811,620," 4.1"
"21995","Z85373",10712,1827,1120,707," 6.6"
"21996","Z85374",26641,6134,3770,2364," 8.9"
"21997","Z85375",20343,4222,2796,1426," 7.0"
"21998","Z85377",2336,727,504,223," 9.5"
"21999","Z85379",14503,1483,320,1163," 8.0"
"22000","Z85381",10782,1280,163,1117,"10.4"
"22001","Z85382",18961,2431,1062,1369," 7.2"
"22002","Z85383",15214,2133,1355,778," 5.1"
"22003","Z85387",5514,839,676,163," 3.0"
"22004","Z85388",8790,1083,285,798," 9.1"
"22005","Z85390",5279,1182,550,632,"12.0"
"22006","Z85392",13630,1493,228,1265," 9.3"
"22007","Z85395",11129,1480,1085,395," 3.5"
"22008","Z85396",6440,1460,916,544," 8.4"
"22009","Z85501",6337,1074,185,889,"14.0"
"22010","Z85533",1507,460,82,378,"25.1"
"22011","Z85534",1420,367,32,335,"23.6"
"22012","Z85539",2374,404,95,309,"13.0"
"22013","Z85540",1411,329,169,160,"11.3"
"22014","Z85541",14982,5567,4539,1028," 6.9"
"22015","Z85543",1453,248,0,248,"17.1"
"22016","Z85544",4047,3200,2912,288," 7.1"
"22017","Z85545",583,359,345,14," 2.4"
"22018","Z85546",7321,1257,223,1034,"14.1"
"22019","Z85550",1371,228,66,162,"11.8"
"22020","Z85552",2485,307,103,204," 8.2"
"22021","Z85553",1231,490,423,67," 5.4"
"22022","Z85601",454,120,14,106,"23.3"
"22023","Z85602",4985,811,103,708,"14.2"
"22024","Z85603",4499,1218,334,884,"19.6"
"22025","Z85605",331,123,61,62,"18.7"
"22026","Z85606",803,247,15,232,"28.9"
"22027","Z85607",5899,1351,182,1169,"19.8"
"22028","Z85610",726,272,74,198,"27.3"
"22029","Z85613",929,136,0,136,"14.6"
"22030","Z85614",15947,3773,2082,1691,"10.6"
"22031","Z85615",4352,461,191,270," 6.2"
"22032","Z85616",2684,401,78,323,"12.0"
"22033","Z85617",744,169,42,127,"17.1"
"22034","Z85620",340,83,0,83,"24.4"
"22035","Z85621",8326,1160,257,903,"10.8"
"22036","Z85622",5244,1474,996,478," 9.1"
"22037","Z85623",2419,397,32,365,"15.1"
"22038","Z85624",912,271,114,157,"17.2"
"22039","Z85625",1398,441,192,249,"17.8"
"22040","Z85626",416,63,20,43,"10.3"
"22041","Z85627",461,64,0,64,"13.9"
"22042","Z85629",8491,914,234,680," 8.0"
"22043","Z85630",1203,220,7,213,"17.7"
"22044","Z85631",1616,298,18,280,"17.3"
"22045","Z85635",16924,2554,240,2314,"13.7"
"22046","Z85638",1302,344,50,294,"22.6"
"22047","Z85640",272,59,41,18," 6.6"
"22048","Z85641",8886,875,238,637," 7.2"
"22049","Z85643",4443,983,143,840,"18.9"
"22050","Z85645",906,180,63,117,"12.9"
"22051","Z85646",1255,396,333,63," 5.0"
"22052","Z85648",6179,581,118,463," 7.5"
"22053","Z85650",7223,1027,238,789,"10.9"
"22054","Z85653",5778,858,53,805,"13.9"
"22055","Z85658",4909,677,272,405," 8.3"
"22056","Z85701",3206,412,163,249," 7.8"
"22057","Z85704",15924,2014,863,1151," 7.2"
"22058","Z85705",28231,4107,590,3517,"12.5"
"22059","Z85706",18508,1890,129,1761," 9.5"
"22060","Z85708",1260,73,0,73," 5.8"
"22061","Z85710",28045,2970,398,2572," 9.2"
"22062","Z85711",19529,2606,406,2200,"11.3"
"22063","Z85712",18409,2374,218,2156,"11.7"
"22064","Z85713",19205,2777,849,1928,"10.0"
"22065","Z85714",5727,664,0,664,"11.6"
"22066","Z85715",9187,1040,308,732," 8.0"
"22067","Z85716",18138,2481,403,2078,"11.5"
"22068","Z85718",15255,2411,1225,1186," 7.8"
"22069","Z85719",19872,2845,375,2470,"12.4"
"22070","Z85730",16926,1249,295,954," 5.6"
"22071","Z85735",4419,382,86,296," 6.7"
"22072","Z85736",2206,597,52,545,"24.7"
"22073","Z85737",9880,979,540,439," 4.4"
"22074","Z85739",9298,1432,692,740," 8.0"
"22075","Z85741",14341,1022,263,759," 5.3"
"22076","Z85742",10385,845,372,473," 4.6"
"22077","Z85743",11781,719,154,565," 4.8"
"22078","Z85745",16843,1772,524,1248," 7.4"
"22079","Z85746",15873,1962,477,1485," 9.4"
"22080","Z85747",8705,479,164,315," 3.6"
"22081","Z85748",7897,565,157,408," 5.2"
"22082","Z85749",8470,806,263,543," 6.4"
"22083","Z85750",13316,2231,1121,1110," 8.3"
"22084","Z85757",5921,531,14,517," 8.7"
"22085","Z85901",11521,5021,3589,1432,"12.4"
"22086","Z85912",141,50,11,39,"27.7"
"22087","Z85924",1957,887,380,507,"25.9"
"22088","Z85925",1963,523,281,242,"12.3"
"22089","Z85928",1157,678,581,97," 8.4"
"22090","Z85929",6154,2950,2384,566," 9.2"
"22091","Z85932",476,248,195,53,"11.1"
"22092","Z85933",4752,3706,3348,358," 7.5"
"22093","Z85935",6582,4540,4154,386," 5.9"
"22094","Z85936",1723,472,178,294,"17.1"
"22095","Z85937",2944,350,84,266," 9.0"
"22096","Z85938",1196,402,197,205,"17.1"
"22097","Z85939",1729,218,116,102," 5.9"
"22098","Z85940",878,339,181,158,"18.0"
"22099","Z85941",2902,277,47,230," 7.9"
"22100","Z86001",20649,3913,2637,1276," 6.2"
"22101","Z86004",15658,2051,1154,897," 5.7"
"22102","Z86017",3428,3076,2959,117," 3.4"
"22103","Z86020",804,195,137,58," 7.2"
"22104","Z86021",827,75,48,27," 3.3"
"22105","Z86022",1015,198,74,124,"12.2"
"22106","Z86023",939,284,26,258,"27.5"
"22107","Z86024",1904,1621,1547,74," 3.9"
"22108","Z86025",2207,338,77,261,"11.8"
"22109","Z86032",483,105,35,70,"14.5"
"22110","Z86036",321,177,121,56,"17.4"
"22111","Z86040",3901,753,507,246," 6.3"
"22112","Z86044",1604,556,265,291,"18.1"
"22113","Z86045",3711,620,407,213," 5.7"
"22114","Z86046",3868,1341,992,349," 9.0"
"22115","Z86047",5122,858,235,623,"12.2"
"22116","Z86301",10952,1318,748,570," 5.2"
"22117","Z86303",12025,3509,2656,853," 7.1"
"22118","Z86305",9899,1789,990,799," 8.1"
"22119","Z86314",14662,984,332,652," 4.4"
"22120","Z86322",5334,639,201,438," 8.2"
"22121","Z86323",7639,1021,372,649," 8.5"
"22122","Z86324",2015,84,82,2," 0.1"
"22123","Z86325",2670,414,170,244," 9.1"
"22124","Z86326",11300,1309,333,976," 8.6"
"22125","Z86327",5345,1151,753,398," 7.4"
"22126","Z86331",474,97,65,32," 6.8"
"22127","Z86332",1036,306,198,108,"10.4"
"22128","Z86333",3284,725,258,467,"14.2"
"22129","Z86334",1998,343,136,207,"10.4"
"22130","Z86335",2773,297,178,119," 4.3"
"22131","Z86336",7443,1642,1170,472," 6.3"
"22132","Z86337",1131,601,475,126,"11.1"
"22133","Z86338",373,132,102,30," 8.0"
"22134","Z86351",4347,1096,717,379," 8.7"
"22135","Z86401",11292,1901,456,1445,"12.8"
"22136","Z86403",10657,3799,3283,516," 4.8"
"22137","Z86404",11153,3561,2946,615," 5.5"
"22138","Z86406",13937,3863,2865,998," 7.2"
"22139","Z86409",12318,1652,497,1155," 9.4"
"22140","Z86413",5569,813,346,467," 8.4"
"22141","Z86426",7270,1698,1054,644," 8.9"
"22142","Z86429",5322,1899,1526,373," 7.0"
"22143","Z86438",662,263,139,124,"18.7"
"22144","Z86440",4663,1835,1300,535,"11.5"
"22145","Z86441",1646,566,362,204,"12.4"
"22146","Z86442",19571,5708,3165,2543,"13.0"
"22147","Z86505",3360,1297,545,752,"22.4"
"22148","Z86508",327,118,30,88,"26.9"
"22149","Z86510",2171,765,584,181," 8.3"
"22150","Z86511",1461,585,221,364,"24.9"
"22151","Z86512",929,326,118,208,"22.4"
"22152","Z86514",1419,739,371,368,"25.9"
"22153","Z86515",1744,505,200,305,"17.5"
"22154","Z86556",854,469,307,162,"19.0"
"22155","Z87001",997,99,23,76," 7.6"
"22156","Z87002",9251,1202,302,900," 9.7"
"22157","Z87004",4223,494,166,328," 7.8"
"22158","Z87006",294,35,29,6," 2.0"
"22159","Z87008",1313,177,121,56," 4.3"
"22160","Z87010",703,132,27,105,"14.9"
"22161","Z87013",2047,698,279,419,"20.5"
"22162","Z87015",5669,1116,482,634,"11.2"
"22163","Z87016",1537,459,246,213,"13.9"
"22164","Z87020",4299,526,77,449,"10.4"
"22165","Z87021",1178,202,10,192,"16.3"
"22166","Z87022",510,137,30,107,"21.0"
"22167","Z87025",1182,613,445,168,"14.2"
"22168","Z87026",1414,256,51,205,"14.5"
"22169","Z87031",16741,1740,146,1594," 9.5"
"22170","Z87035",3440,976,297,679,"19.7"
"22171","Z87036",1146,376,151,225,"19.6"
"22172","Z87041",326,46,25,21," 6.4"
"22173","Z87042",1457,80,0,80," 5.5"
"22174","Z87047",2307,398,140,258,"11.2"
"22175","Z87048",3828,225,9,216," 5.6"
"22176","Z87059",4493,676,265,411," 9.1"
"22177","Z87068",1900,107,27,80," 4.2"
"22178","Z87102",10373,1487,103,1384,"13.3"
"22179","Z87104",5862,488,114,374," 6.4"
"22180","Z87105",21416,2075,188,1887," 8.8"
"22181","Z87106",13030,1310,84,1226," 9.4"
"22182","Z87107",14001,919,75,844," 6.0"
"22183","Z87108",19302,2274,102,2172,"11.3"
"22184","Z87109",19511,1598,185,1413," 7.2"
"22185","Z87110",19068,2031,222,1809," 9.5"
"22186","Z87111",27346,1817,398,1419," 5.2"
"22187","Z87112",20109,1701,168,1533," 7.6"
"22188","Z87113",6225,454,69,385," 6.2"
"22189","Z87114",25570,1483,51,1432," 5.6"
"22190","Z87120",23963,1120,107,1013," 4.2"
"22191","Z87121",24055,1577,35,1542," 6.4"
"22192","Z87122",7360,481,96,385," 5.2"
"22193","Z87124",21465,1589,91,1498," 7.0"
"22194","Z87144",14446,1238,46,1192," 8.3"
"22195","Z87301",8526,1803,115,1688,"19.8"
"22196","Z87305",1317,468,127,341,"25.9"
"22197","Z87312",226,91,20,71,"31.4"
"22198","Z87313",2272,820,213,607,"26.7"
"22199","Z87317",523,173,0,173,"33.1"
"22200","Z87321",1185,566,280,286,"24.1"
"22201","Z87323",2080,815,297,518,"24.9"
"22202","Z87325",1379,580,253,327,"23.7"
"22203","Z87347",164,50,22,28,"17.1"
"22204","Z87401",17547,2668,327,2341,"13.3"
"22205","Z87402",3941,325,102,223," 5.7"
"22206","Z87410",7499,972,98,874,"11.7"
"22207","Z87412",440,142,62,80,"18.2"
"22208","Z87413",6269,996,181,815,"13.0"
"22209","Z87415",723,110,0,110,"15.2"
"22210","Z87417",2280,529,125,404,"17.7"
"22211","Z87418",418,29,0,29," 6.9"
"22212","Z87421",614,119,50,69,"11.2"
"22213","Z87499",222,91,22,69,"31.1"
"22214","Z87501",10715,2345,1256,1089,"10.2"
"22215","Z87505",17074,2899,1217,1682," 9.9"
"22216","Z87506",7068,1293,669,624," 8.8"
"22217","Z87507",18527,1342,496,846," 4.6"
"22218","Z87508",8422,684,229,455," 5.4"
"22219","Z87510",466,188,94,94,"20.2"
"22220","Z87511",1096,299,194,105," 9.6"
"22221","Z87513",388,57,12,45,"11.6"
"22222","Z87514",678,369,266,103,"15.2"
"22223","Z87520",1191,751,455,296,"24.9"
"22224","Z87522",1457,463,116,347,"23.8"
"22225","Z87527",342,24,0,24," 7.0"
"22226","Z87529",2643,647,358,289,"10.9"
"22227","Z87531",279,107,82,25," 9.0"
"22228","Z87532",8081,1360,252,1108,"13.7"
"22229","Z87535",527,158,27,131,"24.9"
"22230","Z87537",1261,331,53,278,"22.0"
"22231","Z87544",8313,698,307,391," 4.7"
"22232","Z87549",607,203,100,103,"17.0"
"22233","Z87552",1907,527,245,282,"14.8"
"22234","Z87553",632,183,54,129,"20.4"
"22235","Z87556",1441,430,232,198,"13.7"
"22236","Z87557",3113,442,197,245," 7.9"
"22237","Z87558",1442,1241,1005,236,"16.4"
"22238","Z87560",874,372,26,346,"39.6"
"22239","Z87562",315,61,0,61,"19.4"
"22240","Z87567",796,142,51,91,"11.4"
"22241","Z87571",6454,1811,1183,628," 9.7"
"22242","Z87578",373,158,59,99,"26.5"
"22243","Z87701",8929,1739,378,1361,"15.2"
"22244","Z87710",3050,2297,1827,470,"15.4"
"22245","Z87711",374,189,154,35," 9.4"
"22246","Z87715",446,201,84,117,"26.2"
"22247","Z87718",663,483,437,46," 6.9"
"22248","Z87732",771,358,81,277,"35.9"
"22249","Z87740",4190,948,121,827,"19.7"
"22250","Z87743",248,134,121,13," 5.2"
"22251","Z87747",831,239,112,127,"15.3"
"22252","Z87801",3987,1196,400,796,"20.0"
"22253","Z87827",206,109,93,16," 7.8"
"22254","Z87830",871,407,277,130,"14.9"
"22255","Z87832",400,159,121,38," 9.5"
"22256","Z87935",1835,1093,914,179," 9.8"
"22257","Z87937",1072,197,17,180,"16.8"
"22258","Z88001",15505,1889,110,1779,"11.5"
"22259","Z88002",615,163,0,163,"26.5"
"22260","Z88005",12112,847,95,752," 6.2"
"22261","Z88007",9434,940,235,705," 7.5"
"22262","Z88008",2406,164,41,123," 5.1"
"22263","Z88011",13849,1641,361,1280," 9.2"
"22264","Z88012",10347,861,131,730," 7.1"
"22265","Z88021",6119,650,116,534," 8.7"
"22266","Z88022",590,142,53,89,"15.1"
"22267","Z88023",1170,169,47,122,"10.4"
"22268","Z88026",688,144,44,100,"14.5"
"22269","Z88030",10074,1587,259,1328,"13.2"
"22270","Z88038",249,130,25,105,"42.2"
"22271","Z88039",374,300,254,46,"12.3"
"22272","Z88044",1460,123,32,91," 6.2"
"22273","Z88045",1639,292,21,271,"16.5"
"22274","Z88046",461,98,0,98,"21.3"
"22275","Z88047",811,72,47,25," 3.1"
"22276","Z88048",1095,76,19,57," 5.2"
"22277","Z88049",245,70,70,0," 0.0"
"22278","Z88061",9001,1393,500,893," 9.9"
"22279","Z88063",3786,312,41,271," 7.2"
"22280","Z88072",660,59,0,59," 8.9"
"22281","Z88081",4584,707,146,561,"12.2"
"22282","Z88101",19193,2192,222,1970,"10.3"
"22283","Z88116",240,61,16,45,"18.8"
"22284","Z88119",888,392,154,238,"26.8"
"22285","Z88124",606,144,39,105,"17.3"
"22286","Z88130",7662,1006,43,963,"12.6"
"22287","Z88135",705,81,0,81,"11.5"
"22288","Z88201",11236,1270,161,1109," 9.9"
"22289","Z88203",12322,1471,74,1397,"11.3"
"22290","Z88210",7424,982,38,944,"12.7"
"22291","Z88220",14526,1392,295,1097," 7.6"
"22292","Z88230",1935,316,28,288,"14.9"
"22293","Z88231",1360,180,15,165,"12.1"
"22294","Z88232",825,135,7,128,"15.5"
"22295","Z88240",14082,2131,288,1843,"13.1"
"22296","Z88242",2635,188,51,137," 5.2"
"22297","Z88252",1028,251,11,240,"23.3"
"22298","Z88256",875,117,31,86," 9.8"
"22299","Z88260",5252,685,0,685,"13.0"
"22300","Z88267",621,174,19,155,"25.0"
"22301","Z88301",869,299,91,208,"23.9"
"22302","Z88310",16942,2189,394,1795,"10.6"
"22303","Z88311",691,142,36,106,"15.3"
"22304","Z88312",3044,1785,1537,248," 8.1"
"22305","Z88316",1224,418,207,211,"17.2"
"22306","Z88317",2810,2183,1978,205," 7.3"
"22307","Z88318",281,132,62,70,"24.9"
"22308","Z88325",483,163,70,93,"19.3"
"22309","Z88330",1161,103,0,103," 8.9"
"22310","Z88336",183,52,19,33,"18.0"
"22311","Z88337",1214,211,28,183,"15.1"
"22312","Z88339",669,419,334,85,"12.7"
"22313","Z88340",975,163,30,133,"13.6"
"22314","Z88341",271,82,44,38,"14.0"
"22315","Z88345",9644,5807,4678,1129,"11.7"
"22316","Z88346",1576,419,193,226,"14.3"
"22317","Z88348",154,34,6,28,"18.2"
"22318","Z88352",2575,551,266,285,"11.1"
"22319","Z88353",311,195,159,36,"11.6"
"22320","Z88401",3742,1164,619,545,"14.6"
"22321","Z88415",1668,509,230,279,"16.7"
"22322","Z88418",180,57,13,44,"24.4"
"22323","Z88426",1240,770,727,43," 3.5"
"22324","Z88434",213,86,66,20," 9.4"
"22325","Z88435",1594,700,469,231,"14.5"
"22326","Z89001",541,86,22,64,"11.8"
"22327","Z89002",12159,1032,278,754," 6.2"
"22328","Z89003",811,370,165,205,"25.3"
"22329","Z89004",172,34,0,34,"19.8"
"22330","Z89005",7581,1215,496,719," 9.5"
"22331","Z89007",419,73,43,30," 7.2"
"22332","Z89008",698,223,45,178,"25.5"
"22333","Z89010",362,110,53,57,"15.7"
"22334","Z89011",10015,2374,655,1719,"17.2"
"22335","Z89012",13932,1678,424,1254," 9.0"
"22336","Z89014",16644,1573,448,1125," 6.8"
"22337","Z89015",16139,1615,281,1334," 8.3"
"22338","Z89017",60,7,7,0," 0.0"
"22339","Z89018",525,106,0,106,"20.2"
"22340","Z89019",1205,344,48,296,"24.6"
"22341","Z89020",460,116,37,79,"17.2"
"22342","Z89021",1175,150,36,114," 9.7"
"22343","Z89025",449,91,5,86,"19.2"
"22344","Z89027",9417,2439,1599,840," 8.9"
"22345","Z89029",5455,1645,1023,622,"11.4"
"22346","Z89030",15757,2556,71,2485,"15.8"
"22347","Z89031",21587,1817,330,1487," 6.9"
"22348","Z89032",15213,1571,140,1431," 9.4"
"22349","Z89040",1857,661,368,293,"15.8"
"22350","Z89043",718,353,297,56," 7.8"
"22351","Z89044",8674,863,490,373," 4.3"
"22352","Z89047",117,82,57,25,"21.4"
"22353","Z89048",10086,1847,608,1239,"12.3"
"22354","Z89049",1799,611,213,398,"22.1"
"22355","Z89052",22910,2507,1246,1261," 5.5"
"22356","Z89060",4897,886,382,504,"10.3"
"22357","Z89061",2640,426,96,330,"12.5"
"22358","Z89074",20760,2127,686,1441," 6.9"
"22359","Z89081",11147,1328,102,1226,"11.0"
"22360","Z89084",9583,1185,445,740," 7.7"
"22361","Z89085",1281,85,0,85," 6.6"
"22362","Z89101",18318,4701,369,4332,"23.6"
"22363","Z89102",16725,2986,335,2651,"15.9"
"22364","Z89103",26786,5418,2181,3237,"12.1"
"22365","Z89104",16279,2368,114,2254,"13.8"
"22366","Z89106",10349,1564,19,1545,"14.9"
"22367","Z89107",13917,1661,253,1408,"10.1"
"22368","Z89108",28370,3682,405,3277,"11.6"
"22369","Z89109",14091,10299,3243,7056,"50.1"
"22370","Z89110",23074,2222,188,2034," 8.8"
"22371","Z89113",11976,1756,840,916," 7.6"
"22372","Z89115",21673,4153,142,4011,"18.5"
"22373","Z89117",26754,4648,1475,3173,"11.9"
"22374","Z89118",10031,1833,659,1174,"11.7"
"22375","Z89119",25654,5628,1708,3920,"15.3"
"22376","Z89120",10118,776,184,592," 5.9"
"22377","Z89121",28168,4476,942,3534,"12.5"
"22378","Z89122",20065,2766,1012,1754," 8.7"
"22379","Z89123",27823,5005,2032,2973,"10.7"
"22380","Z89124",730,385,293,92,"12.6"
"22381","Z89128",16772,2162,738,1424," 8.5"
"22382","Z89129",21114,1692,475,1217," 5.8"
"22383","Z89130",13286,1134,122,1012," 7.6"
"22384","Z89131",16792,1441,356,1085," 6.5"
"22385","Z89134",12901,1175,542,633," 4.9"
"22386","Z89135",12645,1950,736,1214," 9.6"
"22387","Z89138",5362,624,356,268," 5.0"
"22388","Z89139",13154,1716,288,1428,"10.9"
"22389","Z89141",10611,1134,302,832," 7.8"
"22390","Z89142",11474,1385,172,1213,"10.6"
"22391","Z89143",4389,502,112,390," 8.9"
"22392","Z89144",8252,1098,355,743," 9.0"
"22393","Z89145",10952,1623,672,951," 8.7"
"22394","Z89146",8006,1448,302,1146,"14.3"
"22395","Z89147",21902,3515,1317,2198,"10.0"
"22396","Z89148",18034,2424,447,1977,"11.0"
"22397","Z89149",15069,1964,474,1490," 9.9"
"22398","Z89156",10520,1729,127,1602,"15.2"
"22399","Z89166",5411,769,171,598,"11.1"
"22400","Z89169",12819,3629,647,2982,"23.3"
"22401","Z89178",12652,1715,312,1403,"11.1"
"22402","Z89179",1621,195,77,118," 7.3"
"22403","Z89183",15637,1807,391,1416," 9.1"
"22404","Z89301",3222,854,350,504,"15.6"
"22405","Z89310",380,129,113,16," 4.2"
"22406","Z89311",125,76,56,20,"16.0"
"22407","Z89318",645,158,74,84,"13.0"
"22408","Z89403",6086,459,72,387," 6.4"
"22409","Z89406",10738,1263,46,1217,"11.3"
"22410","Z89408",7806,920,44,876,"11.2"
"22411","Z89410",4891,486,62,424," 8.7"
"22412","Z89411",629,216,129,87,"13.8"
"22413","Z89412",216,62,33,29,"13.4"
"22414","Z89413",815,561,469,92,"11.3"
"22415","Z89415",2154,552,68,484,"22.5"
"22416","Z89419",1841,221,85,136," 7.4"
"22417","Z89421",278,76,10,66,"23.7"
"22418","Z89423",4710,334,93,241," 5.1"
"22419","Z89425",297,54,33,21," 7.1"
"22420","Z89429",3367,593,0,593,"17.6"
"22421","Z89431",15383,1591,209,1382," 9.0"
"22422","Z89433",7131,617,154,463," 6.5"
"22423","Z89434",10859,755,80,675," 6.2"
"22424","Z89436",15012,809,127,682," 4.5"
"22425","Z89439",775,51,35,16," 2.1"
"22426","Z89440",521,50,27,23," 4.4"
"22427","Z89441",4372,290,120,170," 3.9"
"22428","Z89442",442,40,5,35," 7.9"
"22429","Z89444",1343,188,58,130," 9.7"
"22430","Z89445",6522,773,111,662,"10.2"
"22431","Z89447",4097,703,75,628,"15.3"
"22432","Z89448",1722,1004,862,142," 8.2"
"22433","Z89449",2251,765,561,204," 9.1"
"22434","Z89450",151,46,46,0," 0.0"
"22435","Z89451",7719,3824,3251,573," 7.4"
"22436","Z89460",5662,417,235,182," 3.2"
"22437","Z89501",2993,666,81,585,"19.5"
"22438","Z89502",19804,2251,180,2071,"10.5"
"22439","Z89503",12293,1373,78,1295,"10.5"
"22440","Z89506",13873,783,52,731," 5.3"
"22441","Z89508",4680,389,102,287," 6.1"
"22442","Z89509",17190,1461,247,1214," 7.1"
"22443","Z89510",803,143,12,131,"16.3"
"22444","Z89511",11304,835,224,611," 5.4"
"22445","Z89512",10999,1549,113,1436,"13.1"
"22446","Z89519",3936,294,97,197," 5.0"
"22447","Z89521",11274,1085,433,652," 5.8"
"22448","Z89523",14232,1034,260,774," 5.4"
"22449","Z89701",10532,737,100,637," 6.0"
"22450","Z89703",4780,367,120,247," 5.2"
"22451","Z89705",2159,68,34,34," 1.6"
"22452","Z89706",8810,837,132,705," 8.0"
"22453","Z89801",9275,934,506,428," 4.6"
"22454","Z89815",5194,208,162,46," 0.9"
"22455","Z89820",2201,273,129,144," 6.5"
"22456","Z89828",260,36,36,0," 0.0"
"22457","Z89832",646,68,32,36," 5.6"
"22458","Z89835",918,223,115,108,"11.8"
"22459","Z89883",1490,144,0,144," 9.7"
"22460","Z90001",14164,726,26,700," 4.9"
"22461","Z90002",12878,744,9,735," 5.7"
"22462","Z90003",17595,1308,5,1303," 7.4"
"22463","Z90004",24624,1898,204,1694," 6.9"
"22464","Z90005",16831,1008,8,1000," 5.9"
"22465","Z90006",20590,1434,45,1389," 6.7"
"22466","Z90007",12724,1017,42,975," 7.7"
"22467","Z90008",15614,1244,116,1128," 7.2"
"22468","Z90010",2418,238,20,218," 9.0"
"22469","Z90011",24202,1468,26,1442," 6.0"
"22470","Z90012",11688,1030,122,908," 7.8"
"22471","Z90013",7560,968,109,859,"11.4"
"22472","Z90014",5111,455,0,455," 8.9"
"22473","Z90015",8678,995,190,805," 9.3"
"22474","Z90016",18104,958,15,943," 5.2"
"22475","Z90017",11305,1324,104,1220,"10.8"
"22476","Z90018",17093,1164,33,1131," 6.6"
"22477","Z90019",25626,1313,57,1256," 4.9"
"22478","Z90020",17868,1443,10,1433," 8.0"
"22479","Z90021",1994,282,0,282,"14.1"
"22480","Z90022",18112,896,139,757," 4.2"
"22481","Z90023",11692,567,8,559," 4.8"
"22482","Z90024",19300,2154,363,1791," 9.3"
"22483","Z90025",23120,1186,245,941," 4.1"
"22484","Z90026",26715,1576,60,1516," 5.7"
"22485","Z90027",23454,1501,149,1352," 5.8"
"22486","Z90028",18062,2189,440,1749," 9.7"
"22487","Z90029",15116,947,83,864," 5.7"
"22488","Z90031",12118,688,0,688," 5.7"
"22489","Z90032",13900,789,28,761," 5.5"
"22490","Z90033",13948,838,101,737," 5.3"
"22491","Z90034",27422,1653,39,1614," 5.9"
"22492","Z90035",14154,962,33,929," 6.6"
"22493","Z90036",20175,1573,246,1327," 6.6"
"22494","Z90037",17943,1340,23,1317," 7.3"
"22495","Z90038",12847,1066,226,840," 6.5"
"22496","Z90039",12443,1000,15,985," 7.9"
"22497","Z90040",3592,127,9,118," 3.3"
"22498","Z90041",10080,489,22,467," 4.6"
"22499","Z90042",21126,1280,142,1138," 5.4"
"22500","Z90043",18010,1379,27,1352," 7.5"
"22501","Z90044",29039,2713,28,2685," 9.2"
"22502","Z90045",16651,911,129,782," 4.7"
"22503","Z90046",31322,2253,113,2140," 6.8"
"22504","Z90047",17889,1285,97,1188," 6.6"
"22505","Z90048",13016,1059,222,837," 6.4"
"22506","Z90049",17968,1709,406,1303," 7.3"
"22507","Z90056",3653,182,17,165," 4.5"
"22508","Z90057",17502,1353,16,1337," 7.6"
"22509","Z90058",855,53,3,50," 5.8"
"22510","Z90061",7656,433,0,433," 5.7"
"22511","Z90062",10099,659,0,659," 6.5"
"22512","Z90063",14305,915,48,867," 6.1"
"22513","Z90064",11292,521,16,505," 4.5"
"22514","Z90065",15918,987,86,901," 5.7"
"22515","Z90066",25557,1123,178,945," 3.7"
"22516","Z90067",1941,513,262,251,"12.9"
"22517","Z90068",13892,2047,700,1347," 9.7"
"22518","Z90069",13783,1232,231,1001," 7.3"
"22519","Z90077",3838,497,156,341," 8.9"
"22520","Z90210",9478,1080,204,876," 9.2"
"22521","Z90211",4017,503,52,451,"11.2"
"22522","Z90212",6134,418,166,252," 4.1"
"22523","Z90220",14013,831,32,799," 5.7"
"22524","Z90221",12617,731,0,731," 5.8"
"22525","Z90222",8334,502,0,502," 6.0"
"22526","Z90230",13456,541,69,472," 3.5"
"22527","Z90232",6869,481,32,449," 6.5"
"22528","Z90240",7589,408,0,408," 5.4"
"22529","Z90241",13860,420,21,399," 2.9"
"22530","Z90242",12684,567,100,467," 3.7"
"22531","Z90245",7203,456,92,364," 5.1"
"22532","Z90247",16897,844,32,812," 4.8"
"22533","Z90248",3631,199,30,169," 4.7"
"22534","Z90249",9044,305,17,288," 3.2"
"22535","Z90250",33481,1668,69,1599," 4.8"
"22536","Z90254",10460,1263,886,377," 3.6"
"22537","Z90255",19085,629,20,609," 3.2"
"22538","Z90260",11048,547,104,443," 4.0"
"22539","Z90262",15729,595,0,595," 3.8"
"22540","Z90265",9442,2236,1320,916," 9.7"
"22541","Z90266",15321,1677,1003,674," 4.4"
"22542","Z90270",6558,180,9,171," 2.6"
"22543","Z90272",9817,632,241,391," 4.0"
"22544","Z90274",10149,707,260,447," 4.4"
"22545","Z90275",16720,859,349,510," 3.1"
"22546","Z90277",17537,1456,671,785," 4.5"
"22547","Z90278",16329,899,210,689," 4.2"
"22548","Z90280",24165,767,111,656," 2.7"
"22549","Z90290",2820,473,190,283,"10.0"
"22550","Z90291",15533,1754,407,1347," 8.7"
"22551","Z90292",13763,1800,479,1321," 9.6"
"22552","Z90293",6880,191,82,109," 1.6"
"22553","Z90301",12673,523,20,503," 4.0"
"22554","Z90302",11595,736,18,718," 6.2"
"22555","Z90303",7716,389,27,362," 4.7"
"22556","Z90304",6891,356,11,345," 5.0"
"22557","Z90305",6236,382,14,368," 5.9"
"22558","Z90401",5164,478,161,317," 6.1"
"22559","Z90402",5804,639,325,314," 5.4"
"22560","Z90403",15041,1322,327,995," 6.6"
"22561","Z90404",10615,807,82,725," 6.8"
"22562","Z90405",15387,1133,362,771," 5.0"
"22563","Z90501",15319,1101,188,913," 6.0"
"22564","Z90502",6206,565,108,457," 7.4"
"22565","Z90503",18267,997,405,592," 3.2"
"22566","Z90504",12178,713,140,573," 4.7"
"22567","Z90505",14793,598,167,431," 2.9"
"22568","Z90601",11525,467,26,441," 3.8"
"22569","Z90602",8558,442,46,396," 4.6"
"22570","Z90603",6797,305,15,290," 4.3"
"22571","Z90604",12388,448,29,419," 3.4"
"22572","Z90605",11055,504,68,436," 3.9"
"22573","Z90606",8905,366,34,332," 3.7"
"22574","Z90620",13188,326,33,293," 2.2"
"22575","Z90621",10555,516,8,508," 4.8"
"22576","Z90623",5079,58,12,46," 0.9"
"22577","Z90630",16263,302,12,290," 1.8"
"22578","Z90631",22213,862,20,842," 3.8"
"22579","Z90638",14934,417,84,333," 2.2"
"22580","Z90640",21441,1615,0,1615," 7.5"
"22581","Z90650",28391,1166,90,1076," 3.8"
"22582","Z90660",17209,615,191,424," 2.5"
"22583","Z90670",4883,245,0,245," 5.0"
"22584","Z90680",9560,397,24,373," 3.9"
"22585","Z90701",4715,157,0,157," 3.3"
"22586","Z90703",15782,637,83,554," 3.5"
"22587","Z90704",2287,947,637,310,"13.6"
"22588","Z90706",24737,1561,61,1500," 6.1"
"22589","Z90710",9310,388,20,368," 4.0"
"22590","Z90712",11241,636,14,622," 5.5"
"22591","Z90713",9725,365,10,355," 3.7"
"22592","Z90715",6305,440,10,430," 6.8"
"22593","Z90716",4002,146,0,146," 3.6"
"22594","Z90717",9076,540,155,385," 4.2"
"22595","Z90720",7998,250,97,153," 1.9"
"22596","Z90723",14395,551,25,526," 3.7"
"22597","Z90731",24205,2016,275,1741," 7.2"
"22598","Z90732",9115,684,108,576," 6.3"
"22599","Z90740",13806,1431,442,989," 7.2"
"22600","Z90742",477,117,98,19," 4.0"
"22601","Z90743",282,116,98,18," 6.4"
"22602","Z90744",14847,575,23,552," 3.7"
"22603","Z90745",15729,603,69,534," 3.4"
"22604","Z90746",8211,164,25,139," 1.7"
"22605","Z90755",4183,155,13,142," 3.4"
"22606","Z90802",23008,2372,499,1873," 8.1"
"22607","Z90803",18240,1245,359,886," 4.9"
"22608","Z90804",15536,854,17,837," 5.4"
"22609","Z90805",27794,1686,4,1682," 6.1"
"22610","Z90806",13153,750,45,705," 5.4"
"22611","Z90807",13364,687,38,649," 4.9"
"22612","Z90808",14449,330,25,305," 2.1"
"22613","Z90810",9554,375,0,375," 3.9"
"22614","Z90813",17769,1194,58,1136," 6.4"
"22615","Z90814",9577,314,33,281," 2.9"
"22616","Z90815",15129,650,23,627," 4.1"
"22617","Z91001",13610,885,110,775," 5.7"
"22618","Z91006",11295,860,207,653," 5.8"
"22619","Z91007",12813,1005,209,796," 6.2"
"22620","Z91010",8133,258,45,213," 2.6"
"22621","Z91011",7053,449,64,385," 5.5"
"22622","Z91016",15416,940,125,815," 5.3"
"22623","Z91020",3630,414,16,398,"11.0"
"22624","Z91024",4925,387,151,236," 4.8"
"22625","Z91030",11037,777,71,706," 6.4"
"22626","Z91040",7582,497,14,483," 6.4"
"22627","Z91042",10587,610,56,554," 5.2"
"22628","Z91101",11722,919,178,741," 6.3"
"22629","Z91103",8886,562,56,506," 5.7"
"22630","Z91104",13760,796,34,762," 5.5"
"22631","Z91105",5792,438,66,372," 6.4"
"22632","Z91106",11523,945,124,821," 7.1"
"22633","Z91107",13509,1103,120,983," 7.3"
"22634","Z91108",5006,360,58,302," 6.0"
"22635","Z91201",8507,324,8,316," 3.7"
"22636","Z91202",9241,525,14,511," 5.5"
"22637","Z91203",5230,418,61,357," 6.8"
"22638","Z91204",6067,243,22,221," 3.6"
"22639","Z91205",14664,471,31,440," 3.0"
"22640","Z91206",13737,812,35,777," 5.7"
"22641","Z91207",4272,310,13,297," 7.0"
"22642","Z91208",6229,382,66,316," 5.1"
"22643","Z91210",320,62,35,27," 8.4"
"22644","Z91214",10981,528,21,507," 4.6"
"22645","Z91301",9685,439,63,376," 3.9"
"22646","Z91302",9634,499,84,415," 4.3"
"22647","Z91303",10158,692,64,628," 6.2"
"22648","Z91304",17814,815,83,732," 4.1"
"22649","Z91306",14977,530,26,504," 3.4"
"22650","Z91307",8790,209,77,132," 1.5"
"22651","Z91311",14319,604,31,573," 4.0"
"22652","Z91316",13048,713,119,594," 4.6"
"22653","Z91321",11328,355,39,316," 2.8"
"22654","Z91324",10144,592,52,540," 5.3"
"22655","Z91325",12430,655,0,655," 5.3"
"22656","Z91326",12638,281,115,166," 1.3"
"22657","Z91331",23246,840,41,799," 3.4"
"22658","Z91335",24637,1204,151,1053," 4.3"
"22659","Z91340",8790,449,10,439," 5.0"
"22660","Z91342",25490,1301,84,1217," 4.8"
"22661","Z91343",17984,690,18,672," 3.7"
"22662","Z91344",17686,637,18,619," 3.5"
"22663","Z91345",5432,307,20,287," 5.3"
"22664","Z91350",11410,138,0,138," 1.2"
"22665","Z91351",10437,324,16,308," 3.0"
"22666","Z91352",12773,503,11,492," 3.9"
"22667","Z91354",10100,441,44,397," 3.9"
"22668","Z91355",13071,371,44,327," 2.5"
"22669","Z91356",12119,860,61,799," 6.6"
"22670","Z91360",15458,452,66,386," 2.5"
"22671","Z91361",9019,480,133,347," 3.8"
"22672","Z91362",14103,511,221,290," 2.1"
"22673","Z91364",11079,836,66,770," 7.0"
"22674","Z91367",18694,1205,259,946," 5.1"
"22675","Z91377",5510,122,0,122," 2.2"
"22676","Z91381",6752,212,0,212," 3.1"
"22677","Z91384",7318,258,29,229," 3.1"
"22678","Z91387",14138,668,0,668," 4.7"
"22679","Z91390",6719,299,53,246," 3.7"
"22680","Z91401",15640,736,25,711," 4.5"
"22681","Z91402",19447,785,12,773," 4.0"
"22682","Z91403",11880,544,116,428," 3.6"
"22683","Z91405",17791,838,63,775," 4.4"
"22684","Z91406",18492,743,30,713," 3.9"
"22685","Z91411",9974,454,17,437," 4.4"
"22686","Z91423",16029,845,151,694," 4.3"
"22687","Z91436",5796,414,101,313," 5.4"
"22688","Z91501",8163,403,39,364," 4.5"
"22689","Z91502",5679,438,15,423," 7.4"
"22690","Z91505",13460,482,101,381," 2.8"
"22691","Z91506",7590,382,38,344," 4.5"
"22692","Z91601",17662,1047,42,1005," 5.7"
"22693","Z91602",10129,853,235,618," 6.1"
"22694","Z91604",15356,1059,266,793," 5.2"
"22695","Z91605",16546,852,40,812," 4.9"
"22696","Z91606",15925,728,8,720," 4.5"
"22697","Z91607",14087,733,107,626," 4.4"
"22698","Z91701",13266,434,11,423," 3.2"
"22699","Z91702",15815,1021,187,834," 5.3"
"22700","Z91706",19062,1052,147,905," 4.7"
"22701","Z91709",24686,990,243,747," 3.0"
"22702","Z91710",22857,1323,106,1217," 5.3"
"22703","Z91711",12739,817,289,528," 4.1"
"22704","Z91722",10362,340,0,340," 3.3"
"22705","Z91723",6439,271,0,271," 4.2"
"22706","Z91724",8432,348,5,343," 4.1"
"22707","Z91730",24219,1262,71,1191," 4.9"
"22708","Z91731",9466,774,5,769," 8.1"
"22709","Z91732",17492,1062,69,993," 5.7"
"22710","Z91733",11809,664,41,623," 5.3"
"22711","Z91737",8368,124,0,124," 1.5"
"22712","Z91739",11606,289,0,289," 2.5"
"22713","Z91740",8577,194,23,171," 2.0"
"22714","Z91741",9184,439,160,279," 3.0"
"22715","Z91744",19154,796,41,755," 3.9"
"22716","Z91745",16972,942,56,886," 5.2"
"22717","Z91746",6822,215,5,210," 3.1"
"22718","Z91748",14164,688,205,483," 3.4"
"22719","Z91750",12395,507,138,369," 3.0"
"22720","Z91752",8605,539,65,474," 5.5"
"22721","Z91754",11708,1039,102,937," 8.0"
"22722","Z91755",8995,558,35,523," 5.8"
"22723","Z91759",351,144,102,42,"12.0"
"22724","Z91761",17123,801,40,761," 4.4"
"22725","Z91762",17749,1053,73,980," 5.5"
"22726","Z91763",11231,820,36,784," 7.0"
"22727","Z91764",16508,1345,56,1289," 7.8"
"22728","Z91765",15820,842,201,641," 4.1"
"22729","Z91766",19054,1052,98,954," 5.0"
"22730","Z91767",14801,741,43,698," 4.7"
"22731","Z91768",8562,342,44,298," 3.5"
"22732","Z91770",18054,969,103,866," 4.8"
"22733","Z91773",12753,679,77,602," 4.7"
"22734","Z91775",8677,407,87,320," 3.7"
"22735","Z91776",12617,1073,205,868," 6.9"
"22736","Z91780",12112,695,146,549," 4.5"
"22737","Z91784",9508,357,98,259," 2.7"
"22738","Z91786",20531,1470,110,1360," 6.6"
"22739","Z91789",13619,766,225,541," 4.0"
"22740","Z91790",12834,375,0,375," 2.9"
"22741","Z91791",10496,486,30,456," 4.3"
"22742","Z91792",9334,548,45,503," 5.4"
"22743","Z91801",20675,1172,108,1064," 5.1"
"22744","Z91803",10319,678,27,651," 6.3"
"22745","Z91901",6812,301,174,127," 1.9"
"22746","Z91902",6351,342,54,288," 4.5"
"22747","Z91906",1393,272,99,173,"12.4"
"22748","Z91910",28518,2590,322,2268," 8.0"
"22749","Z91911",26369,1866,192,1674," 6.3"
"22750","Z91913",14860,1138,113,1025," 6.9"
"22751","Z91914",5007,273,138,135," 2.7"
"22752","Z91915",8260,623,135,488," 5.9"
"22753","Z91916",784,178,49,129,"16.5"
"22754","Z91917",250,46,22,24," 9.6"
"22755","Z91931",199,49,28,21,"10.6"
"22756","Z91932",9823,809,286,523," 5.3"
"22757","Z91934",486,300,146,154,"31.7"
"22758","Z91935",2989,312,96,216," 7.2"
"22759","Z91941",12523,468,62,406," 3.2"
"22760","Z91942",17792,1095,25,1070," 6.0"
"22761","Z91945",8988,423,66,357," 4.0"
"22762","Z91950",17064,1378,138,1240," 7.3"
"22763","Z91962",872,148,85,63," 7.2"
"22764","Z91977",19753,1225,55,1170," 5.9"
"22765","Z91978",3332,219,8,211," 6.3"
"22766","Z92003",2007,320,64,256,"12.8"
"22767","Z92004",2982,1693,1203,490,"16.4"
"22768","Z92008",12966,1483,609,874," 6.7"
"22769","Z92009",17119,764,372,392," 2.3"
"22770","Z92010",5802,105,45,60," 1.0"
"22771","Z92011",10400,1153,598,555," 5.3"
"22772","Z92014",6908,967,612,355," 5.1"
"22773","Z92019",15754,671,108,563," 3.6"
"22774","Z92020",20177,806,46,760," 3.8"
"22775","Z92021",23277,1470,34,1436," 6.2"
"22776","Z92024",20663,1699,961,738," 3.6"
"22777","Z92025",15781,683,46,637," 4.0"
"22778","Z92026",17772,968,176,792," 4.5"
"22779","Z92027",16597,555,30,525," 3.2"
"22780","Z92028",17811,1149,217,932," 5.2"
"22781","Z92029",7319,428,118,310," 4.2"
"22782","Z92036",2232,882,649,233,"10.4"
"22783","Z92037",19971,3175,1872,1303," 6.5"
"22784","Z92040",15801,1063,21,1042," 6.6"
"22785","Z92054",17908,2571,1266,1305," 7.3"
"22786","Z92056",20222,777,139,638," 3.2"
"22787","Z92057",19741,1126,162,964," 4.9"
"22788","Z92058",15229,1513,99,1414," 9.3"
"22789","Z92061",881,285,166,119,"13.5"
"22790","Z92064",16453,590,95,495," 3.0"
"22791","Z92065",12718,1080,359,721," 5.7"
"22792","Z92066",196,35,35,0," 0.0"
"22793","Z92067",4152,954,619,335," 8.1"
"22794","Z92069",15372,759,71,688," 4.5"
"22795","Z92070",578,153,91,62,"10.7"
"22796","Z92071",20140,843,98,745," 3.7"
"22797","Z92075",6094,753,530,223," 3.7"
"22798","Z92078",17821,931,259,672," 3.8"
"22799","Z92081",10992,540,38,502," 4.6"
"22800","Z92082",6759,545,72,473," 7.0"
"22801","Z92083",11260,442,0,442," 3.9"
"22802","Z92084",15938,601,50,551," 3.5"
"22803","Z92086",948,285,135,150,"15.8"
"22804","Z92091",654,25,25,0," 0.0"
"22805","Z92101",24932,4401,1817,2584,"10.4"
"22806","Z92102",15553,1074,125,949," 6.1"
"22807","Z92103",19331,1670,273,1397," 7.2"
"22808","Z92104",22396,1657,202,1455," 6.5"
"22809","Z92105",22508,1316,73,1243," 5.5"
"22810","Z92106",7888,637,220,417," 5.3"
"22811","Z92107",14223,1565,302,1263," 8.9"
"22812","Z92108",11767,1406,214,1192,"10.1"
"22813","Z92109",25924,3503,1847,1656," 6.4"
"22814","Z92110",11925,779,132,647," 5.4"
"22815","Z92111",17483,590,141,449," 2.6"
"22816","Z92113",13707,874,40,834," 6.1"
"22817","Z92114",18436,849,114,735," 4.0"
"22818","Z92115",22609,2013,30,1983," 8.8"
"22819","Z92116",17251,950,129,821," 4.8"
"22820","Z92117",21487,702,139,563," 2.6"
"22821","Z92118",10883,2383,1707,676," 6.2"
"22822","Z92119",9707,205,10,195," 2.0"
"22823","Z92120",11436,648,81,567," 5.0"
"22824","Z92121",1687,133,17,116," 6.9"
"22825","Z92122",21097,1629,524,1105," 5.2"
"22826","Z92123",11388,546,96,450," 4.0"
"22827","Z92124",11459,754,86,668," 5.8"
"22828","Z92126",24395,991,53,938," 3.8"
"22829","Z92127",14490,615,188,427," 2.9"
"22830","Z92128",21153,1032,428,604," 2.9"
"22831","Z92129",17948,609,93,516," 2.9"
"22832","Z92130",18872,874,332,542," 2.9"
"22833","Z92131",11820,284,93,191," 1.6"
"22834","Z92139",10999,670,80,590," 5.4"
"22835","Z92145",592,32,23,9," 1.5"
"22836","Z92154",22257,891,167,724," 3.3"
"22837","Z92173",8206,284,22,262," 3.2"
"22838","Z92201",22801,3582,2052,1530," 6.7"
"22839","Z92203",13063,2833,2055,778," 6.0"
"22840","Z92210",5135,2463,2110,353," 6.9"
"22841","Z92211",20842,8369,6185,2184,"10.5"
"22842","Z92220",13311,1467,148,1319," 9.9"
"22843","Z92223",16600,1047,104,943," 5.7"
"22844","Z92225",9201,3221,2082,1139,"12.4"
"22845","Z92227",8994,1176,199,977,"10.9"
"22846","Z92230",1053,93,0,93," 8.8"
"22847","Z92231",10864,1413,194,1219,"11.2"
"22848","Z92234",21149,3795,2626,1169," 5.5"
"22849","Z92236",11198,714,137,577," 5.2"
"22850","Z92240",14668,2878,1508,1370," 9.3"
"22851","Z92241",6463,2386,1814,572," 8.9"
"22852","Z92243",16083,2313,448,1865,"11.6"
"22853","Z92249",2082,325,51,274,"13.2"
"22854","Z92250",3032,544,114,430,"14.2"
"22855","Z92251",5954,756,104,652,"11.0"
"22856","Z92252",5396,1598,1084,514," 9.5"
"22857","Z92253",23864,8915,7102,1813," 7.6"
"22858","Z92254",3265,262,70,192," 5.9"
"22859","Z92256",2042,497,199,298,"14.6"
"22860","Z92257",1405,624,274,350,"24.9"
"22861","Z92258",264,51,0,51,"19.3"
"22862","Z92260",24427,8620,6736,1884," 7.7"
"22863","Z92262",18918,6376,4384,1992,"10.5"
"22864","Z92264",17905,7003,5694,1309," 7.3"
"22865","Z92268",514,250,185,65,"12.6"
"22866","Z92270",15662,6486,5124,1362," 8.7"
"22867","Z92273",516,105,27,78,"15.1"
"22868","Z92274",6387,1109,386,723,"11.3"
"22869","Z92275",1222,670,469,201,"16.4"
"22870","Z92276",3921,1108,880,228," 5.8"
"22871","Z92277",12420,3209,1375,1834,"14.8"
"22872","Z92281",821,227,19,208,"25.3"
"22873","Z92283",1576,740,378,362,"23.0"
"22874","Z92284",12345,2055,979,1076," 8.7"
"22875","Z92301",9240,1274,155,1119,"12.1"
"22876","Z92305",634,464,366,98,"15.5"
"22877","Z92307",14024,1597,280,1317," 9.4"
"22878","Z92308",15932,1973,567,1406," 8.8"
"22879","Z92309",325,66,6,60,"18.5"
"22880","Z92310",2718,381,53,328,"12.1"
"22881","Z92311",13236,2034,158,1876,"14.2"
"22882","Z92313",4515,144,0,144," 3.2"
"22883","Z92314",9080,4645,4299,346," 3.8"
"22884","Z92315",10065,7760,7270,490," 4.9"
"22885","Z92316",7750,397,9,388," 5.0"
"22886","Z92320",3811,465,40,425,"11.2"
"22887","Z92322",840,475,358,117,"13.9"
"22888","Z92324",18475,1685,74,1611," 8.7"
"22889","Z92325",6407,2904,2551,353," 5.5"
"22890","Z92327",417,181,0,181,"43.4"
"22891","Z92333",1045,806,771,35," 3.3"
"22892","Z92335",24579,1058,43,1015," 4.1"
"22893","Z92336",23555,833,34,799," 3.4"
"22894","Z92337",9718,392,0,392," 4.0"
"22895","Z92339",681,270,220,50," 7.3"
"22896","Z92342",2992,694,375,319,"10.7"
"22897","Z92344",6489,580,209,371," 5.7"
"22898","Z92345",25556,2133,508,1625," 6.4"
"22899","Z92352",8612,6004,5509,495," 5.7"
"22900","Z92354",8119,708,0,708," 8.7"
"22901","Z92356",3281,1008,511,497,"15.1"
"22902","Z92358",554,93,35,58,"10.5"
"22903","Z92359",3179,301,14,287," 9.0"
"22904","Z92363",4129,1820,1420,400," 9.7"
"22905","Z92365",1243,505,179,326,"26.2"
"22906","Z92368",439,155,15,140,"31.9"
"22907","Z92371",5885,732,287,445," 7.6"
"22908","Z92373",14697,1261,125,1136," 7.7"
"22909","Z92374",13813,1055,25,1030," 7.5"
"22910","Z92376",22161,1119,22,1097," 5.0"
"22911","Z92377",5593,366,20,346," 6.2"
"22912","Z92378",73,6,0,6," 8.2"
"22913","Z92382",4077,2030,1862,168," 4.1"
"22914","Z92386",3509,2532,2220,312," 8.9"
"22915","Z92391",1797,821,662,159," 8.8"
"22916","Z92392",17400,1891,288,1603," 9.2"
"22917","Z92394",8767,1047,77,970,"11.1"
"22918","Z92395",14789,1724,419,1305," 8.8"
"22919","Z92397",2934,1046,707,339,"11.6"
"22920","Z92398",673,192,77,115,"17.1"
"22921","Z92399",20219,1634,115,1519," 7.5"
"22922","Z92401",734,78,0,78,"10.6"
"22923","Z92404",18923,1744,162,1582," 8.4"
"22924","Z92405",9016,661,44,617," 6.8"
"22925","Z92407",16812,1075,61,1014," 6.0"
"22926","Z92408",4117,399,34,365," 8.9"
"22927","Z92410",13551,1212,70,1142," 8.4"
"22928","Z92411",6932,470,0,470," 6.8"
"22929","Z92501",7492,651,38,613," 8.2"
"22930","Z92503",25917,815,30,785," 3.0"
"22931","Z92504",17119,1131,257,874," 5.1"
"22932","Z92505",14739,1342,160,1182," 8.0"
"22933","Z92506",16333,1015,69,946," 5.8"
"22934","Z92507",18982,2685,221,2464,"13.0"
"22935","Z92508",10647,438,8,430," 4.0"
"22936","Z92509",20513,1217,155,1062," 5.2"
"22937","Z92518",734,225,0,225,"30.7"
"22938","Z92530",15989,1255,143,1112," 7.0"
"22939","Z92532",6581,656,0,656,"10.0"
"22940","Z92539",2166,605,331,274,"12.7"
"22941","Z92543",15180,1910,113,1797,"11.8"
"22942","Z92544",17558,2132,374,1758,"10.0"
"22943","Z92545",17098,2223,588,1635," 9.6"
"22944","Z92548",2678,458,87,371,"13.9"
"22945","Z92549",4190,2958,2736,222," 5.3"
"22946","Z92551",8349,359,53,306," 3.7"
"22947","Z92553",20040,1270,132,1138," 5.7"
"22948","Z92555",11437,753,62,691," 6.0"
"22949","Z92557",15164,814,54,760," 5.0"
"22950","Z92561",1209,495,367,128,"10.6"
"22951","Z92562",21203,1336,491,845," 4.0"
"22952","Z92563",17942,1013,132,881," 4.9"
"22953","Z92567",2863,182,41,141," 4.9"
"22954","Z92570",14912,1160,118,1042," 7.0"
"22955","Z92571",12951,901,44,857," 6.6"
"22956","Z92582",4614,298,48,250," 5.4"
"22957","Z92583",10765,1240,270,970," 9.0"
"22958","Z92584",14741,828,130,698," 4.7"
"22959","Z92585",6269,558,102,456," 7.3"
"22960","Z92586",9945,1009,180,829," 8.3"
"22961","Z92590",1893,270,193,77," 4.1"
"22962","Z92591",13605,958,116,842," 6.2"
"22963","Z92592",24717,1546,505,1041," 4.2"
"22964","Z92595",9646,508,104,404," 4.2"
"22965","Z92596",7674,446,92,354," 4.6"
"22966","Z92602",8699,221,82,139," 1.6"
"22967","Z92603",8061,296,186,110," 1.4"
"22968","Z92604",10537,369,99,270," 2.6"
"22969","Z92606",8535,494,56,438," 5.1"
"22970","Z92610",4272,252,26,226," 5.3"
"22971","Z92612",13475,1237,321,916," 6.8"
"22972","Z92614",10015,279,69,210," 2.1"
"22973","Z92618",11256,789,89,700," 6.2"
"22974","Z92620",17104,802,66,736," 4.3"
"22975","Z92624",3318,567,435,132," 4.0"
"22976","Z92625",6609,899,496,403," 6.1"
"22977","Z92626",20272,1202,110,1092," 5.4"
"22978","Z92627",23038,920,166,754," 3.3"
"22979","Z92629",13366,1832,1295,537," 4.0"
"22980","Z92630",21332,815,87,728," 3.4"
"22981","Z92637",13058,1760,767,993," 7.6"
"22982","Z92646",21920,895,391,504," 2.3"
"22983","Z92647",20724,696,111,585," 2.8"
"22984","Z92648",20594,1327,756,571," 2.8"
"22985","Z92649",14537,757,310,447," 3.1"
"22986","Z92651",13913,2305,1480,825," 5.9"
"22987","Z92653",10028,562,132,430," 4.3"
"22988","Z92655",2659,20,0,20," 0.8"
"22989","Z92656",20245,1043,261,782," 3.9"
"22990","Z92657",4263,390,248,142," 3.3"
"22991","Z92660",16300,1618,594,1024," 6.3"
"22992","Z92661",2410,814,621,193," 8.0"
"22993","Z92662",2025,533,401,132," 6.5"
"22994","Z92663",12034,1365,856,509," 4.2"
"22995","Z92672",16263,2052,1073,979," 6.0"
"22996","Z92673",10675,785,272,513," 4.8"
"22997","Z92675",12596,739,240,499," 4.0"
"22998","Z92676",883,85,21,64," 7.2"
"22999","Z92677",26923,1900,648,1252," 4.7"
"23000","Z92678",232,20,20,0," 0.0"
"23001","Z92679",10947,350,32,318," 2.9"
"23002","Z92683",28438,1101,85,1016," 3.6"
"23003","Z92688",16842,904,53,851," 5.1"
"23004","Z92691",16613,494,62,432," 2.6"
"23005","Z92692",18353,345,0,345," 1.9"
"23006","Z92694",7582,221,36,185," 2.4"
"23007","Z92701",13031,382,16,366," 2.8"
"23008","Z92703",13467,246,37,209," 1.6"
"23009","Z92704",20415,613,139,474," 2.3"
"23010","Z92705",15692,756,34,722," 4.6"
"23011","Z92706",9740,352,8,344," 3.5"
"23012","Z92707",13690,427,41,386," 2.8"
"23013","Z92708",19536,450,78,372," 1.9"
"23014","Z92780",19682,698,11,687," 3.5"
"23015","Z92782",8671,399,65,334," 3.9"
"23016","Z92801",18849,688,13,675," 3.6"
"23017","Z92802",12196,510,33,477," 3.9"
"23018","Z92804",25751,1873,28,1845," 7.2"
"23019","Z92805",19036,839,107,732," 3.8"
"23020","Z92806",13063,697,49,648," 5.0"
"23021","Z92807",12777,591,98,493," 3.9"
"23022","Z92808",7601,204,49,155," 2.0"
"23023","Z92821",13800,570,227,343," 2.5"
"23024","Z92831",13129,933,110,823," 6.3"
"23025","Z92832",8508,408,0,408," 4.8"
"23026","Z92833",16600,620,16,604," 3.6"
"23027","Z92835",8682,267,99,168," 1.9"
"23028","Z92840",15519,590,7,583," 3.8"
"23029","Z92841",9473,210,0,210," 2.2"
"23030","Z92843",11531,305,59,246," 2.1"
"23031","Z92844",6823,141,0,141," 2.1"
"23032","Z92845",5806,141,31,110," 1.9"
"23033","Z92860",7356,326,14,312," 4.2"
"23034","Z92861",1975,53,4,49," 2.5"
"23035","Z92865",6421,267,36,231," 3.6"
"23036","Z92866",5781,336,20,316," 5.5"
"23037","Z92867",13512,451,33,418," 3.1"
"23038","Z92868",7838,195,0,195," 2.5"
"23039","Z92869",11860,318,0,318," 2.7"
"23040","Z92870",17095,563,65,498," 2.9"
"23041","Z92879",15101,765,47,718," 4.8"
"23042","Z92880",16393,504,132,372," 2.3"
"23043","Z92881",9984,297,0,297," 3.0"
"23044","Z92882",22022,932,87,845," 3.8"
"23045","Z92883",10535,559,47,512," 4.9"
"23046","Z92886",16552,298,25,273," 1.6"
"23047","Z92887",7024,382,21,361," 5.1"
"23048","Z93001",14126,1364,732,632," 4.5"
"23049","Z93003",20288,936,219,717," 3.5"
"23050","Z93004",10996,269,63,206," 1.9"
"23051","Z93010",16286,621,54,567," 3.5"
"23052","Z93012",13319,537,239,298," 2.2"
"23053","Z93013",7021,713,450,263," 3.7"
"23054","Z93015",5151,321,0,321," 6.2"
"23055","Z93021",11580,422,0,422," 3.6"
"23056","Z93022",2602,89,28,61," 2.3"
"23057","Z93023",8719,1060,312,748," 8.6"
"23058","Z93030",15856,673,59,614," 3.9"
"23059","Z93033",18138,877,110,767," 4.2"
"23060","Z93035",12124,2409,1672,737," 6.1"
"23061","Z93036",12768,405,22,383," 3.0"
"23062","Z93041",8584,1276,553,723," 8.4"
"23063","Z93060",10019,514,60,454," 4.5"
"23064","Z93063",19487,397,27,370," 1.9"
"23065","Z93065",24669,680,123,557," 2.3"
"23066","Z93066",1160,35,0,35," 3.0"
"23067","Z93067",615,128,75,53," 8.6"
"23068","Z93101",13295,938,186,752," 5.7"
"23069","Z93103",7791,813,319,494," 6.3"
"23070","Z93105",11507,701,247,454," 3.9"
"23071","Z93108",5537,1231,949,282," 5.1"
"23072","Z93109",4756,414,195,219," 4.6"
"23073","Z93110",6797,473,154,319," 4.7"
"23074","Z93111",6684,346,38,308," 4.6"
"23075","Z93117",16849,1120,191,929," 5.5"
"23076","Z93201",379,41,0,41,"10.8"
"23077","Z93202",1144,87,0,87," 7.6"
"23078","Z93203",5369,383,23,360," 6.7"
"23079","Z93204",2314,158,0,158," 6.8"
"23080","Z93205",1220,210,158,52," 4.3"
"23081","Z93206",690,112,0,112,"16.2"
"23082","Z93210",4929,250,0,250," 5.1"
"23083","Z93212",4383,266,0,266," 6.1"
"23084","Z93215",12424,695,56,639," 5.1"
"23085","Z93218",325,46,3,43,"13.2"
"23086","Z93219",2506,103,6,97," 3.9"
"23087","Z93221",5393,445,0,445," 8.3"
"23088","Z93223",2701,79,0,79," 2.9"
"23089","Z93225",2565,683,366,317,"12.4"
"23090","Z93230",22671,1616,152,1464," 6.5"
"23091","Z93234",1936,207,17,190," 9.8"
"23092","Z93235",1144,96,0,96," 8.4"
"23093","Z93238",1175,334,209,125,"10.6"
"23094","Z93239",457,63,0,63,"13.8"
"23095","Z93240",3554,1073,393,680,"19.1"
"23096","Z93241",4463,275,28,247," 5.5"
"23097","Z93242",1108,60,5,55," 5.0"
"23098","Z93243",815,248,91,157,"19.3"
"23099","Z93245",12769,775,72,703," 5.5"
"23100","Z93247",5404,365,49,316," 5.8"
"23101","Z93249",595,46,11,35," 5.9"
"23102","Z93250",3244,87,0,87," 2.7"
"23103","Z93251",108,34,6,28,"25.9"
"23104","Z93252",803,232,126,106,"13.2"
"23105","Z93256",1497,176,19,157,"10.5"
"23106","Z93257",23211,1867,76,1791," 7.7"
"23107","Z93258",580,43,0,43," 7.4"
"23108","Z93263",5422,331,1,330," 6.1"
"23109","Z93265",2076,505,254,251,"12.1"
"23110","Z93266",382,34,24,10," 2.6"
"23111","Z93267",2002,166,0,166," 8.3"
"23112","Z93268",6156,649,38,611," 9.9"
"23113","Z93270",1622,212,16,196,"12.1"
"23114","Z93271",1386,322,244,78," 5.6"
"23115","Z93272",1009,37,5,32," 3.2"
"23116","Z93274",22663,1278,46,1232," 5.4"
"23117","Z93277",19551,1458,148,1310," 6.7"
"23118","Z93280",6043,473,28,445," 7.4"
"23119","Z93283",1348,250,172,78," 5.8"
"23120","Z93285",2327,1332,1093,239,"10.3"
"23121","Z93286",3024,184,0,184," 6.1"
"23122","Z93291",16859,892,142,750," 4.4"
"23123","Z93292",13923,619,0,619," 4.4"
"23124","Z93301",5328,566,33,533,"10.0"
"23125","Z93304",16920,1374,20,1354," 8.0"
"23126","Z93305",12081,1330,17,1313,"10.9"
"23127","Z93306",22812,1752,104,1648," 7.2"
"23128","Z93307",23586,1662,69,1593," 6.8"
"23129","Z93308",20882,1761,194,1567," 7.5"
"23130","Z93309",23421,1796,117,1679," 7.2"
"23131","Z93311",14897,814,182,632," 4.2"
"23132","Z93312",19337,824,29,795," 4.1"
"23133","Z93313",12900,556,7,549," 4.3"
"23134","Z93314",8044,313,130,183," 2.3"
"23135","Z93401",12629,808,331,477," 3.8"
"23136","Z93402",6929,438,271,167," 2.4"
"23137","Z93405",8970,687,222,465," 5.2"
"23138","Z93420",13061,1201,675,526," 4.0"
"23139","Z93422",12964,663,181,482," 3.7"
"23140","Z93424",902,298,235,63," 7.0"
"23141","Z93426",1148,722,670,52," 4.5"
"23142","Z93427",2316,315,152,163," 7.0"
"23143","Z93428",4254,1311,971,340," 8.0"
"23144","Z93430",2583,1132,1047,85," 3.3"
"23145","Z93432",558,175,108,67,"12.0"
"23146","Z93433",6043,590,373,217," 3.6"
"23147","Z93434",1921,59,20,39," 2.0"
"23148","Z93436",18649,851,165,686," 3.7"
"23149","Z93437",926,53,0,53," 5.7"
"23150","Z93441",516,86,56,30," 5.8"
"23151","Z93442",6780,1560,1364,196," 2.9"
"23152","Z93444",7338,652,113,539," 7.3"
"23153","Z93445",3051,587,321,266," 8.7"
"23154","Z93446",19151,2119,1350,769," 4.0"
"23155","Z93449",5248,1381,1093,288," 5.5"
"23156","Z93450",297,24,6,18," 6.1"
"23157","Z93451",1500,142,62,80," 5.3"
"23158","Z93452",280,122,122,0," 0.0"
"23159","Z93453",1564,151,55,96," 6.1"
"23160","Z93454",12421,1035,140,895," 7.2"
"23161","Z93455",16020,918,131,787," 4.9"
"23162","Z93458",13586,460,46,414," 3.0"
"23163","Z93460",2399,413,231,182," 7.6"
"23164","Z93461",619,94,17,77,"12.4"
"23165","Z93463",3700,325,157,168," 4.5"
"23166","Z93465",3604,378,61,317," 8.8"
"23167","Z93501",2422,493,97,396,"16.4"
"23168","Z93505",5677,1218,91,1127,"19.9"
"23169","Z93510",2808,288,80,208," 7.4"
"23170","Z93513",819,100,74,26," 3.2"
"23171","Z93514",6854,823,458,365," 5.3"
"23172","Z93516",1260,414,139,275,"21.8"
"23173","Z93523",1514,367,80,287,"19.0"
"23174","Z93526",491,134,121,13," 2.6"
"23175","Z93527",998,188,97,91," 9.1"
"23176","Z93531",247,82,82,0," 0.0"
"23177","Z93532",1145,183,46,137,"12.0"
"23178","Z93534",15811,1755,210,1545," 9.8"
"23179","Z93535",23247,2346,892,1454," 6.3"
"23180","Z93536",22807,1897,407,1490," 6.5"
"23181","Z93541",310,187,187,0," 0.0"
"23182","Z93543",3967,368,91,277," 7.0"
"23183","Z93544",596,141,72,69,"11.6"
"23184","Z93545",1065,197,167,30," 2.8"
"23185","Z93546",10618,7450,6237,1213,"11.4"
"23186","Z93549",294,153,112,41,"13.9"
"23187","Z93550",22886,2238,124,2114," 9.2"
"23188","Z93551",16962,1117,149,968," 5.7"
"23189","Z93552",10724,787,154,633," 5.9"
"23190","Z93553",894,105,45,60," 6.7"
"23191","Z93555",15189,2009,485,1524,"10.0"
"23192","Z93560",7548,1247,178,1069,"14.2"
"23193","Z93561",12874,1964,627,1337,"10.4"
"23194","Z93563",179,42,42,0," 0.0"
"23195","Z93591",2191,275,35,240,"11.0"
"23196","Z93601",846,116,32,84," 9.9"
"23197","Z93602",1967,361,302,59," 3.0"
"23198","Z93604",1307,970,863,107," 8.2"
"23199","Z93606",215,29,29,0," 0.0"
"23200","Z93609",1635,77,4,73," 4.5"
"23201","Z93610",5796,792,430,362," 6.2"
"23202","Z93611",16366,533,28,505," 3.1"
"23203","Z93612",14538,1040,35,1005," 6.9"
"23204","Z93614",4950,693,366,327," 6.6"
"23205","Z93615",1592,110,9,101," 6.3"
"23206","Z93616",631,35,8,27," 4.3"
"23207","Z93618",8419,364,14,350," 4.2"
"23208","Z93619",11118,660,52,608," 5.5"
"23209","Z93620",3256,386,58,328,"10.1"
"23210","Z93622",2979,217,42,175," 5.9"
"23211","Z93624",343,44,5,39,"11.4"
"23212","Z93625",2170,90,0,90," 4.1"
"23213","Z93626",574,99,41,58,"10.1"
"23214","Z93630",5626,442,159,283," 5.0"
"23215","Z93631",5426,271,89,182," 3.4"
"23216","Z93635",12230,815,54,761," 6.2"
"23217","Z93636",4126,265,150,115," 2.8"
"23218","Z93637",12523,993,277,716," 5.7"
"23219","Z93638",12977,914,430,484," 3.7"
"23220","Z93640",3109,62,0,62," 2.0"
"23221","Z93643",1768,612,476,136," 7.7"
"23222","Z93644",4245,938,633,305," 7.2"
"23223","Z93646",2857,184,0,184," 6.4"
"23224","Z93647",2999,119,5,114," 3.8"
"23225","Z93648",4249,250,25,225," 5.3"
"23226","Z93650",1354,6,6,0," 0.0"
"23227","Z93651",767,137,0,137,"17.9"
"23228","Z93652",96,27,0,27,"28.1"
"23229","Z93654",9187,535,46,489," 5.3"
"23230","Z93656",1833,112,12,100," 5.5"
"23231","Z93657",11488,927,227,700," 6.1"
"23232","Z93660",1285,152,34,118," 9.2"
"23233","Z93662",9188,476,38,438," 4.8"
"23234","Z93664",2299,2032,1838,194," 8.4"
"23235","Z93665",223,31,0,31,"13.9"
"23236","Z93667",1053,156,0,156,"14.8"
"23237","Z93668",381,48,34,14," 3.7"
"23238","Z93669",256,112,67,45,"17.6"
"23239","Z93675",1420,274,36,238,"16.8"
"23240","Z93701",3790,752,0,752,"19.8"
"23241","Z93702",12961,946,6,940," 7.3"
"23242","Z93703",10834,1120,18,1102,"10.2"
"23243","Z93704",11761,1048,88,960," 8.2"
"23244","Z93705",13013,790,62,728," 5.6"
"23245","Z93706",11695,1065,57,1008," 8.6"
"23246","Z93710",12250,1049,63,986," 8.0"
"23247","Z93711",16795,1109,314,795," 4.7"
"23248","Z93720",18633,1025,132,893," 4.8"
"23249","Z93721",1909,179,29,150," 7.9"
"23250","Z93722",26053,1719,156,1563," 6.0"
"23251","Z93723",3203,173,128,45," 1.4"
"23252","Z93725",7262,452,29,423," 5.8"
"23253","Z93726",14869,832,21,811," 5.5"
"23254","Z93727",24141,1527,13,1514," 6.3"
"23255","Z93728",6199,582,22,560," 9.0"
"23256","Z93730",3997,141,65,76," 1.9"
"23257","Z93901",10349,604,18,586," 5.7"
"23258","Z93905",13575,523,0,523," 3.9"
"23259","Z93906",18002,945,0,945," 5.2"
"23260","Z93907",7547,411,40,371," 4.9"
"23261","Z93908",4789,216,26,190," 4.0"
"23262","Z93920",540,228,195,33," 6.1"
"23263","Z93923",7293,1521,1110,411," 5.6"
"23264","Z93924",3149,592,405,187," 5.9"
"23265","Z93926",2264,8,0,8," 0.4"
"23266","Z93927",4339,386,93,293," 6.8"
"23267","Z93930",4128,154,82,72," 1.7"
"23268","Z93933",9026,668,117,551," 6.1"
"23269","Z93940",15328,2005,795,1210," 7.9"
"23270","Z93950",8431,1599,747,852,"10.1"
"23271","Z93953",2856,1005,836,169," 5.9"
"23272","Z93955",11027,688,81,607," 5.5"
"23273","Z93960",4221,244,16,228," 5.4"
"23274","Z93962",293,64,22,42,"14.3"
"23275","Z94002",10677,343,160,183," 1.7"
"23276","Z94005",1842,59,0,59," 3.2"
"23277","Z94010",17561,1197,290,907," 5.2"
"23278","Z94014",14310,715,150,565," 3.9"
"23279","Z94015",20653,737,140,597," 2.9"
"23280","Z94019",7707,686,259,427," 5.5"
"23281","Z94022",7843,420,70,350," 4.5"
"23282","Z94024",8090,220,52,168," 2.1"
"23283","Z94025",15646,814,190,624," 4.0"
"23284","Z94027",2602,126,22,104," 4.0"
"23285","Z94028",2815,170,125,45," 1.6"
"23286","Z94030",8602,437,110,327," 3.8"
"23287","Z94037",1119,94,39,55," 4.9"
"23288","Z94038",1188,50,50,0," 0.0"
"23289","Z94040",14497,511,66,445," 3.1"
"23290","Z94041",6483,235,0,235," 3.6"
"23291","Z94043",13331,753,160,593," 4.4"
"23292","Z94044",14767,631,74,557," 3.8"
"23293","Z94060",601,127,67,60,"10.0"
"23294","Z94061",14244,369,90,279," 2.0"
"23295","Z94062",10961,689,169,520," 4.7"
"23296","Z94063",9726,513,53,460," 4.7"
"23297","Z94065",5186,211,62,149," 2.9"
"23298","Z94066",15412,513,50,463," 3.0"
"23299","Z94070",12300,443,26,417," 3.4"
"23300","Z94080",22394,1155,166,989," 4.4"
"23301","Z94085",8652,411,0,411," 4.8"
"23302","Z94086",19663,577,133,444," 2.3"
"23303","Z94087",21183,836,192,644," 3.0"
"23304","Z94089",8061,381,49,332," 4.1"
"23305","Z94102",19137,2674,361,2313,"12.1"
"23306","Z94103",15026,2298,320,1978,"13.2"
"23307","Z94105",4870,1092,957,135," 2.8"
"23308","Z94107",15104,1361,650,711," 4.7"
"23309","Z94108",8753,886,266,620," 7.1"
"23310","Z94109",37050,3329,838,2491," 6.7"
"23311","Z94110",29845,1826,322,1504," 5.0"
"23312","Z94111",2634,516,327,189," 7.2"
"23313","Z94112",24319,996,102,894," 3.7"
"23314","Z94114",17877,1421,444,977," 5.5"
"23315","Z94115",19224,1492,288,1204," 6.3"
"23316","Z94116",16569,743,99,644," 3.9"
"23317","Z94117",19720,1358,268,1090," 5.5"
"23318","Z94118",18707,1044,162,882," 4.7"
"23319","Z94121",18955,1567,450,1117," 5.9"
"23320","Z94122",24056,1174,159,1015," 4.2"
"23321","Z94123",15217,1255,359,896," 5.9"
"23322","Z94124",11282,781,0,781," 6.9"
"23323","Z94127",7579,371,135,236," 3.1"
"23324","Z94129",1324,66,5,61," 4.6"
"23325","Z94130",806,182,0,182,"22.6"
"23326","Z94131",13912,658,139,519," 3.7"
"23327","Z94132",11056,665,150,515," 4.7"
"23328","Z94133",14813,1583,545,1038," 7.0"
"23329","Z94134",12315,654,130,524," 4.3"
"23330","Z94158",3258,329,158,171," 5.2"
"23331","Z94301",7564,433,62,371," 4.9"
"23332","Z94303",14266,726,20,706," 4.9"
"23333","Z94304",2025,188,46,142," 7.0"
"23334","Z94306",11152,511,148,363," 3.3"
"23335","Z94401",13626,643,87,556," 4.1"
"23336","Z94402",9654,376,92,284," 2.9"
"23337","Z94403",16239,817,174,643," 4.0"
"23338","Z94404",14612,589,119,470," 3.2"
"23339","Z94501",26883,1356,242,1114," 4.1"
"23340","Z94502",5361,180,46,134," 2.5"
"23341","Z94503",6023,162,9,153," 2.5"
"23342","Z94505",5737,596,419,177," 3.1"
"23343","Z94506",8089,217,0,217," 2.7"
"23344","Z94507",5820,241,96,145," 2.5"
"23345","Z94508",1284,179,83,96," 7.5"
"23346","Z94509",23152,1564,8,1556," 6.7"
"23347","Z94510",11482,621,53,568," 4.9"
"23348","Z94513",19323,665,26,639," 3.3"
"23349","Z94514",405,29,2,27," 6.7"
"23350","Z94515",3592,722,467,255," 7.1"
"23351","Z94517",4886,227,14,213," 4.4"
"23352","Z94518",10780,517,6,511," 4.7"
"23353","Z94519",7337,501,0,501," 6.8"
"23354","Z94520",13692,646,0,646," 4.7"
"23355","Z94521",16432,578,36,542," 3.3"
"23356","Z94523",14406,371,74,297," 2.1"
"23357","Z94526",12390,396,37,359," 2.9"
"23358","Z94530",10679,565,65,500," 4.7"
"23359","Z94531",12857,727,0,727," 5.7"
"23360","Z94533",24040,1716,54,1662," 6.9"
"23361","Z94534",13101,303,40,263," 2.0"
"23362","Z94535",1081,27,0,27," 2.5"
"23363","Z94536",25264,1126,421,705," 2.8"
"23364","Z94538",22016,931,297,634," 2.9"
"23365","Z94539",16643,418,84,334," 2.0"
"23366","Z94541",22048,1181,49,1132," 5.1"
"23367","Z94542",4501,179,39,140," 3.1"
"23368","Z94544",23275,673,66,607," 2.6"
"23369","Z94545",9535,210,0,210," 2.2"
"23370","Z94546",16535,578,73,505," 3.1"
"23371","Z94547",8407,265,0,265," 3.2"
"23372","Z94548",160,15,0,15," 9.4"
"23373","Z94549",11297,465,10,455," 4.0"
"23374","Z94550",18276,755,93,662," 3.6"
"23375","Z94551",14721,578,91,487," 3.3"
"23376","Z94552",5241,163,34,129," 2.5"
"23377","Z94553",19809,887,21,866," 4.4"
"23378","Z94555",11506,261,150,111," 1.0"
"23379","Z94556",5857,80,13,67," 1.1"
"23380","Z94558",26837,2607,1281,1326," 4.9"
"23381","Z94559",11356,942,226,716," 6.3"
"23382","Z94560",13799,363,190,173," 1.3"
"23383","Z94561",12144,441,124,317," 2.6"
"23384","Z94563",6813,104,28,76," 1.1"
"23385","Z94564",7225,484,4,480," 6.6"
"23386","Z94565",28240,1334,125,1209," 4.3"
"23387","Z94566",15682,394,52,342," 2.2"
"23388","Z94567",331,118,40,78,"23.6"
"23389","Z94568",17406,709,125,584," 3.4"
"23390","Z94569",220,41,41,0," 0.0"
"23391","Z94571",4405,477,106,371," 8.4"
"23392","Z94572",3303,136,0,136," 4.1"
"23393","Z94573",69,5,0,5," 7.2"
"23394","Z94574",4376,763,315,448,"10.2"
"23395","Z94577",17731,735,119,616," 3.5"
"23396","Z94578",14496,698,58,640," 4.4"
"23397","Z94579",7176,8,8,0," 0.0"
"23398","Z94580",9090,447,14,433," 4.8"
"23399","Z94582",13491,427,0,427," 3.2"
"23400","Z94583",12825,267,47,220," 1.7"
"23401","Z94585",9205,333,29,304," 3.3"
"23402","Z94586",398,31,2,29," 7.3"
"23403","Z94587",21407,946,280,666," 3.1"
"23404","Z94588",11621,438,55,383," 3.3"
"23405","Z94589",10190,638,13,625," 6.1"
"23406","Z94590",16366,2330,91,2239,"13.7"
"23407","Z94591",20131,1840,116,1724," 8.6"
"23408","Z94595",9984,924,71,853," 8.5"
"23409","Z94596",10163,656,180,476," 4.7"
"23410","Z94597",10330,490,77,413," 4.0"
"23411","Z94598",10590,411,52,359," 3.4"
"23412","Z94599",1547,197,106,91," 5.9"
"23413","Z94601",16303,1372,49,1323," 8.1"
"23414","Z94602",12584,654,41,613," 4.9"
"23415","Z94603",10515,901,36,865," 8.2"
"23416","Z94605",16771,1572,76,1496," 8.9"
"23417","Z94606",16191,1295,52,1243," 7.7"
"23418","Z94607",12414,1070,82,988," 8.0"
"23419","Z94608",15345,1597,9,1588,"10.3"
"23420","Z94609",10288,494,40,454," 4.4"
"23421","Z94610",16405,843,80,763," 4.7"
"23422","Z94611",17800,889,91,798," 4.5"
"23423","Z94612",8956,763,119,644," 7.2"
"23424","Z94618",7516,410,19,391," 5.2"
"23425","Z94619",9650,734,19,715," 7.4"
"23426","Z94621",10196,786,16,770," 7.6"
"23427","Z94702",8100,519,49,470," 5.8"
"23428","Z94703",9737,850,34,816," 8.4"
"23429","Z94704",8869,726,54,672," 7.6"
"23430","Z94705",6199,359,38,321," 5.2"
"23431","Z94706",8528,532,95,437," 5.1"
"23432","Z94707",5341,209,0,209," 3.9"
"23433","Z94708",5037,299,34,265," 5.3"
"23434","Z94709",5669,450,33,417," 7.4"
"23435","Z94710",3298,365,35,330,"10.0"
"23436","Z94801",10427,1136,92,1044,"10.0"
"23437","Z94803",9898,570,40,530," 5.4"
"23438","Z94804",15694,1097,82,1015," 6.5"
"23439","Z94805",5607,280,12,268," 4.8"
"23440","Z94806",20832,1571,161,1410," 6.8"
"23441","Z94901",16235,597,99,498," 3.1"
"23442","Z94903",12853,685,178,507," 3.9"
"23443","Z94904",5643,208,105,103," 1.8"
"23444","Z94920",6113,678,177,501," 8.2"
"23445","Z94922",263,26,0,26," 9.9"
"23446","Z94923",1366,916,654,262,"19.2"
"23447","Z94924",871,332,224,108,"12.4"
"23448","Z94925",4171,387,23,364," 8.7"
"23449","Z94928",16475,529,115,414," 2.5"
"23450","Z94929",463,384,347,37," 8.0"
"23451","Z94930",4105,239,62,177," 4.3"
"23452","Z94931",3373,179,55,124," 3.7"
"23453","Z94937",746,283,172,111,"14.9"
"23454","Z94939",3366,119,31,88," 2.6"
"23455","Z94941",13992,1024,256,768," 5.5"
"23456","Z94945",7429,211,30,181," 2.4"
"23457","Z94946",369,74,46,28," 7.6"
"23458","Z94947",10357,411,29,382," 3.7"
"23459","Z94949",7318,461,37,424," 5.8"
"23460","Z94951",1706,150,40,110," 6.4"
"23461","Z94952",13853,677,115,562," 4.1"
"23462","Z94954",13856,563,85,478," 3.4"
"23463","Z94956",1012,256,185,71," 7.0"
"23464","Z94957",449,52,6,46,"10.2"
"23465","Z94960",6638,254,7,247," 3.7"
"23466","Z94965",6303,732,359,373," 5.9"
"23467","Z94970",914,636,562,74," 8.1"
"23468","Z94973",799,51,21,30," 3.8"
"23469","Z95003",11714,1656,1292,364," 3.1"
"23470","Z95004",1326,23,8,15," 1.1"
"23471","Z95005",2741,193,83,110," 4.0"
"23472","Z95006",4664,732,419,313," 6.7"
"23473","Z95008",19300,949,44,905," 4.7"
"23474","Z95010",4778,540,442,98," 2.1"
"23475","Z95012",2774,323,120,203," 7.3"
"23476","Z95014",22394,1128,202,926," 4.1"
"23477","Z95017",346,64,32,32," 9.2"
"23478","Z95018",3498,485,265,220," 6.3"
"23479","Z95019",2193,119,0,119," 5.4"
"23480","Z95020",18106,508,60,448," 2.5"
"23481","Z95023",15444,639,92,547," 3.5"
"23482","Z95030",5843,496,79,417," 7.1"
"23483","Z95032",10498,485,96,389," 3.7"
"23484","Z95033",4030,288,76,212," 5.3"
"23485","Z95035",21529,658,222,436," 2.0"
"23486","Z95037",16255,436,127,309," 1.9"
"23487","Z95039",570,74,16,58,"10.2"
"23488","Z95045",1609,105,42,63," 3.9"
"23489","Z95046",2023,147,0,147," 7.3"
"23490","Z95050",14960,518,163,355," 2.4"
"23491","Z95051",21168,967,27,940," 4.4"
"23492","Z95054",9004,571,96,475," 5.3"
"23493","Z95060",20175,1884,777,1107," 5.5"
"23494","Z95062",16824,1878,1112,766," 4.6"
"23495","Z95064",483,51,19,32," 6.6"
"23496","Z95065",3246,114,62,52," 1.6"
"23497","Z95066",5973,176,126,50," 0.8"
"23498","Z95070",11395,452,111,341," 3.0"
"23499","Z95073",4429,347,56,291," 6.6"
"23500","Z95076",24834,1888,880,1008," 4.1"
"23501","Z95110",6735,354,24,330," 4.9"
"23502","Z95111",16227,529,26,503," 3.1"
"23503","Z95112",21147,1173,141,1032," 4.9"
"23504","Z95113",788,92,23,69," 8.8"
"23505","Z95116",14572,322,11,311," 2.1"
"23506","Z95117",11421,461,13,448," 3.9"
"23507","Z95118",11602,276,23,253," 2.2"
"23508","Z95119",3289,137,25,112," 3.4"
"23509","Z95120",12728,242,0,242," 1.9"
"23510","Z95121",9830,173,9,164," 1.7"
"23511","Z95122",13306,216,0,216," 1.6"
"23512","Z95123",22425,642,104,538," 2.4"
"23513","Z95124",17636,364,33,331," 1.9"
"23514","Z95125",21928,854,71,783," 3.6"
"23515","Z95126",15060,861,64,797," 5.3"
"23516","Z95127",17178,365,52,313," 1.8"
"23517","Z95128",14692,746,139,607," 4.1"
"23518","Z95129",14738,658,70,588," 4.0"
"23519","Z95130",5177,178,22,156," 3.0"
"23520","Z95131",9454,277,27,250," 2.6"
"23521","Z95132",12078,172,0,172," 1.4"
"23522","Z95133",8150,222,0,222," 2.7"
"23523","Z95134",8432,696,160,536," 6.4"
"23524","Z95135",7623,161,0,161," 2.1"
"23525","Z95136",15492,438,0,438," 2.8"
"23526","Z95138",6221,449,82,367," 5.9"
"23527","Z95139",2259,8,0,8," 0.4"
"23528","Z95140",88,30,0,30,"34.1"
"23529","Z95148",12100,183,11,172," 1.4"
"23530","Z95202",3987,1064,19,1045,"26.2"
"23531","Z95203",5831,668,21,647,"11.1"
"23532","Z95204",12167,1227,39,1188," 9.8"
"23533","Z95205",11542,1277,71,1206,"10.4"
"23534","Z95206",18339,1661,143,1518," 8.3"
"23535","Z95207",19596,1818,81,1737," 8.9"
"23536","Z95209",13324,671,26,645," 4.8"
"23537","Z95210",12281,717,40,677," 5.5"
"23538","Z95212",7718,438,37,401," 5.2"
"23539","Z95215",7339,610,7,603," 8.2"
"23540","Z95219",11660,864,141,723," 6.2"
"23541","Z95220",2613,157,5,152," 5.8"
"23542","Z95222",2576,390,200,190," 7.4"
"23543","Z95223",7820,6420,6150,270," 3.5"
"23544","Z95224",285,163,107,56,"19.6"
"23545","Z95225",281,48,48,0," 0.0"
"23546","Z95227",342,36,0,36,"10.5"
"23547","Z95228",2674,861,527,334,"12.5"
"23548","Z95230",250,14,11,3," 1.2"
"23549","Z95231",846,37,0,37," 4.4"
"23550","Z95236",1458,106,0,106," 7.3"
"23551","Z95237",1236,90,0,90," 7.3"
"23552","Z95240",17409,1573,86,1487," 8.5"
"23553","Z95242",10399,505,78,427," 4.1"
"23554","Z95245",1347,404,241,163,"12.1"
"23555","Z95247",2613,459,293,166," 6.4"
"23556","Z95248",151,93,74,19,"12.6"
"23557","Z95249",1705,256,15,241,"14.1"
"23558","Z95252",5513,501,186,315," 5.7"
"23559","Z95255",1143,339,251,88," 7.7"
"23560","Z95257",263,107,77,30,"11.4"
"23561","Z95258",1557,115,24,91," 5.8"
"23562","Z95301",12350,873,28,845," 6.8"
"23563","Z95303",290,25,16,9," 3.1"
"23564","Z95304",4314,195,44,151," 3.5"
"23565","Z95306",478,24,0,24," 5.0"
"23566","Z95307",13123,871,23,848," 6.5"
"23567","Z95310",1023,111,85,26," 2.5"
"23568","Z95311",1401,521,242,279,"19.9"
"23569","Z95313",470,75,0,75,"16.0"
"23570","Z95315",3650,209,0,209," 5.7"
"23571","Z95316",2406,112,1,111," 4.6"
"23572","Z95319",482,19,0,19," 3.9"
"23573","Z95320",4832,438,0,438," 9.1"
"23574","Z95321",3605,2013,1716,297," 8.2"
"23575","Z95322",3264,316,53,263," 8.1"
"23576","Z95323",359,15,5,10," 2.8"
"23577","Z95326",3492,210,0,210," 6.0"
"23578","Z95327",2742,320,155,165," 6.0"
"23579","Z95328",1220,17,17,0," 0.0"
"23580","Z95329",1510,334,124,210,"13.9"
"23581","Z95330",5283,262,28,234," 4.4"
"23582","Z95333",1007,122,23,99," 9.8"
"23583","Z95334",4403,255,59,196," 4.5"
"23584","Z95335",1174,972,844,128,"10.9"
"23585","Z95336",15780,871,24,847," 5.4"
"23586","Z95337",11005,722,6,716," 6.5"
"23587","Z95338",5960,1372,624,748,"12.6"
"23588","Z95340",12590,850,4,846," 6.7"
"23589","Z95341",9386,882,33,849," 9.0"
"23590","Z95346",1403,748,664,84," 6.0"
"23591","Z95348",11380,633,25,608," 5.3"
"23592","Z95350",20527,1248,122,1126," 5.5"
"23593","Z95351",14110,914,23,891," 6.3"
"23594","Z95354",9588,992,19,973,"10.1"
"23595","Z95355",22513,1351,43,1308," 5.8"
"23596","Z95356",11955,460,7,453," 3.8"
"23597","Z95357",3833,232,0,232," 6.1"
"23598","Z95358",9292,405,0,405," 4.4"
"23599","Z95360",3903,314,0,314," 8.0"
"23600","Z95361",12235,696,34,662," 5.4"
"23601","Z95363",7718,547,10,537," 7.0"
"23602","Z95365",1375,170,30,140,"10.2"
"23603","Z95366",6129,209,53,156," 2.5"
"23604","Z95367",7635,421,0,421," 5.5"
"23605","Z95368",4133,194,13,181," 4.4"
"23606","Z95369",435,94,35,59,"13.6"
"23607","Z95370",13582,1798,1142,656," 4.8"
"23608","Z95372",760,46,0,46," 6.1"
"23609","Z95376",15715,711,25,686," 4.4"
"23610","Z95377",8899,227,143,84," 0.9"
"23611","Z95379",1820,249,0,249,"13.7"
"23612","Z95380",14779,994,21,973," 6.6"
"23613","Z95382",13640,743,14,729," 5.3"
"23614","Z95383",3327,1744,1526,218," 6.6"
"23615","Z95386",3023,125,0,125," 4.1"
"23616","Z95388",4050,342,7,335," 8.3"
"23617","Z95391",3769,100,0,100," 2.7"
"23618","Z95401",13920,590,44,546," 3.9"
"23619","Z95403",18151,857,134,723," 4.0"
"23620","Z95404",16986,802,222,580," 3.4"
"23621","Z95405",9190,628,144,484," 5.3"
"23622","Z95407",12805,656,79,577," 4.5"
"23623","Z95409",12645,702,188,514," 4.1"
"23624","Z95410",543,143,102,41," 7.6"
"23625","Z95420",259,24,24,0," 0.0"
"23626","Z95422",9115,2153,1153,1000,"11.0"
"23627","Z95423",2713,1164,611,553,"20.4"
"23628","Z95425",4495,569,214,355," 7.9"
"23629","Z95428",1175,268,180,88," 7.5"
"23630","Z95432",267,68,46,22," 8.2"
"23631","Z95436",2928,388,259,129," 4.4"
"23632","Z95437",6979,1128,573,555," 8.0"
"23633","Z95441",808,137,117,20," 2.5"
"23634","Z95442",1986,482,291,191," 9.6"
"23635","Z95445",1343,380,380,0," 0.0"
"23636","Z95446",3692,1493,1057,436,"11.8"
"23637","Z95448",8372,1379,878,501," 6.0"
"23638","Z95449",691,114,31,83,"12.0"
"23639","Z95450",354,205,145,60,"16.9"
"23640","Z95451",6138,1380,877,503," 8.2"
"23641","Z95452",685,132,73,59," 8.6"
"23642","Z95453",5080,714,284,430," 8.5"
"23643","Z95454",1252,292,143,149,"11.9"
"23644","Z95457",1767,434,342,92," 5.2"
"23645","Z95458",1763,512,288,224,"12.7"
"23646","Z95460",1616,493,446,47," 2.9"
"23647","Z95461",1768,413,305,108," 6.1"
"23648","Z95462",1157,540,440,100," 8.6"
"23649","Z95464",1625,483,200,283,"17.4"
"23650","Z95465",1405,426,336,90," 6.4"
"23651","Z95466",408,96,81,15," 3.7"
"23652","Z95468",793,253,140,113,"14.2"
"23653","Z95469",1022,328,254,74," 7.2"
"23654","Z95470",2465,264,78,186," 7.5"
"23655","Z95471",437,206,126,80,"18.3"
"23656","Z95472",14010,1119,480,639," 4.6"
"23657","Z95476",17114,1751,725,1026," 6.0"
"23658","Z95482",12652,1113,262,851," 6.7"
"23659","Z95485",1314,249,117,132,"10.0"
"23660","Z95488",268,84,77,7," 2.6"
"23661","Z95490",6178,749,223,526," 8.5"
"23662","Z95492",10513,519,125,394," 3.7"
"23663","Z95497",1886,1285,1032,253,"13.4"
"23664","Z95501",10785,1241,187,1054," 9.8"
"23665","Z95503",10635,813,210,603," 5.7"
"23666","Z95519",7788,714,140,574," 7.4"
"23667","Z95521",9209,995,122,873," 9.5"
"23668","Z95524",798,41,0,41," 5.1"
"23669","Z95525",848,130,73,57," 6.7"
"23670","Z95526",270,136,116,20," 7.4"
"23671","Z95527",451,202,169,33," 7.3"
"23672","Z95528",524,104,76,28," 5.3"
"23673","Z95531",9445,1495,484,1011,"10.7"
"23674","Z95536",1354,219,99,120," 8.9"
"23675","Z95540",5616,678,74,604,"10.8"
"23676","Z95542",1370,366,178,188,"13.7"
"23677","Z95546",1510,399,110,289,"19.1"
"23678","Z95548",581,129,51,78,"13.4"
"23679","Z95549",344,30,19,11," 3.2"
"23680","Z95551",901,230,49,181,"20.1"
"23681","Z95556",348,91,85,6," 1.7"
"23682","Z95560",1009,497,318,179,"17.7"
"23683","Z95562",1593,235,57,178,"11.2"
"23684","Z95563",441,139,130,9," 2.0"
"23685","Z95565",412,58,22,36," 8.7"
"23686","Z95567",860,122,76,46," 5.3"
"23687","Z95570",1490,490,330,160,"10.7"
"23688","Z95573",1111,371,238,133,"12.0"
"23689","Z95585",318,92,51,41,"12.9"
"23690","Z95589",884,420,318,102,"11.5"
"23691","Z95602",7487,651,347,304," 4.1"
"23692","Z95603",12299,701,57,644," 5.2"
"23693","Z95604",88,56,56,0," 0.0"
"23694","Z95605",5210,271,0,271," 5.2"
"23695","Z95608",27460,2010,89,1921," 7.0"
"23696","Z95610",17970,837,43,794," 4.4"
"23697","Z95612",470,30,0,30," 6.4"
"23698","Z95614",1743,257,65,192,"11.0"
"23699","Z95615",332,72,0,72,"21.7"
"23700","Z95616",17775,718,150,568," 3.2"
"23701","Z95618",10064,421,16,405," 4.0"
"23702","Z95619",1991,135,0,135," 6.8"
"23703","Z95620",6960,404,39,365," 5.2"
"23704","Z95621",16785,710,5,705," 4.2"
"23705","Z95623",1642,123,108,15," 0.9"
"23706","Z95624",20222,1038,105,933," 4.6"
"23707","Z95626",2130,73,14,59," 2.8"
"23708","Z95627",1329,196,25,171,"12.9"
"23709","Z95628",17323,1069,0,1069," 6.2"
"23710","Z95630",26852,996,78,918," 3.4"
"23711","Z95631",2715,323,128,195," 7.2"
"23712","Z95632",9640,486,18,468," 4.9"
"23713","Z95633",1382,285,236,49," 3.5"
"23714","Z95634",1511,315,185,130," 8.6"
"23715","Z95635",538,150,108,42," 7.8"
"23716","Z95636",563,261,184,77,"13.7"
"23717","Z95638",737,25,6,19," 2.6"
"23718","Z95640",4440,556,150,406," 9.1"
"23719","Z95641",1064,236,84,152,"14.3"
"23720","Z95642",3439,715,216,499,"14.5"
"23721","Z95648",20074,1085,330,755," 3.8"
"23722","Z95650",4800,341,51,290," 6.0"
"23723","Z95651",345,48,48,0," 0.0"
"23724","Z95655",1514,177,0,177,"11.7"
"23725","Z95658",2671,151,17,134," 5.0"
"23726","Z95659",362,20,8,12," 3.3"
"23727","Z95660",11419,720,34,686," 6.0"
"23728","Z95661",12400,523,121,402," 3.2"
"23729","Z95662",12665,665,44,621," 4.9"
"23730","Z95663",915,58,10,48," 5.2"
"23731","Z95664",474,31,0,31," 6.5"
"23732","Z95665",1979,280,162,118," 6.0"
"23733","Z95666",3449,1406,1157,249," 7.2"
"23734","Z95667",16058,1658,549,1109," 6.9"
"23735","Z95668",341,21,0,21," 6.2"
"23736","Z95669",1067,255,107,148,"13.9"
"23737","Z95670",21550,1257,52,1205," 5.6"
"23738","Z95673",5180,333,9,324," 6.3"
"23739","Z95674",345,38,8,30," 8.7"
"23740","Z95677",9384,495,84,411," 4.4"
"23741","Z95678",16940,1048,27,1021," 6.0"
"23742","Z95681",499,73,0,73,"14.6"
"23743","Z95682",11693,799,124,675," 5.8"
"23744","Z95683",2678,84,0,84," 3.1"
"23745","Z95684",1767,386,260,126," 7.1"
"23746","Z95685",2054,315,202,113," 5.5"
"23747","Z95686",405,48,8,40," 9.9"
"23748","Z95687",23008,1306,111,1195," 5.2"
"23749","Z95688",13557,778,176,602," 4.4"
"23750","Z95689",819,358,268,90,"11.0"
"23751","Z95690",953,185,26,159,"16.7"
"23752","Z95691",13666,653,45,608," 4.4"
"23753","Z95692",1727,131,41,90," 5.2"
"23754","Z95693",2639,305,55,250," 9.5"
"23755","Z95694",3498,106,9,97," 2.8"
"23756","Z95695",15138,886,147,739," 4.9"
"23757","Z95701",503,174,139,35," 7.0"
"23758","Z95703",470,9,0,9," 1.9"
"23759","Z95709",1992,185,96,89," 4.5"
"23760","Z95713",4285,459,304,155," 3.6"
"23761","Z95714",340,169,131,38,"11.2"
"23762","Z95715",120,67,65,2," 1.7"
"23763","Z95717",124,34,34,0," 0.0"
"23764","Z95720",385,352,340,12," 3.1"
"23765","Z95722",2036,167,0,167," 8.2"
"23766","Z95726",4609,1248,769,479,"10.4"
"23767","Z95728",1232,1002,942,60," 4.9"
"23768","Z95736",84,17,0,17,"20.2"
"23769","Z95742",2998,89,33,56," 1.9"
"23770","Z95746",8290,212,59,153," 1.8"
"23771","Z95747",21329,997,92,905," 4.2"
"23772","Z95757",12721,624,0,624," 4.9"
"23773","Z95758",21537,952,203,749," 3.5"
"23774","Z95762",13677,406,147,259," 1.9"
"23775","Z95765",12622,278,74,204," 1.6"
"23776","Z95776",7395,596,44,552," 7.5"
"23777","Z95811",4567,512,53,459,"10.1"
"23778","Z95814",6473,1294,159,1135,"17.5"
"23779","Z95815",10050,1206,14,1192,"11.9"
"23780","Z95816",10754,899,66,833," 7.7"
"23781","Z95817",6563,654,35,619," 9.4"
"23782","Z95818",10092,565,59,506," 5.0"
"23783","Z95819",8095,350,62,288," 3.6"
"23784","Z95820",13440,1021,33,988," 7.4"
"23785","Z95821",16081,1714,83,1631,"10.1"
"23786","Z95822",16890,1195,148,1047," 6.2"
"23787","Z95823",24395,1613,65,1548," 6.3"
"23788","Z95824",9720,739,69,670," 6.9"
"23789","Z95825",17067,1793,112,1681," 9.8"
"23790","Z95826",16261,1294,136,1158," 7.1"
"23791","Z95827",7677,507,32,475," 6.2"
"23792","Z95828",18850,1009,69,940," 5.0"
"23793","Z95829",8106,332,14,318," 3.9"
"23794","Z95830",326,51,0,51,"15.6"
"23795","Z95831",19429,1345,41,1304," 6.7"
"23796","Z95832",3105,219,0,219," 7.1"
"23797","Z95833",15341,972,34,938," 6.1"
"23798","Z95834",10142,872,0,872," 8.6"
"23799","Z95835",13891,872,160,712," 5.1"
"23800","Z95837",171,18,18,0," 0.0"
"23801","Z95838",11724,1002,102,900," 7.7"
"23802","Z95841",8634,994,27,967,"11.2"
"23803","Z95842",11931,720,19,701," 5.9"
"23804","Z95843",14670,465,2,463," 3.2"
"23805","Z95864",9956,588,117,471," 4.7"
"23806","Z95901",12691,1263,166,1097," 8.6"
"23807","Z95903",546,114,0,114,"20.9"
"23808","Z95912",1533,145,46,99," 6.5"
"23809","Z95916",933,392,261,131,"14.0"
"23810","Z95917",1129,61,7,54," 4.8"
"23811","Z95918",993,59,20,39," 3.9"
"23812","Z95919",715,108,71,37," 5.2"
"23813","Z95922",394,82,68,14," 3.6"
"23814","Z95926",16929,1916,245,1671," 9.9"
"23815","Z95928",16023,2184,513,1671,"10.4"
"23816","Z95932",3121,353,53,300," 9.6"
"23817","Z95934",220,63,20,43,"19.5"
"23818","Z95935",298,61,32,29," 9.7"
"23819","Z95937",530,87,9,78,"14.7"
"23820","Z95938",1710,197,67,130," 7.6"
"23821","Z95942",1009,533,484,49," 4.9"
"23822","Z95943",399,73,14,59,"14.8"
"23823","Z95945",12568,1268,393,875," 7.0"
"23824","Z95946",4647,538,313,225," 4.8"
"23825","Z95947",906,157,72,85," 9.4"
"23826","Z95948",4237,520,31,489,"11.5"
"23827","Z95949",8977,844,276,568," 6.3"
"23828","Z95953",3287,285,29,256," 7.8"
"23829","Z95954",5888,871,283,588,"10.0"
"23830","Z95955",544,49,14,35," 6.4"
"23831","Z95956",477,305,264,41," 8.6"
"23832","Z95957",361,20,0,20," 5.5"
"23833","Z95959",8235,965,580,385," 4.7"
"23834","Z95960",362,20,15,5," 1.4"
"23835","Z95961",9154,726,29,697," 7.6"
"23836","Z95962",782,136,101,35," 4.5"
"23837","Z95963",5889,659,40,619,"10.5"
"23838","Z95965",7888,921,93,828,"10.5"
"23839","Z95966",13044,1492,262,1230," 9.4"
"23840","Z95969",12950,1601,347,1254," 9.7"
"23841","Z95971",2878,352,101,251," 8.7"
"23842","Z95973",14405,931,204,727," 5.0"
"23843","Z95975",809,107,68,39," 4.8"
"23844","Z95979",438,160,103,57,"13.0"
"23845","Z95982",1308,72,0,72," 5.5"
"23846","Z95987",1968,171,24,147," 7.5"
"23847","Z95988",3519,382,159,223," 6.3"
"23848","Z95991",15252,876,57,819," 5.4"
"23849","Z95993",12416,788,108,680," 5.5"
"23850","Z96001",14761,1364,287,1077," 7.3"
"23851","Z96002",13508,1040,39,1001," 7.4"
"23852","Z96003",19462,1746,547,1199," 6.2"
"23853","Z96007",9729,760,191,569," 5.8"
"23854","Z96008",490,97,15,82,"16.7"
"23855","Z96013",2115,397,129,268,"12.7"
"23856","Z96014",160,89,70,19,"11.9"
"23857","Z96019",4200,341,103,238," 5.7"
"23858","Z96020",1961,1025,782,243,"12.4"
"23859","Z96021",6428,816,103,713,"11.1"
"23860","Z96022",6709,377,61,316," 4.7"
"23861","Z96023",568,106,12,94,"16.5"
"23862","Z96025",1532,498,253,245,"16.0"
"23863","Z96027",1211,165,132,33," 2.7"
"23864","Z96028",836,255,135,120,"14.4"
"23865","Z96032",1130,240,85,155,"13.7"
"23866","Z96035",1288,148,7,141,"10.9"
"23867","Z96037",95,29,0,29,"30.5"
"23868","Z96038",301,39,0,39,"13.0"
"23869","Z96039",701,172,47,125,"17.8"
"23870","Z96040",277,103,103,0," 0.0"
"23871","Z96041",1792,561,343,218,"12.2"
"23872","Z96044",601,181,98,83,"13.8"
"23873","Z96048",397,114,56,58,"14.6"
"23874","Z96051",835,283,276,7," 0.8"
"23875","Z96052",958,351,257,94," 9.8"
"23876","Z96054",158,39,12,27,"17.1"
"23877","Z96055",1785,215,60,155," 8.7"
"23878","Z96056",814,167,77,90,"11.1"
"23879","Z96058",411,135,102,33," 8.0"
"23880","Z96061",194,181,181,0," 0.0"
"23881","Z96062",476,38,4,34," 7.1"
"23882","Z96063",390,288,280,8," 2.1"
"23883","Z96067",4036,675,401,274," 6.8"
"23884","Z96069",452,99,64,35," 7.7"
"23885","Z96073",1543,54,3,51," 3.3"
"23886","Z96080",12150,1378,226,1152," 9.5"
"23887","Z96088",2541,727,582,145," 5.7"
"23888","Z96091",872,602,527,75," 8.6"
"23889","Z96093",1905,318,130,188," 9.9"
"23890","Z96094",3200,580,249,331,"10.3"
"23891","Z96096",346,49,41,8," 2.3"
"23892","Z96097",4937,536,152,384," 7.8"
"23893","Z96101",2887,553,177,376,"13.0"
"23894","Z96103",2154,1411,1144,267,"12.4"
"23895","Z96104",410,145,68,77,"18.8"
"23896","Z96105",214,189,160,29,"13.6"
"23897","Z96107",774,251,68,183,"23.6"
"23898","Z96113",469,92,2,90,"19.2"
"23899","Z96114",1505,104,18,86," 5.7"
"23900","Z96118",752,122,36,86,"11.4"
"23901","Z96120",663,322,239,83,"12.5"
"23902","Z96122",2492,944,507,437,"17.5"
"23903","Z96126",113,80,80,0," 0.0"
"23904","Z96128",405,51,0,51,"12.6"
"23905","Z96130",6813,1435,581,854,"12.5"
"23906","Z96134",1251,337,76,261,"20.9"
"23907","Z96137",4213,2472,1990,482,"11.4"
"23908","Z96140",1600,1221,1118,103," 6.4"
"23909","Z96141",1658,1395,1341,54," 3.3"
"23910","Z96142",2117,1799,1667,132," 6.2"
"23911","Z96143",3163,1622,1513,109," 3.4"
"23912","Z96145",4855,3624,3405,219," 4.5"
"23913","Z96146",1810,1424,1352,72," 4.0"
"23914","Z96148",714,442,404,38," 5.3"
"23915","Z96150",23401,12119,10081,2038," 8.7"
"23916","Z96161",17338,10131,9430,701," 4.0"
"23917","Z96701",13903,902,153,749," 5.4"
"23918","Z96703",865,250,105,145,"16.8"
"23919","Z96704",3114,573,367,206," 6.6"
"23920","Z96705",808,87,13,74," 9.2"
"23921","Z96706",19279,1237,217,1020," 5.3"
"23922","Z96707",13531,1191,536,655," 4.8"
"23923","Z96708",4252,553,377,176," 4.1"
"23924","Z96712",3152,568,428,140," 4.4"
"23925","Z96713",771,263,180,83,"10.8"
"23926","Z96714",914,609,186,423,"46.3"
"23927","Z96717",1805,426,239,187,"10.4"
"23928","Z96719",678,83,0,83,"12.2"
"23929","Z96720",18851,2459,744,1715," 9.1"
"23930","Z96722",2651,1610,538,1072,"40.4"
"23931","Z96725",1440,324,177,147,"10.2"
"23932","Z96726",248,52,45,7," 2.8"
"23933","Z96727",1747,295,86,209,"12.0"
"23934","Z96728",240,44,10,34,"14.2"
"23935","Z96729",373,30,10,20," 5.4"
"23936","Z96731",1146,426,321,105," 9.2"
"23937","Z96732",7767,808,87,721," 9.3"
"23938","Z96734",16901,714,264,450," 2.7"
"23939","Z96737",2650,1063,514,549,"20.7"
"23940","Z96738",4664,2225,1565,660,"14.2"
"23941","Z96740",17973,5452,3586,1866,"10.4"
"23942","Z96741",2439,467,196,271,"11.1"
"23943","Z96743",5943,1871,1286,585," 9.8"
"23944","Z96744",17190,752,187,565," 3.3"
"23945","Z96746",8150,1565,945,620," 7.6"
"23946","Z96748",2055,481,149,332,"16.2"
"23947","Z96749",6744,631,136,495," 7.3"
"23948","Z96750",1417,186,111,75," 5.3"
"23949","Z96752",1367,347,187,160,"11.7"
"23950","Z96753",18655,7678,2911,4767,"25.6"
"23951","Z96754",1593,321,146,175,"11.0"
"23952","Z96755",1241,277,153,124,"10.0"
"23953","Z96756",3389,1396,1186,210," 6.2"
"23954","Z96757",308,65,22,43,"14.0"
"23955","Z96760",1253,181,69,112," 8.9"
"23956","Z96761",11919,4428,1727,2701,"22.7"
"23957","Z96762",1159,183,147,36," 3.1"
"23958","Z96763",1524,327,152,175,"11.5"
"23959","Z96764",351,123,53,70,"19.9"
"23960","Z96766",5552,753,314,439," 7.9"
"23961","Z96768",6923,709,288,421," 6.1"
"23962","Z96770",721,481,306,175,"24.3"
"23963","Z96771",3262,721,380,341,"10.5"
"23964","Z96772",1028,267,146,121,"11.8"
"23965","Z96776",579,96,24,72,"12.4"
"23966","Z96777",574,93,23,70,"12.2"
"23967","Z96778",6832,1539,699,840,"12.3"
"23968","Z96779",1264,320,113,207,"16.4"
"23969","Z96780",345,103,30,73,"21.2"
"23970","Z96781",581,58,9,49," 8.4"
"23971","Z96782",11892,362,54,308," 2.6"
"23972","Z96783",816,185,85,100,"12.3"
"23973","Z96786",14416,988,60,928," 6.4"
"23974","Z96789",18475,501,118,383," 2.1"
"23975","Z96790",3801,381,254,127," 3.3"
"23976","Z96791",2629,324,287,37," 1.4"
"23977","Z96792",13349,1964,903,1061," 7.9"
"23978","Z96793",10782,1170,379,791," 7.3"
"23979","Z96795",2494,87,46,41," 1.6"
"23980","Z96796",901,277,199,78," 8.7"
"23981","Z96797",19788,736,83,653," 3.3"
"23982","Z96813",10624,1075,235,840," 7.9"
"23983","Z96814",11759,2040,1062,978," 8.3"
"23984","Z96815",22350,8117,4632,3485,"15.6"
"23985","Z96816",18952,1783,525,1258," 6.6"
"23986","Z96817",20323,1252,104,1148," 5.6"
"23987","Z96818",19148,1061,142,919," 4.8"
"23988","Z96819",12553,594,81,513," 4.1"
"23989","Z96821",6988,561,184,377," 5.4"
"23990","Z96822",19636,1559,226,1333," 6.8"
"23991","Z96825",11202,685,320,365," 3.3"
"23992","Z96826",15930,1445,192,1253," 7.9"
"23993","Z97001",143,91,40,51,"35.7"
"23994","Z97002",2318,182,80,102," 4.4"
"23995","Z97004",1634,19,9,10," 0.6"
"23996","Z97005",11120,666,23,643," 5.8"
"23997","Z97006",25874,1338,98,1240," 4.8"
"23998","Z97007",25894,851,104,747," 2.9"
"23999","Z97008",12307,795,0,795," 6.5"
"24000","Z97009",3094,247,7,240," 7.8"
"24001","Z97011",470,183,126,57,"12.1"
"24002","Z97013",8484,267,25,242," 2.9"
"24003","Z97014",693,179,4,175,"25.3"
"24004","Z97015",8333,416,0,416," 5.0"
"24005","Z97017",1048,110,0,110,"10.5"
"24006","Z97018",954,41,0,41," 4.3"
"24007","Z97019",1335,80,0,80," 6.0"
"24008","Z97020",363,21,0,21," 5.8"
"24009","Z97021",576,137,24,113,"19.6"
"24010","Z97022",1213,101,0,101," 8.3"
"24011","Z97023",4084,352,50,302," 7.4"
"24012","Z97026",1275,79,3,76," 6.0"
"24013","Z97027",5142,256,0,256," 5.0"
"24014","Z97029",144,24,0,24,"16.7"
"24015","Z97030",15197,716,28,688," 4.5"
"24016","Z97031",7786,899,501,398," 5.1"
"24017","Z97032",1622,34,0,34," 2.1"
"24018","Z97034",8504,446,114,332," 3.9"
"24019","Z97035",11240,637,117,520," 4.6"
"24020","Z97037",623,187,149,38," 6.1"
"24021","Z97038",5869,181,0,181," 3.1"
"24022","Z97039",260,30,7,23," 8.8"
"24023","Z97040",656,212,102,110,"16.8"
"24024","Z97042",1213,53,9,44," 3.6"
"24025","Z97045",20426,1007,42,965," 4.7"
"24026","Z97048",2893,332,31,301,"10.4"
"24027","Z97050",134,15,3,12," 9.0"
"24028","Z97051",6187,607,42,565," 9.1"
"24029","Z97053",1323,87,0,87," 6.6"
"24030","Z97054",678,56,11,45," 6.6"
"24031","Z97055",7170,582,42,540," 7.5"
"24032","Z97056",4761,201,0,201," 4.2"
"24033","Z97058",8301,691,98,593," 7.1"
"24034","Z97060",7797,210,38,172," 2.2"
"24035","Z97062",11649,440,34,406," 3.5"
"24036","Z97063",901,376,349,27," 3.0"
"24037","Z97064",1549,281,37,244,"15.8"
"24038","Z97065",334,43,2,41,"12.3"
"24039","Z97067",1595,491,346,145," 9.1"
"24040","Z97068",11283,408,127,281," 2.5"
"24041","Z97070",9499,529,17,512," 5.4"
"24042","Z97071",10084,966,0,966," 9.6"
"24043","Z97080",15386,699,16,683," 4.4"
"24044","Z97086",10434,451,180,271," 2.6"
"24045","Z97089",4569,231,8,223," 4.9"
"24046","Z97101",1401,153,56,97," 6.9"
"24047","Z97102",366,288,241,47,"12.8"
"24048","Z97103",8294,945,263,682," 8.2"
"24049","Z97106",1678,142,7,135," 8.0"
"24050","Z97107",804,189,87,102,"12.7"
"24051","Z97109",205,5,0,5," 2.4"
"24052","Z97110",1235,721,617,104," 8.4"
"24053","Z97111",1344,140,17,123," 9.2"
"24054","Z97112",1216,459,371,88," 7.2"
"24055","Z97113",4364,260,65,195," 4.5"
"24056","Z97114",1743,183,41,142," 8.1"
"24057","Z97116",9583,581,112,469," 4.9"
"24058","Z97117",241,19,0,19," 7.9"
"24059","Z97118",532,182,141,41," 7.7"
"24060","Z97119",1739,127,44,83," 4.8"
"24061","Z97121",675,83,42,41," 6.1"
"24062","Z97122",304,106,76,30," 9.9"
"24063","Z97123",15806,712,52,660," 4.2"
"24064","Z97124",20936,1445,285,1160," 5.5"
"24065","Z97127",1299,196,0,196,"15.1"
"24066","Z97128",14460,1130,138,992," 6.9"
"24067","Z97130",1370,1168,1092,76," 5.5"
"24068","Z97131",2164,1084,987,97," 4.5"
"24069","Z97132",10616,695,112,583," 5.5"
"24070","Z97133",1598,145,25,120," 7.5"
"24071","Z97134",447,308,308,0," 0.0"
"24072","Z97135",1215,825,774,51," 4.2"
"24073","Z97136",2924,2126,1973,153," 5.2"
"24074","Z97137",455,29,9,20," 4.4"
"24075","Z97138",7254,2962,1932,1030,"14.2"
"24076","Z97140",9039,232,47,185," 2.0"
"24077","Z97141",6123,1177,744,433," 7.1"
"24078","Z97146",2712,442,234,208," 7.7"
"24079","Z97147",234,75,63,12," 5.1"
"24080","Z97148",1335,149,35,114," 8.5"
"24081","Z97149",853,600,600,0," 0.0"
"24082","Z97201",9468,904,379,525," 5.5"
"24083","Z97202",18704,693,23,670," 3.6"
"24084","Z97203",12251,621,43,578," 4.7"
"24085","Z97204",425,21,0,21," 4.9"
"24086","Z97205",5453,518,177,341," 6.3"
"24087","Z97206",20613,981,78,903," 4.4"
"24088","Z97209",12240,1496,796,700," 5.7"
"24089","Z97210",6954,585,221,364," 5.2"
"24090","Z97211",13216,641,33,608," 4.6"
"24091","Z97212",10934,483,63,420," 3.8"
"24092","Z97213",14060,460,53,407," 2.9"
"24093","Z97214",12533,793,11,782," 6.2"
"24094","Z97215",7791,302,0,302," 3.9"
"24095","Z97216",6545,333,19,314," 4.8"
"24096","Z97217",14795,983,233,750," 5.1"
"24097","Z97218",5968,377,8,369," 6.2"
"24098","Z97219",17308,680,79,601," 3.5"
"24099","Z97220",11831,540,95,445," 3.8"
"24100","Z97221",5302,220,0,220," 4.1"
"24101","Z97222",16208,949,27,922," 5.7"
"24102","Z97223",19621,1041,217,824," 4.2"
"24103","Z97224",14719,482,93,389," 2.6"
"24104","Z97225",11689,516,34,482," 4.1"
"24105","Z97227",2075,107,11,96," 4.6"
"24106","Z97229",24016,970,244,726," 3.0"
"24107","Z97230",16224,1026,44,982," 6.1"
"24108","Z97231",1851,202,14,188,"10.2"
"24109","Z97232",6491,272,104,168," 2.6"
"24110","Z97233",13988,1005,44,961," 6.9"
"24111","Z97236",13498,861,44,817," 6.1"
"24112","Z97239",8867,844,211,633," 7.1"
"24113","Z97266",12803,718,26,692," 5.4"
"24114","Z97267",13097,571,35,536," 4.1"
"24115","Z97301",19273,1474,126,1348," 7.0"
"24116","Z97302",16595,978,70,908," 5.5"
"24117","Z97303",14949,695,0,695," 4.6"
"24118","Z97304",12211,851,61,790," 6.5"
"24119","Z97305",14807,1159,106,1053," 7.1"
"24120","Z97306",11835,324,24,300," 2.5"
"24121","Z97317",8106,271,15,256," 3.2"
"24122","Z97321",10721,813,7,806," 7.5"
"24123","Z97322",14176,787,47,740," 5.2"
"24124","Z97324",575,103,83,20," 3.5"
"24125","Z97325",2565,78,0,78," 3.0"
"24126","Z97327",1281,161,17,144,"11.2"
"24127","Z97330",18691,1670,146,1524," 8.2"
"24128","Z97333",9761,953,99,854," 8.7"
"24129","Z97338",7839,364,40,324," 4.1"
"24130","Z97341",2435,1161,858,303,"12.4"
"24131","Z97342",540,445,358,87,"16.1"
"24132","Z97344",460,36,0,36," 7.8"
"24133","Z97348",670,39,0,39," 5.8"
"24134","Z97351",3743,411,0,411,"11.0"
"24135","Z97352",2345,196,0,196," 8.4"
"24136","Z97355",12078,1002,85,917," 7.6"
"24137","Z97358",1243,239,102,137,"11.0"
"24138","Z97360",993,65,9,56," 5.6"
"24139","Z97361",4578,264,15,249," 5.4"
"24140","Z97362",1609,176,21,155," 9.6"
"24141","Z97365",6041,1120,818,302," 5.0"
"24142","Z97366",955,324,229,95," 9.9"
"24143","Z97367",7323,3012,2553,459," 6.3"
"24144","Z97368",1968,485,354,131," 6.7"
"24145","Z97369",410,325,272,53,"12.9"
"24146","Z97370",3558,297,63,234," 6.6"
"24147","Z97371",291,107,58,49,"16.8"
"24148","Z97374",2151,102,35,67," 3.1"
"24149","Z97375",546,73,0,73,"13.4"
"24150","Z97376",802,169,164,5," 0.6"
"24151","Z97377",300,71,50,21," 7.0"
"24152","Z97378",2763,315,56,259," 9.4"
"24153","Z97380",1212,54,28,26," 2.1"
"24154","Z97381",5848,467,114,353," 6.0"
"24155","Z97383",3701,279,23,256," 6.9"
"24156","Z97385",1546,141,0,141," 9.1"
"24157","Z97386",5537,378,83,295," 5.3"
"24158","Z97388",1165,797,775,22," 1.9"
"24159","Z97389",645,23,0,23," 3.6"
"24160","Z97390",426,137,91,46,"10.8"
"24161","Z97391",2228,337,106,231,"10.4"
"24162","Z97394",3383,1390,1128,262," 7.7"
"24163","Z97396",1253,141,40,101," 8.1"
"24164","Z97401",20703,1920,53,1867," 9.0"
"24165","Z97402",21559,812,135,677," 3.1"
"24166","Z97403",4232,437,93,344," 8.1"
"24167","Z97404",13395,516,145,371," 2.8"
"24168","Z97405",20128,879,256,623," 3.1"
"24169","Z97408",5191,122,49,73," 1.4"
"24170","Z97411",4220,857,413,444,"10.5"
"24171","Z97413",779,336,261,75," 9.6"
"24172","Z97415",7691,1064,495,569," 7.4"
"24173","Z97416",447,34,8,26," 5.8"
"24174","Z97417",1204,152,2,150,"12.5"
"24175","Z97419",586,18,18,0," 0.0"
"24176","Z97420",12581,1573,374,1199," 9.5"
"24177","Z97423",3057,352,0,352,"11.5"
"24178","Z97424",7598,481,120,361," 4.8"
"24179","Z97426",4174,321,11,310," 7.4"
"24180","Z97431",963,94,44,50," 5.2"
"24181","Z97434",340,23,8,15," 4.4"
"24182","Z97435",1003,80,3,77," 7.7"
"24183","Z97436",483,96,71,25," 5.2"
"24184","Z97437",1038,31,8,23," 2.2"
"24185","Z97438",481,114,45,69,"14.3"
"24186","Z97439",8818,1754,971,783," 8.9"
"24187","Z97442",954,82,6,76," 8.0"
"24188","Z97443",843,81,33,48," 5.7"
"24189","Z97444",2989,713,232,481,"16.1"
"24190","Z97446",1747,118,42,76," 4.4"
"24191","Z97448",5241,331,68,263," 5.0"
"24192","Z97451",152,5,0,5," 3.3"
"24193","Z97452",697,34,16,18," 2.6"
"24194","Z97453",485,84,36,48," 9.9"
"24195","Z97454",628,49,0,49," 7.8"
"24196","Z97455",1017,16,0,16," 1.6"
"24197","Z97456",1202,136,0,136,"11.3"
"24198","Z97457",4346,513,58,455,"10.5"
"24199","Z97458",2323,395,0,395,"17.0"
"24200","Z97459",6138,611,120,491," 8.0"
"24201","Z97462",1761,221,95,126," 7.2"
"24202","Z97463",2074,344,107,237,"11.4"
"24203","Z97465",1448,220,71,149,"10.3"
"24204","Z97467",2689,436,175,261," 9.7"
"24205","Z97470",9239,694,88,606," 6.6"
"24206","Z97473",222,85,43,42,"18.9"
"24207","Z97476",103,46,20,26,"25.2"
"24208","Z97477",16236,713,8,705," 4.3"
"24209","Z97478",15126,1017,144,873," 5.8"
"24210","Z97479",4350,563,72,491,"11.3"
"24211","Z97487",3133,96,0,96," 3.1"
"24212","Z97488",590,134,55,79,"13.4"
"24213","Z97489",472,89,20,69,"14.6"
"24214","Z97493",203,56,56,0," 0.0"
"24215","Z97496",2892,192,0,192," 6.6"
"24216","Z97497",714,45,0,45," 6.3"
"24217","Z97498",1764,915,786,129," 7.3"
"24218","Z97499",880,120,53,67," 7.6"
"24219","Z97501",18226,1339,149,1190," 6.5"
"24220","Z97502",11570,860,127,733," 6.3"
"24221","Z97503",4075,403,44,359," 8.8"
"24222","Z97504",19534,1612,349,1263," 6.5"
"24223","Z97520",12650,1282,557,725," 5.7"
"24224","Z97522",297,76,30,46,"15.5"
"24225","Z97523",3114,429,101,328,"10.5"
"24226","Z97524",5737,580,116,464," 8.1"
"24227","Z97525",2132,229,68,161," 7.6"
"24228","Z97526",15697,1089,244,845," 5.4"
"24229","Z97527",15371,1500,179,1321," 8.6"
"24230","Z97530",3613,536,298,238," 6.6"
"24231","Z97532",1043,41,26,15," 1.4"
"24232","Z97534",420,232,25,207,"49.3"
"24233","Z97535",2614,170,0,170," 6.5"
"24234","Z97536",578,141,102,39," 6.7"
"24235","Z97537",3715,339,98,241," 6.5"
"24236","Z97538",1020,195,67,128,"12.5"
"24237","Z97539",1720,169,37,132," 7.7"
"24238","Z97540",3662,182,72,110," 3.0"
"24239","Z97543",387,86,0,86,"22.2"
"24240","Z97544",1004,97,33,64," 6.4"
"24241","Z97601",11243,1938,723,1215,"10.8"
"24242","Z97603",12810,1032,69,963," 7.5"
"24243","Z97622",225,11,11,0," 0.0"
"24244","Z97623",1191,165,57,108," 9.1"
"24245","Z97624",2310,793,266,527,"22.8"
"24246","Z97626",169,82,52,30,"17.8"
"24247","Z97630",2467,268,46,222," 9.0"
"24248","Z97632",555,76,3,73,"13.2"
"24249","Z97633",633,87,40,47," 7.4"
"24250","Z97636",239,27,3,24,"10.0"
"24251","Z97641",810,266,88,178,"22.0"
"24252","Z97701",28411,2463,910,1553," 5.5"
"24253","Z97702",18777,1987,1157,830," 4.4"
"24254","Z97707",7791,5135,4704,431," 5.5"
"24255","Z97720",2354,502,57,445,"18.9"
"24256","Z97730",523,383,367,16," 3.1"
"24257","Z97731",170,44,24,20,"11.8"
"24258","Z97733",1114,916,764,152,"13.6"
"24259","Z97734",1676,665,565,100," 6.0"
"24260","Z97738",759,67,0,67," 8.8"
"24261","Z97739",6438,1660,1212,448," 7.0"
"24262","Z97741",4655,528,42,486,"10.4"
"24263","Z97753",1061,200,156,44," 4.1"
"24264","Z97754",8913,877,348,529," 5.9"
"24265","Z97756",15386,2044,890,1154," 7.5"
"24266","Z97759",4706,2217,1849,368," 7.8"
"24267","Z97760",3438,669,397,272," 7.9"
"24268","Z97761",1124,109,4,105," 9.3"
"24269","Z97801",8523,560,19,541," 6.3"
"24270","Z97810",416,92,25,67,"16.1"
"24271","Z97812",437,104,55,49,"11.2"
"24272","Z97813",543,97,15,82,"15.1"
"24273","Z97814",6187,671,143,528," 8.5"
"24274","Z97818",1327,74,0,74," 5.6"
"24275","Z97820",629,190,114,76,"12.1"
"24276","Z97823",599,118,61,57," 9.5"
"24277","Z97824",736,43,9,34," 4.6"
"24278","Z97825",174,34,18,16," 9.2"
"24279","Z97826",417,51,0,51,"12.2"
"24280","Z97827",1292,278,120,158,"12.2"
"24281","Z97828",1575,266,143,123," 7.8"
"24282","Z97830",469,110,75,35," 7.5"
"24283","Z97833",460,62,34,28," 6.1"
"24284","Z97834",727,325,214,111,"15.3"
"24285","Z97836",1134,320,198,122,"10.8"
"24286","Z97838",9630,588,121,467," 4.8"
"24287","Z97841",199,1,0,1," 0.5"
"24288","Z97844",1489,143,46,97," 6.5"
"24289","Z97845",1347,213,55,158,"11.7"
"24290","Z97846",1427,486,391,95," 6.7"
"24291","Z97850",7422,771,143,628," 8.5"
"24292","Z97857",269,47,18,29,"10.8"
"24293","Z97862",4814,493,95,398," 8.3"
"24294","Z97864",173,72,48,24,"13.9"
"24295","Z97867",374,74,25,49,"13.1"
"24296","Z97868",860,102,23,79," 9.2"
"24297","Z97869",549,144,39,105,"19.1"
"24298","Z97870",342,88,46,42,"12.3"
"24299","Z97875",1030,56,0,56," 5.4"
"24300","Z97876",386,38,10,28," 7.3"
"24301","Z97880",262,151,113,38,"14.5"
"24302","Z97882",2148,270,11,259,"12.1"
"24303","Z97883",1071,143,14,129,"12.0"
"24304","Z97885",681,139,49,90,"13.2"
"24305","Z97886",777,300,261,39," 5.0"
"24306","Z97901",332,85,37,48,"14.5"
"24307","Z97907",314,99,54,45,"14.3"
"24308","Z97910",366,139,80,59,"16.1"
"24309","Z97913",2055,253,78,175," 8.5"
"24310","Z97914",6470,485,2,483," 7.5"
"24311","Z97918",1805,181,18,163," 9.0"
"24312","Z98001",11853,744,59,685," 5.8"
"24313","Z98002",13738,1051,29,1022," 7.4"
"24314","Z98003",19289,1498,0,1498," 7.8"
"24315","Z98004",17462,1944,366,1578," 9.0"
"24316","Z98005",8146,639,176,463," 5.7"
"24317","Z98006",13727,539,161,378," 2.8"
"24318","Z98007",11154,653,55,598," 5.4"
"24319","Z98008",9357,341,9,332," 3.5"
"24320","Z98010",2023,110,38,72," 3.6"
"24321","Z98011",13329,604,95,509," 3.8"
"24322","Z98012",21804,1005,35,970," 4.4"
"24323","Z98014",2760,149,8,141," 5.1"
"24324","Z98019",4391,273,91,182," 4.1"
"24325","Z98020",9211,483,110,373," 4.0"
"24326","Z98021",10666,267,64,203," 1.9"
"24327","Z98022",9214,681,380,301," 3.3"
"24328","Z98023",18530,970,138,832," 4.5"
"24329","Z98024",2174,188,0,188," 8.6"
"24330","Z98026",15406,1071,64,1007," 6.5"
"24331","Z98027",11360,513,35,478," 4.2"
"24332","Z98028",8536,509,24,485," 5.7"
"24333","Z98029",11144,595,63,532," 4.8"
"24334","Z98030",12484,758,63,695," 5.6"
"24335","Z98031",12676,551,10,541," 4.3"
"24336","Z98032",14675,1264,110,1154," 7.9"
"24337","Z98033",16640,1048,229,819," 4.9"
"24338","Z98034",18001,719,180,539," 3.0"
"24339","Z98036",14694,436,0,436," 3.0"
"24340","Z98037",10815,611,25,586," 5.4"
"24341","Z98038",12545,533,57,476," 3.8"
"24342","Z98039",1266,179,57,122," 9.6"
"24343","Z98040",10179,596,24,572," 5.6"
"24344","Z98042",16573,789,125,664," 4.0"
"24345","Z98043",8557,402,39,363," 4.2"
"24346","Z98045",5848,248,0,248," 4.2"
"24347","Z98047",2475,222,8,214," 8.6"
"24348","Z98051",1323,11,0,11," 0.8"
"24349","Z98052",26354,1572,378,1194," 4.5"
"24350","Z98053",8377,501,105,396," 4.7"
"24351","Z98055",9457,573,34,539," 5.7"
"24352","Z98056",13893,478,73,405," 2.9"
"24353","Z98057",6440,588,37,551," 8.6"
"24354","Z98059",13637,420,40,380," 2.8"
"24355","Z98065",4953,240,44,196," 4.0"
"24356","Z98068",906,796,778,18," 2.0"
"24357","Z98070",5798,1041,775,266," 4.6"
"24358","Z98072",9217,494,15,479," 5.2"
"24359","Z98074",9070,292,36,256," 2.8"
"24360","Z98075",7595,226,68,158," 2.1"
"24361","Z98077",4923,117,34,83," 1.7"
"24362","Z98087",12911,736,0,736," 5.7"
"24363","Z98092",16100,859,125,734," 4.6"
"24364","Z98101",9173,1262,433,829," 9.0"
"24365","Z98102",15038,648,313,335," 2.2"
"24366","Z98103",24340,1404,64,1340," 5.5"
"24367","Z98104",7999,722,180,542," 6.8"
"24368","Z98105",16374,1100,69,1031," 6.3"
"24369","Z98106",10747,628,0,628," 5.8"
"24370","Z98107",12707,579,88,491," 3.9"
"24371","Z98108",8612,555,53,502," 5.8"
"24372","Z98109",15202,1196,335,861," 5.7"
"24373","Z98110",10374,899,472,427," 4.1"
"24374","Z98112",10930,548,114,434," 4.0"
"24375","Z98115",22085,1006,126,880," 4.0"
"24376","Z98116",12313,772,164,608," 4.9"
"24377","Z98117",14220,407,11,396," 2.8"
"24378","Z98118",17060,1017,75,942," 5.5"
"24379","Z98119",12166,523,36,487," 4.0"
"24380","Z98121",10259,1014,238,776," 7.6"
"24381","Z98122",17551,878,212,666," 3.8"
"24382","Z98125",18882,1046,48,998," 5.3"
"24383","Z98126",10242,698,110,588," 5.7"
"24384","Z98133",22049,1290,0,1290," 5.9"
"24385","Z98134",189,28,0,28,"14.8"
"24386","Z98136",7483,289,0,289," 3.9"
"24387","Z98144",13211,908,0,908," 6.9"
"24388","Z98146",10239,805,138,667," 6.5"
"24389","Z98148",4634,374,42,332," 7.2"
"24390","Z98155",13838,475,29,446," 3.2"
"24391","Z98164",140,59,46,13," 9.3"
"24392","Z98166",8765,386,58,328," 3.7"
"24393","Z98168",12139,617,55,562," 4.6"
"24394","Z98177",8212,415,30,385," 4.7"
"24395","Z98178",9752,830,38,792," 8.1"
"24396","Z98188",10041,431,59,372," 3.7"
"24397","Z98198",14123,997,72,925," 6.5"
"24398","Z98199",9920,747,136,611," 6.2"
"24399","Z98201",13979,1429,334,1095," 7.8"
"24400","Z98203",14282,947,135,812," 5.7"
"24401","Z98204",17799,1419,51,1368," 7.7"
"24402","Z98208",20769,1022,51,971," 4.7"
"24403","Z98221",11010,1960,1348,612," 5.6"
"24404","Z98222",165,136,129,7," 4.2"
"24405","Z98223",16123,1236,370,866," 5.4"
"24406","Z98225",20826,1450,263,1187," 5.7"
"24407","Z98226",17900,1786,710,1076," 6.0"
"24408","Z98229",13868,1632,839,793," 5.7"
"24409","Z98230",8665,2083,1708,375," 4.3"
"24410","Z98232",1839,215,111,104," 5.7"
"24411","Z98233",6111,364,0,364," 6.0"
"24412","Z98236",3330,724,431,293," 8.8"
"24413","Z98237",2130,490,377,113," 5.3"
"24414","Z98239",3740,675,429,246," 6.6"
"24415","Z98240",1171,84,0,84," 7.2"
"24416","Z98241",1081,227,155,72," 6.7"
"24417","Z98243",544,293,221,72,"13.2"
"24418","Z98244",2359,1130,1028,102," 4.3"
"24419","Z98245",2759,867,666,201," 7.3"
"24420","Z98247",3439,161,12,149," 4.3"
"24421","Z98248",8808,524,274,250," 2.8"
"24422","Z98249",3174,1123,887,236," 7.4"
"24423","Z98250",5713,2178,1695,483," 8.5"
"24424","Z98251",2221,425,321,104," 4.7"
"24425","Z98252",3949,540,206,334," 8.5"
"24426","Z98257",2081,368,171,197," 9.5"
"24427","Z98258",11414,567,168,399," 3.5"
"24428","Z98260",3172,673,429,244," 7.7"
"24429","Z98261",2301,1054,845,209," 9.1"
"24430","Z98262",962,493,420,73," 7.6"
"24431","Z98264",7697,727,100,627," 8.1"
"24432","Z98266",1490,136,93,43," 2.9"
"24433","Z98267",436,179,113,66,"15.1"
"24434","Z98270",17693,723,17,706," 4.0"
"24435","Z98271",11046,913,316,597," 5.4"
"24436","Z98272",9245,710,57,653," 7.1"
"24437","Z98273",11346,797,179,618," 5.4"
"24438","Z98274",7635,1234,656,578," 7.6"
"24439","Z98275",8377,477,84,393," 4.7"
"24440","Z98276",214,10,0,10," 4.7"
"24441","Z98277",17043,1411,219,1192," 7.0"
"24442","Z98279",645,321,283,38," 5.9"
"24443","Z98280",512,277,229,48," 9.4"
"24444","Z98281",2152,1506,1378,128," 5.9"
"24445","Z98282",8624,2265,1771,494," 5.7"
"24446","Z98284",10313,953,322,631," 6.1"
"24447","Z98290",13602,1306,472,834," 6.1"
"24448","Z98292",9129,1094,514,580," 6.4"
"24449","Z98294",2622,162,0,162," 6.2"
"24450","Z98295",995,126,77,49," 4.9"
"24451","Z98296",10109,468,180,288," 2.8"
"24452","Z98304",725,391,284,107,"14.8"
"24453","Z98305",224,70,35,35,"15.6"
"24454","Z98310",9279,620,46,574," 6.2"
"24455","Z98311",10742,711,149,562," 5.2"
"24456","Z98312",13873,1565,230,1335," 9.6"
"24457","Z98315",1365,57,0,57," 4.2"
"24458","Z98320",1476,915,778,137," 9.3"
"24459","Z98321",5335,294,12,282," 5.3"
"24460","Z98327",3491,201,44,157," 4.5"
"24461","Z98328",4444,558,246,312," 7.0"
"24462","Z98329",4146,263,39,224," 5.4"
"24463","Z98331",2774,297,132,165," 5.9"
"24464","Z98332",6645,629,211,418," 6.3"
"24465","Z98333",1545,191,134,57," 3.7"
"24466","Z98335",10683,1107,348,759," 7.1"
"24467","Z98336",479,77,0,77,"16.1"
"24468","Z98337",3342,463,16,447,"13.4"
"24469","Z98338",9576,593,119,474," 4.9"
"24470","Z98339",1613,273,59,214,"13.3"
"24471","Z98340",1594,345,208,137," 8.6"
"24472","Z98345",220,20,20,0," 0.0"
"24473","Z98346",4264,389,289,100," 2.3"
"24474","Z98349",2619,835,562,273,"10.4"
"24475","Z98351",555,242,201,41," 7.4"
"24476","Z98354",2943,129,14,115," 3.9"
"24477","Z98355",330,21,16,5," 1.5"
"24478","Z98356",1055,112,15,97," 9.2"
"24479","Z98358",654,176,95,81,"12.4"
"24480","Z98359",2019,297,161,136," 6.7"
"24481","Z98360",4555,316,20,296," 6.5"
"24482","Z98361",1584,1070,981,89," 5.6"
"24483","Z98362",11162,1141,219,922," 8.3"
"24484","Z98363",6648,1154,620,534," 8.0"
"24485","Z98365",2925,877,588,289," 9.9"
"24486","Z98366",14384,2014,333,1681,"11.7"
"24487","Z98367",11476,1238,297,941," 8.2"
"24488","Z98368",8573,1405,763,642," 7.5"
"24489","Z98370",12489,1089,460,629," 5.0"
"24490","Z98371",8487,437,0,437," 5.1"
"24491","Z98372",9906,730,44,686," 6.9"
"24492","Z98373",9349,740,19,721," 7.7"
"24493","Z98374",14268,828,41,787," 5.5"
"24494","Z98375",10138,701,14,687," 6.8"
"24495","Z98376",1350,612,495,117," 8.7"
"24496","Z98377",1117,263,96,167,"15.0"
"24497","Z98380",2178,247,210,37," 1.7"
"24498","Z98381",283,67,49,18," 6.4"
"24499","Z98382",14124,1649,687,962," 6.8"
"24500","Z98383",8883,690,64,626," 7.0"
"24501","Z98385",118,9,0,9," 7.6"
"24502","Z98387",16274,1367,21,1346," 8.3"
"24503","Z98388",2770,164,18,146," 5.3"
"24504","Z98390",4577,331,64,267," 5.8"
"24505","Z98391",16559,848,217,631," 3.8"
"24506","Z98392",1382,145,46,99," 7.2"
"24507","Z98394",684,221,162,59," 8.6"
"24508","Z98402",3767,490,50,440,"11.7"
"24509","Z98403",4745,446,41,405," 8.5"
"24510","Z98404",11833,1064,13,1051," 8.9"
"24511","Z98405",10512,1133,35,1098,"10.4"
"24512","Z98406",9829,564,16,548," 5.6"
"24513","Z98407",9674,757,83,674," 7.0"
"24514","Z98408",7576,609,0,609," 8.0"
"24515","Z98409",10336,1060,74,986," 9.5"
"24516","Z98418",4245,627,13,614,"14.5"
"24517","Z98422",7783,379,22,357," 4.6"
"24518","Z98424",4162,302,8,294," 7.1"
"24519","Z98433",4185,271,10,261," 6.2"
"24520","Z98439",2163,214,0,214," 9.9"
"24521","Z98443",2281,67,0,67," 2.9"
"24522","Z98444",13668,911,38,873," 6.4"
"24523","Z98445",11844,1015,12,1003," 8.5"
"24524","Z98446",4126,258,0,258," 6.3"
"24525","Z98465",3373,288,30,258," 7.6"
"24526","Z98466",12004,766,39,727," 6.1"
"24527","Z98467",6381,264,49,215," 3.4"
"24528","Z98498",12404,1447,179,1268,"10.2"
"24529","Z98499",14026,1399,48,1351," 9.6"
"24530","Z98501",17677,1075,204,871," 4.9"
"24531","Z98502",14455,1626,431,1195," 8.3"
"24532","Z98503",16123,1298,82,1216," 7.5"
"24533","Z98506",8533,559,39,520," 6.1"
"24534","Z98512",12022,679,48,631," 5.2"
"24535","Z98513",13343,1031,235,796," 6.0"
"24536","Z98516",9085,414,7,407," 4.5"
"24537","Z98520",9186,1149,83,1066,"11.6"
"24538","Z98524",1795,464,428,36," 2.0"
"24539","Z98526",205,100,76,24,"11.7"
"24540","Z98528",5158,1846,1149,697,"13.5"
"24541","Z98531",10463,881,72,809," 7.7"
"24542","Z98532",9443,705,100,605," 6.4"
"24543","Z98535",423,179,135,44,"10.4"
"24544","Z98537",902,83,10,73," 8.1"
"24545","Z98538",102,13,0,13,"12.7"
"24546","Z98541",4467,692,295,397," 8.9"
"24547","Z98542",207,13,0,13," 6.3"
"24548","Z98547",1346,835,797,38," 2.8"
"24549","Z98548",2501,1199,1034,165," 6.6"
"24550","Z98550",5281,760,116,644,"12.2"
"24551","Z98552",260,29,7,22," 8.5"
"24552","Z98563",3387,216,20,196," 5.8"
"24553","Z98564",1171,227,173,54," 4.6"
"24554","Z98565",220,9,0,9," 4.1"
"24555","Z98569",5660,2816,2196,620,"11.0"
"24556","Z98570",1902,267,128,139," 7.3"
"24557","Z98572",346,56,9,47,"13.6"
"24558","Z98576",1859,103,32,71," 3.8"
"24559","Z98577",2989,352,103,249," 8.3"
"24560","Z98579",5057,303,68,235," 4.6"
"24561","Z98580",4277,235,9,226," 5.3"
"24562","Z98584",16306,2880,1760,1120," 6.9"
"24563","Z98585",421,81,53,28," 6.7"
"24564","Z98586",1030,207,97,110,"10.7"
"24565","Z98588",1883,1072,976,96," 5.1"
"24566","Z98589",3147,283,141,142," 4.5"
"24567","Z98590",338,128,115,13," 3.8"
"24568","Z98591",1647,150,55,95," 5.8"
"24569","Z98592",1064,435,393,42," 3.9"
"24570","Z98593",492,119,68,51,"10.4"
"24571","Z98595",2155,905,634,271,"12.6"
"24572","Z98596",2763,259,73,186," 6.7"
"24573","Z98597",8782,854,167,687," 7.8"
"24574","Z98601",1130,107,54,53," 4.7"
"24575","Z98603",658,228,141,87,"13.2"
"24576","Z98604",12279,678,50,628," 5.1"
"24577","Z98605",566,107,18,89,"15.7"
"24578","Z98606",3220,191,0,191," 5.9"
"24579","Z98607",10651,415,34,381," 3.6"
"24580","Z98611",4155,239,30,209," 5.0"
"24581","Z98612",1277,222,191,31," 2.4"
"24582","Z98616",514,442,401,41," 8.0"
"24583","Z98617",427,38,0,38," 8.9"
"24584","Z98619",255,75,46,29,"11.4"
"24585","Z98620",3247,427,98,329,"10.1"
"24586","Z98624",939,256,150,106,"11.3"
"24587","Z98625",2673,189,66,123," 4.6"
"24588","Z98626",9630,712,62,650," 6.7"
"24589","Z98628",208,25,22,3," 1.4"
"24590","Z98629",3154,208,30,178," 5.6"
"24591","Z98631",3307,1639,1284,355,"10.7"
"24592","Z98632",21700,1607,203,1404," 6.5"
"24593","Z98635",1193,413,260,153,"12.8"
"24594","Z98638",623,106,45,61," 9.8"
"24595","Z98640",5138,3185,2889,296," 5.8"
"24596","Z98642",6505,341,27,314," 4.8"
"24597","Z98644",444,312,303,9," 2.0"
"24598","Z98648",1428,222,71,151,"10.6"
"24599","Z98649",397,35,0,35," 8.8"
"24600","Z98650",481,147,120,27," 5.6"
"24601","Z98651",417,105,52,53,"12.7"
"24602","Z98660",5509,297,51,246," 4.5"
"24603","Z98661",18592,816,79,737," 4.0"
"24604","Z98662",12597,634,56,578," 4.6"
"24605","Z98663",6004,331,27,304," 5.1"
"24606","Z98664",9378,630,121,509," 5.4"
"24607","Z98665",10252,566,42,524," 5.1"
"24608","Z98671",8649,506,142,364," 4.2"
"24609","Z98672",2953,693,394,299,"10.1"
"24610","Z98673",258,59,22,37,"14.3"
"24611","Z98674",4422,567,74,493,"11.1"
"24612","Z98675",2222,168,39,129," 5.8"
"24613","Z98682",19382,1093,48,1045," 5.4"
"24614","Z98683",13499,531,10,521," 3.9"
"24615","Z98684",10448,479,46,433," 4.1"
"24616","Z98685",10321,321,17,304," 2.9"
"24617","Z98686",7187,176,15,161," 2.2"
"24618","Z98801",16510,1656,211,1445," 8.8"
"24619","Z98802",11380,747,214,533," 4.7"
"24620","Z98812",1916,394,136,258,"13.5"
"24621","Z98813",1119,187,28,159,"14.2"
"24622","Z98815",3086,561,216,345,"11.2"
"24623","Z98816",4624,2029,1678,351," 7.6"
"24624","Z98819",270,168,160,8," 3.0"
"24625","Z98822",1064,247,128,119,"11.2"
"24626","Z98823",4254,272,67,205," 4.8"
"24627","Z98826",5781,2904,2414,490," 8.5"
"24628","Z98828",864,10,0,10," 1.2"
"24629","Z98831",2310,1008,711,297,"12.9"
"24630","Z98833",396,343,296,47,"11.9"
"24631","Z98836",288,20,0,20," 6.9"
"24632","Z98837",16003,1451,224,1227," 7.7"
"24633","Z98840",2291,396,121,275,"12.0"
"24634","Z98841",3752,306,135,171," 4.6"
"24635","Z98844",2765,671,558,113," 4.1"
"24636","Z98846",665,229,180,49," 7.4"
"24637","Z98847",904,309,71,238,"26.3"
"24638","Z98848",4933,1341,1071,270," 5.5"
"24639","Z98849",641,178,147,31," 4.8"
"24640","Z98850",640,126,44,82,"12.8"
"24641","Z98851",2091,275,142,133," 6.4"
"24642","Z98855",3435,678,558,120," 3.5"
"24643","Z98856",1599,439,313,126," 7.9"
"24644","Z98857",1330,137,8,129," 9.7"
"24645","Z98858",947,93,41,52," 5.5"
"24646","Z98862",2168,1210,1116,94," 4.3"
"24647","Z98901",10320,559,34,525," 5.1"
"24648","Z98902",17703,1251,0,1251," 7.1"
"24649","Z98903",5701,597,118,479," 8.4"
"24650","Z98908",14966,881,189,692," 4.6"
"24651","Z98922",4982,2381,2035,346," 6.9"
"24652","Z98925",878,638,561,77," 8.8"
"24653","Z98926",13205,1033,229,804," 6.1"
"24654","Z98930",4932,212,0,212," 4.3"
"24655","Z98932",1338,45,0,45," 3.4"
"24656","Z98933",380,14,2,12," 3.2"
"24657","Z98934",482,49,9,40," 8.3"
"24658","Z98936",2028,131,23,108," 5.3"
"24659","Z98937",2504,981,815,166," 6.6"
"24660","Z98938",661,20,0,20," 3.0"
"24661","Z98941",550,186,119,67,"12.2"
"24662","Z98942",6644,380,64,316," 4.8"
"24663","Z98944",6319,358,0,358," 5.7"
"24664","Z98946",250,11,11,0," 0.0"
"24665","Z98947",1041,83,8,75," 7.2"
"24666","Z98948",3611,209,25,184," 5.1"
"24667","Z98951",3906,229,0,229," 5.9"
"24668","Z98952",620,92,16,76,"12.3"
"24669","Z98953",2197,98,13,85," 3.9"
"24670","Z99001",1651,249,0,249,"15.1"
"24671","Z99003",2007,99,16,83," 4.1"
"24672","Z99004",7572,665,137,528," 7.0"
"24673","Z99005",3168,260,94,166," 5.2"
"24674","Z99006",4546,378,83,295," 6.5"
"24675","Z99009",1532,143,60,83," 5.4"
"24676","Z99011",856,125,0,125,"14.6"
"24677","Z99016",5134,273,36,237," 4.6"
"24678","Z99019",4539,638,220,418," 9.2"
"24679","Z99021",3600,155,50,105," 2.9"
"24680","Z99022",3619,302,66,236," 6.5"
"24681","Z99025",2385,537,379,158," 6.6"
"24682","Z99026",3933,204,77,127," 3.2"
"24683","Z99027",2542,76,38,38," 1.5"
"24684","Z99029",516,15,0,15," 2.9"
"24685","Z99030",483,104,4,100,"20.7"
"24686","Z99031",501,66,0,66,"13.2"
"24687","Z99032",382,38,25,13," 3.4"
"24688","Z99033",472,75,0,75,"15.9"
"24689","Z99036",605,68,0,68,"11.2"
"24690","Z99037",5224,303,0,303," 5.8"
"24691","Z99040",298,19,2,17," 5.7"
"24692","Z99101",724,161,34,127,"17.5"
"24693","Z99109",2626,336,126,210," 8.0"
"24694","Z99110",587,85,31,54," 9.2"
"24695","Z99111",1888,120,19,101," 5.3"
"24696","Z99113",325,12,0,12," 3.7"
"24697","Z99114",5778,782,342,440," 7.6"
"24698","Z99116",778,94,34,60," 7.7"
"24699","Z99117",288,91,67,24," 8.3"
"24700","Z99121",84,32,24,8," 9.5"
"24701","Z99122",2188,733,520,213," 9.7"
"24702","Z99125",276,56,12,44,"15.9"
"24703","Z99128",128,15,7,8," 6.2"
"24704","Z99129",420,90,61,29," 6.9"
"24705","Z99130",406,55,2,53,"13.1"
"24706","Z99133",1056,251,120,131,"12.4"
"24707","Z99134",315,78,10,68,"21.6"
"24708","Z99138",778,293,207,86,"11.1"
"24709","Z99139",827,286,170,116,"14.0"
"24710","Z99140",227,80,42,38,"16.7"
"24711","Z99141",2754,624,364,260," 9.4"
"24712","Z99143",358,72,17,55,"15.4"
"24713","Z99148",1751,825,750,75," 4.3"
"24714","Z99150",162,70,67,3," 1.9"
"24715","Z99153",352,150,35,115,"32.7"
"24716","Z99155",424,76,31,45,"10.6"
"24717","Z99156",4763,1363,831,532,"11.2"
"24718","Z99157",417,73,25,48,"11.5"
"24719","Z99159",710,110,3,107,"15.1"
"24720","Z99161",689,80,20,60," 8.7"
"24721","Z99163",12857,1433,82,1351,"10.5"
"24722","Z99166",1900,450,242,208,"10.9"
"24723","Z99167",309,53,37,16," 5.2"
"24724","Z99169",1203,162,23,139,"11.6"
"24725","Z99171",619,100,15,85,"13.7"
"24726","Z99173",681,91,29,62," 9.1"
"24727","Z99176",80,10,0,10,"12.5"
"24728","Z99179",267,51,9,42,"15.7"
"24729","Z99180",616,188,155,33," 5.4"
"24730","Z99181",1067,279,173,106," 9.9"
"24731","Z99185",737,224,116,108,"14.7"
"24732","Z99201",7633,950,31,919,"12.0"
"24733","Z99202",7520,785,44,741," 9.9"
"24734","Z99203",9733,594,127,467," 4.8"
"24735","Z99204",4076,542,0,542,"13.3"
"24736","Z99205",18988,1378,77,1301," 6.9"
"24737","Z99206",14930,447,28,419," 2.8"
"24738","Z99207",13464,1538,36,1502,"11.2"
"24739","Z99208",21508,1507,122,1385," 6.4"
"24740","Z99212",8671,674,72,602," 6.9"
"24741","Z99216",11201,878,0,878," 7.8"
"24742","Z99217",7356,359,0,359," 4.9"
"24743","Z99218",6236,430,74,356," 5.7"
"24744","Z99223",13515,800,85,715," 5.3"
"24745","Z99224",8978,589,22,567," 6.3"
"24746","Z99301",23048,976,102,874," 3.8"
"24747","Z99320",3568,225,77,148," 4.1"
"24748","Z99322",93,24,2,22,"23.7"
"24749","Z99323",1289,52,28,24," 1.9"
"24750","Z99328",1943,401,181,220,"11.3"
"24751","Z99330",432,50,0,50,"11.6"
"24752","Z99336",19702,1413,66,1347," 6.8"
"24753","Z99337",11076,468,114,354," 3.2"
"24754","Z99338",4670,219,60,159," 3.4"
"24755","Z99341",375,121,27,94,"25.1"
"24756","Z99343",802,60,13,47," 5.9"
"24757","Z99344",5183,331,107,224," 4.3"
"24758","Z99345",79,8,4,4," 5.1"
"24759","Z99346",180,11,11,0," 0.0"
"24760","Z99347",1261,271,71,200,"15.9"
"24761","Z99348",547,101,22,79,"14.4"
"24762","Z99349",2361,584,425,159," 6.7"
"24763","Z99350",4737,240,93,147," 3.1"
"24764","Z99352",12425,707,79,628," 5.1"
"24765","Z99353",5186,125,17,108," 2.1"
"24766","Z99354",9675,631,139,492," 5.1"
"24767","Z99357",949,79,38,41," 4.3"
"24768","Z99360",451,46,8,38," 8.4"
"24769","Z99361",823,131,51,80," 9.7"
"24770","Z99362",16681,1495,283,1212," 7.3"
"24771","Z99402",858,124,49,75," 8.7"
"24772","Z99403",8879,369,38,331," 3.7"
"24773","Z99501",8544,999,227,772," 9.0"
"24774","Z99502",9455,767,103,664," 7.0"
"24775","Z99503",6446,580,48,532," 8.3"
"24776","Z99504",15734,1293,151,1142," 7.3"
"24777","Z99507",14951,941,213,728," 4.9"
"24778","Z99508",13237,1042,114,928," 7.0"
"24779","Z99515",8145,530,193,337," 4.1"
"24780","Z99516",7428,428,103,325," 4.4"
"24781","Z99517",7354,567,21,546," 7.4"
"24782","Z99518",4446,381,223,158," 3.6"
"24783","Z99540",263,91,64,27,"10.3"
"24784","Z99546",550,514,251,263,"47.8"
"24785","Z99547",46,19,8,11,"23.9"
"24786","Z99550",152,57,38,19,"12.5"
"24787","Z99552",111,11,2,9," 8.1"
"24788","Z99553",54,8,4,4," 7.4"
"24789","Z99555",118,61,29,32,"27.1"
"24790","Z99556",1679,601,382,219,"13.0"
"24791","Z99557",418,190,98,92,"22.0"
"24792","Z99559",2787,561,229,332,"11.9"
"24793","Z99563",258,50,0,50,"19.4"
"24794","Z99566",279,215,185,30,"10.8"
"24795","Z99567",3372,81,11,70," 2.1"
"24796","Z99571",97,56,29,27,"27.8"
"24797","Z99572",413,222,191,31," 7.5"
"24798","Z99573",809,553,461,92,"11.4"
"24799","Z99574",1324,433,281,152,"11.5"
"24800","Z99575",39,8,0,8,"20.5"
"24801","Z99576",1374,541,270,271,"19.7"
"24802","Z99577",9612,423,73,350," 3.6"
"24803","Z99578",121,23,0,23,"19.0"
"24804","Z99581",221,25,0,25,"11.3"
"24805","Z99587",1521,591,432,159,"10.5"
"24806","Z99588",1269,996,891,105," 8.3"
"24807","Z99590",72,21,3,18,"25.0"
"24808","Z99603",5815,1944,1267,677,"11.6"
"24809","Z99604",227,14,0,14," 6.2"
"24810","Z99606",172,52,20,32,"18.6"
"24811","Z99611",7130,1311,666,645," 9.0"
"24812","Z99612",268,38,20,18," 6.7"
"24813","Z99613",410,268,170,98,"23.9"
"24814","Z99614",179,27,2,25,"14.0"
"24815","Z99615",4856,567,262,305," 6.3"
"24816","Z99620",165,22,2,20,"12.1"
"24817","Z99621",215,53,26,27,"12.6"
"24818","Z99627",291,139,88,51,"17.5"
"24819","Z99631",245,82,68,14," 5.7"
"24820","Z99632",190,37,9,28,"14.7"
"24821","Z99633",444,223,145,78,"17.6"
"24822","Z99634",114,16,4,12,"10.5"
"24823","Z99636",126,19,2,17,"13.5"
"24824","Z99637",126,14,0,14,"11.1"
"24825","Z99639",1217,742,612,130,"10.7"
"24826","Z99641",116,20,4,16,"13.8"
"24827","Z99643",115,30,15,15,"13.0"
"24828","Z99645",9318,750,144,606," 6.5"
"24829","Z99652",2945,1539,1335,204," 6.9"
"24830","Z99653",79,34,28,6," 7.6"
"24831","Z99654",20469,2399,861,1538," 7.5"
"24832","Z99655",188,31,0,31,"16.5"
"24833","Z99657",131,52,49,3," 2.3"
"24834","Z99658",246,62,14,48,"19.5"
"24835","Z99660",208,47,11,36,"17.3"
"24836","Z99661",417,65,22,43,"10.3"
"24837","Z99662",113,4,2,2," 1.8"
"24838","Z99663",424,203,129,74,"17.5"
"24839","Z99664",2223,588,346,242,"10.9"
"24840","Z99669",7056,1648,1190,458," 6.5"
"24841","Z99672",2427,916,761,155," 6.4"
"24842","Z99676",1639,1024,790,234,"14.3"
"24843","Z99678",323,140,58,82,"25.4"
"24844","Z99681",88,18,0,18,"20.5"
"24845","Z99683",816,626,595,31," 3.8"
"24846","Z99684",345,107,60,47,"13.6"
"24847","Z99685",981,168,39,129,"13.1"
"24848","Z99686",1476,287,172,115," 7.8"
"24849","Z99688",2871,1843,1554,289,"10.1"
"24850","Z99689",349,99,50,49,"14.0"
"24851","Z99692",84,23,9,14,"16.7"
"24852","Z99693",321,208,136,72,"22.4"
"24853","Z99694",809,225,98,127,"15.7"
"24854","Z99701",8589,1244,309,935,"10.9"
"24855","Z99702",1057,282,0,282,"26.7"
"24856","Z99703",1908,122,0,122," 6.4"
"24857","Z99705",9285,912,164,748," 8.1"
"24858","Z99709",14065,1814,672,1142," 8.1"
"24859","Z99712",5429,929,476,453," 8.3"
"24860","Z99723",1652,323,61,262,"15.9"
"24861","Z99730",252,216,149,67,"26.6"
"24862","Z99737",2671,1233,607,626,"23.4"
"24863","Z99739",136,39,32,7," 5.1"
"24864","Z99741",293,91,19,72,"24.6"
"24865","Z99742",213,50,25,25,"11.7"
"24866","Z99743",921,471,355,116,"12.6"
"24867","Z99747",72,23,9,14,"19.4"
"24868","Z99752",1293,372,232,140,"10.8"
"24869","Z99753",92,18,2,16,"17.4"
"24870","Z99756",269,231,184,47,"17.5"
"24871","Z99759",82,13,0,13,"15.9"
"24872","Z99760",578,311,179,132,"22.8"
"24873","Z99762",1968,539,348,191," 9.7"
"24874","Z99772",225,64,62,2," 0.9"
"24875","Z99777",153,50,28,22,"14.4"
"24876","Z99780",948,376,286,90," 9.5"
"24877","Z99783",70,13,7,6," 8.6"
"24878","Z99789",136,37,19,18,"13.2"
"24879","Z99801",12061,946,262,684," 5.7"
"24880","Z99820",285,161,108,53,"18.6"
"24881","Z99824",1098,99,23,76," 6.9"
"24882","Z99827",1640,436,248,188,"11.5"
"24883","Z99830",272,78,9,69,"25.4"
"24884","Z99832",106,70,38,32,"30.2"
"24885","Z99833",1738,454,265,189,"10.9"
"24886","Z99835",4108,636,248,388," 9.4"
"24887","Z99840",636,230,111,119,"18.7"
"24888","Z99841",198,123,96,27,"13.6"
"24889","Z99901",6220,953,342,611," 9.8"
"24890","Z99921",967,294,186,108,"11.2"
"24891","Z99922",126,17,5,12," 9.5"
"24892","Z99925",391,66,26,40,"10.2"
"24893","Z99926",539,63,10,53," 9.8"
"24894","Z99927",131,53,38,15,"11.5"
"24895","Z99929",1457,341,151,190,"13.0"
